a	a˧˥
á	a˩˧
à	a˦˨
ả	a˧˩˨
ạ	a˨ˀ˩ʔ
ác	ak˦˥
ắc	ăk˦˥
ặc	ăk˨ˀ˩ʔ
ác-bít	ak˦˥-bit˦˥
ắc-coóc	ăk˦˥-kɔkp˦˥
ách	ak˦˥
ạch	ak˨ˀ˩ʔ
ác-ten	ak˦˥-tɛŋ˧˥
a-di-đà	a˧˥-ji˧˥-da˦˨
â,	ɤ̆˧˥
ai	aj˧˥
ái	aj˩˧
ải	aj˧˩˨
a-lê	a˧˥-le˧˥
am	am˧˥
ám	am˩˧
ăm	ăm˧˥
ẵm	ăm˧˩˨
ảm	am˧˩˨
âm	ɤ̆m˧˥
ấm	ɤ̆m˩˧
ấm,	ɤ̆m˩˧
ầm	ɤ̆m˦˨
ẫm	ɤ̆m˧˩˨
ẩm	ɤ̆m˧˩˨
ậm	ɤ̆m˨ˀ˩ʔ
a-mi-nô	a˧˥-mi˧˥-no˧˥
am-pe	am˧˥-pɛ˧˥
an	aŋ˧˥
án	aŋ˩˧
ăn	ăŋ˧˥
ăn,	ăŋ˧˥
ăn;	ăŋ˧˥
ân	ɤ̆ŋ˧˥
ấn	ɤ̆ŋ˩˧
ẩn	ɤ̆ŋ˧˩˨
ang	aŋ˧˥
áng	aŋ˩˧
ăng	ăŋ˧˥
ắng	ăŋ˩˧
ằng	ăŋ˦˨
ẳng	ăŋ˧˩˨
(anh)	an˧˥
anh	an˧˥
anh,	an˧˥
ánh	an˩˧
ành	an˦˨
ảnh	an˧˩˨
ao	aw˧˥
ao,	aw˧˥
áo	aw˩˧
Áo	aw˩˧
áo	aw˩˧
áo,	aw˩˧
ào	aw˦˨
ảo	aw˧˩˨
ạo	aw˨ˀ˩ʔ
áp	ap˦˥
ấp	ɤ̆p˦˥
ập	ɤ̆p˨ˀ˩ʔ
a-rập	a˧˥-ʐɤ̆p˨ˀ˩ʔ
át	ak˦˥
ắt	ăk˦˥
ất	ɤ̆k˦˥
au	ăw˧˥
âu	ɤ̆w˧˥
Âu	ɤ̆w˧˥
âu	ɤ̆w˧˥
Âu	ɤ̆w˧˥
âu	ɤ̆w˧˥
Âu	ɤ̆w˧˥
âu	ɤ̆w˧˥
ấu	ɤ̆w˩˧
ầu	ɤ̆w˦˨
ẩu	ɤ̆w˧˩˨
a-xê-ti-len	a˧˥-se˧˥-ti˧˥-lɛŋ˧˥
a-xít	a˧˥-sit˦˥
ay	ăj˧˥
áy	ăj˩˧
ấy	ɤ̆j˩˧
ba	ba˧˥
ba,	ba˧˥
bá	ba˩˧
bà	ba˦˨
bã	ba˧˩˨
bả	ba˧˩˨
bạ	ba˨ˀ˩ʔ
bác	bak˦˥
bác,	bak˦˥
bắc	băk˦˥
bạc	bak˨ˀ˩ʔ
bặc	băk˨ˀ˩ʔ
bấc	bɤ̆k˦˥
bậc	bɤ̆k˨ˀ˩ʔ
bách	bak˦˥
bạch	bak˨ˀ˩ʔ
bai	baj˧˥
bái	baj˩˧
bài	baj˦˨
bài,	baj˦˨
bãi	baj˧˩˨
bải	baj˧˩˨
bại	baj˨ˀ˩ʔ
bam	bam˧˥
bám	bam˩˧
bàm	bam˦˨
băm	băm˧˥
bặm	băm˨ˀ˩ʔ
bấm	bɤ̆m˩˧
bầm	bɤ̆m˦˨
bẫm	bɤ̆m˧˩˨
bẩm	bɤ̆m˧˩˨
bậm	bɤ̆m˨ˀ˩ʔ
ban	baŋ˧˥
bán	baŋ˩˧
bán,	baŋ˩˧
bàn	baŋ˦˨
băn	băŋ˧˥
bắn	băŋ˩˧
bằn	băŋ˦˨
bẳn	băŋ˧˩˨
bản	baŋ˧˩˨
bạn	baŋ˨ˀ˩ʔ
bạn,	baŋ˨ˀ˩ʔ
bân	bɤ̆ŋ˧˥
bấn	bɤ̆ŋ˩˧
bần	bɤ̆ŋ˦˨
bẩn	bɤ̆ŋ˧˩˨
bận	bɤ̆ŋ˨ˀ˩ʔ
bang	baŋ˧˥
báng	baŋ˩˧
bàng	baŋ˦˨
băng	băŋ˧˥
bắng	băŋ˩˧
bằng	băŋ˦˨
bẵng	băŋ˧˩˨
bảng	baŋ˧˩˨
bạng	baŋ˨ˀ˩ʔ
bặng	băŋ˨ˀ˩ʔ
bâng	bɤ̆ŋ˧˥
bầng	bɤ̆ŋ˦˨
băng-giô	băŋ˧˥-jo˧˥
bánh	ban˩˧
bành	ban˦˨
bành,	ban˦˨
bảnh	ban˧˩˨
bạnh	ban˨ˀ˩ʔ
bao	baw˧˥
báo	baw˩˧
bào	baw˦˨
bão	baw˧˩˨
bảo	baw˧˩˨
bạo	baw˨ˀ˩ʔ
bắp	băp˦˥
bấp	bɤ̆p˦˥
bập	bɤ̆p˨ˀ˩ʔ
bát	bak˦˥
bát,	bak˦˥
bắt	băk˦˥
bạt	bak˨ˀ˩ʔ
bặt	băk˨ˀ˩ʔ
bất	bɤ̆k˦˥
bật	bɤ̆k˨ˀ˩ʔ
ba-trui,	ba˧˥-ʈuj˧˥
bát-tràng,	bak˦˥-ʈaŋ˦˨
báu	băw˩˧
bàu	băw˦˨
bảu	băw˧˩˨
bạu	băw˨ˀ˩ʔ
bâu	bɤ̆w˧˥
bấu	bɤ̆w˩˧
bầu	bɤ̆w˦˨
bậu	bɤ̆w˨ˀ˩ʔ
ba-xí	ba˧˥-si˩˧
bay	băj˧˥
bày	băj˦˨
bảy	băj˧˩˨
bảy,	băj˧˩˨
bây	bɤ̆j˧˥
bấy	bɤ̆j˩˧
bầy	bɤ̆j˦˨
bẫy	bɤ̆j˧˩˨
bẩy	bɤ̆j˧˩˨
bậy	bɤ̆j˨ˀ˩ʔ
bê	be˧˥
bế	be˩˧
bề	be˦˨
bể	be˧˩˨
bệ	be˨ˀ˩ʔ
be	bɛ˧˥
be,	bɛ˧˥
bé	bɛ˩˧
bè	bɛ˦˨
bẽ	bɛ˧˩˨
bẻ	bɛ˧˩˨
bẹ	bɛ˨ˀ˩ʔ
béc	bɛk˦˥
bệch	bet˨ˀ˩ʔ
bem	bɛm˧˥
bèm	bɛm˦˨
bẻm	bɛm˧˩˨
bên	ben˧˥
bến	ben˩˧
bền	ben˦˨
bện	ben˨ˀ˩ʔ
bén	bɛŋ˩˧
bèn	bɛŋ˦˨
bẽn	bɛŋ˧˩˨
beng	bɛŋ˧˥
bênh	ben˧˥
bềnh	ben˦˨
bệnh	ben˨ˀ˩ʔ
beo	beo˧˥
béo	beo˩˧
bèo	beo˦˨
bèo,	beo˦˨
bẻo	beo˧˩˨
bếp	bep˦˥
bép	bɛp˦˥
bẹp	bɛp˨ˀ˩ʔ
bết	bet˦˥
bệt	bet˨ˀ˩ʔ
bét	bɛk˦˥
bẹt	bɛk˨ˀ˩ʔ
bê-tông	be˧˥-toŋm˧˥
bêu	bɛu˧˥
bều	bɛu˦˨
bệu	bɛu˨ˀ˩ʔ
bia	biə˧˥
bìa	biə˦˨
bịa	biə˨ˀ˩ʔ
bi	bi˧˥
bí	bi˩˧
bì	bi˦˨
bĩ	bi˧˩˨
bỉ	bi˧˩˨
bị	bi˨ˀ˩ʔ
bích	bit˦˥
bích-câu	bit˦˥-kɤ̆w˧˥
biếc	biək˦˥
biếm	biəm˩˧
biên	biəŋ˧˥
biến	biəŋ˩˧
biền	biəŋ˦˨
biển	biəŋ˧˩˨
biển,	biəŋ˧˩˨
biện	biəŋ˨ˀ˩ʔ
biêng	biəŋ˧˥
biếng	biəŋ˩˧
biết	biək˦˥
biết,	biək˦˥
biệt	biək˨ˀ˩ʔ
biếu	biəw˩˧
biểu	biəw˧˩˨
bìm	bim˦˨
bỉm	bim˧˩˨
bin	bin˧˥
bín	bin˩˧
bịn	bin˨ˀ˩ʔ
binh	bin˧˥
bính	bin˩˧
bình	bin˦˨
bĩnh	bin˧˩˨
bỉnh	bin˧˩˨
bíp	bip˦˥
bịp	bip˨ˀ˩ʔ
bít	bit˦˥
bịt	bit˨ˀ˩ʔ
bịt;	bit˨ˀ˩ʔ
bíu	biw˩˧
bìu	biw˦˨
bĩu	biw˧˩˨
bơ	bɤ˧˥
bớ	bɤ˩˧
bờ	bɤ˦˨
bờ,	bɤ˦˨
bỡ	bɤ˧˩˨
bở	bɤ˧˩˨
bở,	bɤ˧˩˨
bợ	bɤ˨ˀ˩ʔ
bô	bo˧˥
bố	bo˩˧
bồ	bo˦˨
bỗ	bo˧˩˨
bổ	bo˧˩˨
bộ	bo˨ˀ˩ʔ
bo	bɔ˧˥
bo,	bɔ˧˥
bó	bɔ˩˧
(bò)	bɔ˦˨
bò	bɔ˦˨
bò;	bɔ˦˨
bõ	bɔ˧˩˨
bỏ	bɔ˧˩˨
bọ	bɔ˨ˀ˩ʔ
bốc	bokp˦˥
bộc	bokp˨ˀ˩ʔ
bóc	bɔkp˦˥
bọc	bɔkp˨ˀ˩ʔ
bơi	bɤj˧˥
bới	bɤj˩˧
bời	bɤj˦˨
bởi	bɤj˧˩˨
bôi	boj˧˥
bối	boj˩˧
bồi	boj˦˨
bổi	boj˧˩˨
bội	boj˨ˀ˩ʔ
bói	bɔj˩˧
bói,	bɔj˩˧
bòi	bɔj˦˨
bơm	bɤm˧˥
bờm	bɤm˦˨
bợm	bɤm˨ˀ˩ʔ
bôm	bom˧˥
bồm	bom˦˨
bom	bɔm˧˥
bòm	bɔm˦˨
bỏm	bɔm˧˩˨
bơn	bɤŋ˧˥
bờn	bɤŋ˦˨
bỡn	bɤŋ˧˩˨
bợn	bɤŋ˨ˀ˩ʔ
bôn	boŋm˧˥
bốn	boŋm˩˧
bồn	boŋm˦˨
bổn	boŋm˧˩˨
bộn	boŋm˨ˀ˩ʔ
bon	bɔŋm˧˥
bón	bɔŋm˩˧
bòn	bɔŋm˦˨
bỏn	bɔŋm˧˩˨
bọn	bɔŋm˨ˀ˩ʔ
bông	boŋm˧˥
bống	boŋm˩˧
bống,	boŋm˩˧
bồng	boŋm˦˨
bỗng	boŋm˧˩˨
bổng	boŋm˧˩˨
bổng,	boŋm˧˩˨
bộng	boŋm˨ˀ˩ʔ
bong	bɔŋm˧˥
bóng	bɔŋm˩˧
bòng	bɔŋm˦˨
bỏng	bɔŋm˧˩˨
bọng	bɔŋm˨ˀ˩ʔ
bôn-sê-vích	boŋm˧˥-ʂe˧˥-jit˦˥
boóc	bɔkp˦˥
boong	bɔŋm˧˥
bớp	bɤp˦˥
bợp	bɤp˨ˀ˩ʔ
bốp	bop˦˥
bộp	bop˨ˀ˩ʔ
bóp	bɔp˦˥
bọp	bɔp˨ˀ˩ʔ
bớt	bɤk˦˥
bợt	bɤk˨ˀ˩ʔ
bột	bokp˨ˀ˩ʔ
bọt	bɔkp˨ˀ˩ʔ
búa	buə˩˧
bùa	buə˦˨
bủa	buə˧˩˨
bừa	bɯə˦˨
bữa	bɯə˧˩˨
bữa,	bɯə˧˩˨
bu	bu˧˥
bú	bu˩˧
bù	bu˦˨
bủ	bu˧˩˨
bụ	bu˨ˀ˩ʔ
bư	bɯ˧˥
bứ	bɯ˩˧
bự	bɯ˨ˀ˩ʔ
bức	bɯk˦˥
bực	bɯk˨ˀ˩ʔ
bui	buj˧˥
búi	buj˩˧
bùi	buj˦˨
bụi	buj˨ˀ˩ʔ
bum	bum˧˥
bùm	bum˦˨
bun	buŋm˧˥
bún	buŋm˩˧
bùn	buŋm˦˨
bủn	buŋm˧˩˨
bung	buŋm˧˥
búng	buŋm˩˧
bùng	buŋm˦˨
bủng	buŋm˧˩˨
bụng	buŋm˨ˀ˩ʔ
bụng,	buŋm˨ˀ˩ʔ
bưng	bɯŋ˧˥
bưng;	bɯŋ˧˥
bừng	bɯŋ˦˨
bửng	bɯŋ˧˩˨
buộc	buək˨ˀ˩ʔ
bước	bɯək˦˥
buổi	buəj˧˩˨
bưởi	bɯəj˧˩˨
buồm	buəm˦˨
bươm	bɯəm˧˥
bướm	bɯəm˩˧
buôn	buəŋ˧˥
buồn	buəŋ˦˨
bươn	bɯəŋ˧˥
buông	buəŋ˧˥
buồng	buəŋ˦˨
bương	bɯəŋ˧˥
bướng	bɯəŋ˩˧
buốt	buək˦˥
buột	buək˨ˀ˩ʔ
bươu	bɯəw˧˥
bướu	bɯəw˩˧
búp	bup˦˥
bút	bukp˦˥
bụt	bukp˨ˀ˩ʔ
bụt,	bukp˨ˀ˩ʔ
bứt	bɯk˦˥
bưu	bɯw˧˥
bửu	bɯw˧˩˨
cách	kak˦˥
cạch	kak˨ˀ˩ʔ
các	kak˦˥
cắc	kăk˦˥
cạc	kak˨ˀ˩ʔ
cặc	kăk˨ˀ˩ʔ
cấc	kɤ̆k˦˥
các-tông	kak˦˥-toŋm˧˥
cai	kaj˧˥
cái	kaj˩˧
cái,	kaj˩˧
cài	kaj˦˨
cãi	kaj˧˩˨
cải	kaj˧˩˨
ca	ka˧˥
cá	ka˩˧
cá,	ka˩˧
cà	ka˦˨
cả	ka˧˩˨
cả,	ka˧˩˨
cả;	ka˧˩˨
cam	kam˧˥
cám	kam˩˧
cám,	kam˩˧
căm	kăm˧˥
cắm	kăm˩˧
cằm	kăm˦˨
cảm	kam˧˩˨
cạm	kam˨ˀ˩ʔ
cặm	kăm˨ˀ˩ʔ
câm	kɤ̆m˧˥
cấm	kɤ̆m˩˧
cầm	kɤ̆m˦˨
cầm,	kɤ̆m˦˨
cẩm	kɤ̆m˧˩˨
cậm	kɤ̆m˨ˀ˩ʔ
cang	kaŋ˧˥
cáng	kaŋ˩˧
càng	kaŋ˦˨
càng	kaŋ˦˨
căng	kăŋ˧˥
cẳng	kăŋ˧˩˨
cảng	kaŋ˧˩˨
câng	kɤ̆ŋ˧˥
canh	kan˧˥
cánh	kan˩˧
cành	kan˦˨
cảnh	kan˧˩˨
cạnh	kan˨ˀ˩ʔ
can	kaŋ˧˥
cán	kaŋ˩˧
càn	kaŋ˦˨
căn	kăŋ˧˥
cắn	kăŋ˩˧
cằn	kăŋ˦˨
cẳn	kăŋ˧˩˨
cản	kaŋ˧˩˨
cạn	kaŋ˨ˀ˩ʔ
cặn	kăŋ˨ˀ˩ʔ
cân	kɤ̆ŋ˧˥
cân,	kɤ̆ŋ˧˥
cấn	kɤ̆ŋ˩˧
cần	kɤ̆ŋ˦˨
cần,	kɤ̆ŋ˦˨
cẩn	kɤ̆ŋ˧˩˨
cận	kɤ̆ŋ˨ˀ˩ʔ
cao	kaw˧˥
cao,	kaw˧˥
cáo	kaw˩˧
cáo,	kaw˩˧
cào	kaw˦˨
cảo	kaw˧˩˨
cạo	kaw˨ˀ˩ʔ
cà-phê	ka˦˨-fe˧˥
cáp	kap˦˥
cắp	kăp˦˥
cắp,	kăp˦˥
cạp	kap˨ˀ˩ʔ
cặp	kăp˨ˀ˩ʔ
cấp	kɤ̆p˦˥
cập	kɤ̆p˨ˀ˩ʔ
cát	kak˦˥
cắt	kăk˦˥
cất	kɤ̆k˦˥
cật	kɤ̆k˨ˀ˩ʔ
cau	kăw˧˥
cáu	kăw˩˧
càu	kăw˦˨
cảu	kăw˧˩˨
câu	kɤ̆w˧˥
câu,	kɤ̆w˧˥
cấu	kɤ̆w˩˧
cầu	kɤ̆w˦˨
cẩu	kɤ̆w˧˩˨
cậu	kɤ̆w˨ˀ˩ʔ
cay	kăj˧˥
cáy	kăj˩˧
cày	kăj˦˨
cày,	kăj˦˨
cảy	kăj˧˩˨
cạy	kăj˨ˀ˩ʔ
cây	kɤ̆j˧˥
cấy	kɤ̆j˩˧
cầy	kɤ̆j˦˨
cầy;	kɤ̆j˦˨
cậy	kɤ̆j˨ˀ˩ʔ
cha	ca˧˥
cha,	ca˧˥
chà	ca˦˨
chả	ca˧˩˨
chạ	ca˨ˀ˩ʔ
chác	cak˦˥
chắc	căk˦˥
chạc	cak˨ˀ˩ʔ
chặc	căk˨ˀ˩ʔ
chậc	cɤ̆k˨ˀ˩ʔ
chạch	cak˨ˀ˩ʔ
chai	caj˧˥
chài	caj˦˨
chài,	caj˦˨
chải	caj˧˩˨
cham	cam˧˥
chàm	cam˦˨
chăm	căm˧˥
chằm	căm˦˨
chạm	cam˨ˀ˩ʔ
châm	cɤ̆m˧˥
chấm	cɤ̆m˩˧
chầm	cɤ̆m˦˨
chẩm	cɤ̆m˧˩˨
chậm	cɤ̆m˨ˀ˩ʔ
chan	caŋ˧˥
chán	caŋ˩˧
chăn	căŋ˧˥
chắn	căŋ˩˧
chằn	căŋ˦˨
chẵn	căŋ˧˩˨
chặn	căŋ˨ˀ˩ʔ
chân	cɤ̆ŋ˧˥
chân,	cɤ̆ŋ˧˥
chấn	cɤ̆ŋ˩˧
chần	cɤ̆ŋ˦˨
chẩn	cɤ̆ŋ˧˩˨
chận	cɤ̆ŋ˨ˀ˩ʔ
chang	caŋ˧˥
chàng	caŋ˦˨
chàng,	caŋ˦˨
chăng	căŋ˧˥
chằng	căŋ˦˨
chằng,	căŋ˦˨
chẳng	căŋ˧˩˨
chảng	caŋ˧˩˨
chạng	caŋ˨ˀ˩ʔ
chặng	căŋ˨ˀ˩ʔ
châng	cɤ̆ŋ˧˥
chanh	can˧˥
chánh	can˩˧
chành	can˦˨
chảnh	can˧˩˨
chạnh	can˨ˀ˩ʔ
chao	caw˧˥
cháo	caw˩˧
chào	caw˦˨
chão	caw˧˩˨
chảo	caw˧˩˨
chạo	caw˨ˀ˩ʔ
chắp	căp˦˥
chạp	cap˨ˀ˩ʔ
chạp,	cap˨ˀ˩ʔ
chặp	căp˨ˀ˩ʔ
chấp	cɤ̆p˦˥
chập	cɤ̆p˨ˀ˩ʔ
chát	cak˦˥
chắt	căk˦˥
chặt	căk˨ˀ˩ʔ
chất	cɤ̆k˦˥
chật	cɤ̆k˨ˀ˩ʔ
chau	căw˧˥
cháu	căw˩˧
chàu	căw˦˨
chảu	căw˧˩˨
châu	cɤ̆w˧˥
chấu	cɤ̆w˩˧
chầu	cɤ̆w˦˨
chầu,	cɤ̆w˦˨
chẫu	cɤ̆w˧˩˨
chậu	cɤ̆w˨ˀ˩ʔ
chậu,	cɤ̆w˨ˀ˩ʔ
chay	căj˧˥
chay,	căj˧˥
cháy	căj˩˧
cháy,	căj˩˧
chày	căj˦˨
chày,	căj˦˨
chảy	căj˧˩˨
chạy	căj˨ˀ˩ʔ
chây	cɤ̆j˧˥
chấy	cɤ̆j˩˧
chầy	cɤ̆j˦˨
chê	ce˧˥
chê,	ce˧˥
chế	ce˩˧
chề	ce˦˨
che	cɛ˧˥
chè	cɛ˦˨
chẻ	cɛ˧˩˨
chếch	cet˦˥
chệch	cet˨ˀ˩ʔ
chêm	cem˧˥
chềm	cem˦˨
chễm	cem˧˩˨
chem	cɛm˧˥
chém	cɛm˩˧
chèm	cɛm˦˨
chẻm	cɛm˧˩˨
chen	cɛŋ˧˥
chén	cɛŋ˩˧
chèn	cɛŋ˦˨
chẻn	cɛŋ˧˩˨
chẹn	cɛŋ˨ˀ˩ʔ
cheng	cɛŋ˧˥
chênh	cen˧˥
chếnh	cen˩˧
chềnh	cen˦˨
chễnh	cen˧˩˨
chểnh	cen˧˩˨
chệnh	cen˨ˀ˩ʔ
cheo	ceo˧˥
chéo	ceo˩˧
chèo	ceo˦˨
chẻo	ceo˧˩˨
chép	cɛp˦˥
chẹp	cɛp˨ˀ˩ʔ
chết	cet˦˥
chết,	cet˦˥
chét	cɛk˦˥
chẹt	cɛk˨ˀ˩ʔ
chêu	cɛu˧˥
chia	ciə˧˥
chìa	ciə˦˨
chĩa	ciə˧˩˨
chích	cit˦˥
chi	ci˧˥
chí	ci˩˧
chí,	ci˩˧
chì	ci˦˨
chỉ	ci˧˩˨
chị	ci˨ˀ˩ʔ
chiếc	ciək˦˥
chiêm	ciəm˧˥
chiếm	ciəm˩˧
chiên	ciəŋ˧˥
chiến	ciəŋ˩˧
chiền	ciəŋ˦˨
chiêng	ciəŋ˧˥
chiếng,	ciəŋ˩˧
chiềng	ciəŋ˦˨
chiếp	ciəp˦˥
chiết	ciək˦˥
chiêu	ciəw˧˥
chiếu	ciəw˩˧
chiều	ciəw˦˨
chiều;	ciəw˦˨
chiểu	ciəw˧˩˨
chim	cim˧˥
chìm	cim˦˨
chin	cin˧˥
chín	cin˩˧
chỉn	cin˧˩˨
chinh	cin˧˥
chính	cin˩˧
chính,	cin˩˧
chình	cin˦˨
chĩnh	cin˧˩˨
chỉnh	cin˧˩˨
chíp	cip˦˥
chít	cit˦˥
chiu	ciw˧˥
chíu	ciw˩˧
chịu	ciw˨ˀ˩ʔ
choác	cwak˦˥
choạc	cwak˨ˀ˩ʔ
choá	cwa˩˧
choai	cwaj˧˥
choàm	cwam˦˨
choăn	cwăŋ˧˥
choang	cwaŋ˧˥
choáng	cwaŋ˩˧
choàng	cwaŋ˦˨
choạng	cwaŋ˨ˀ˩ʔ
choắt	cwăk˦˥
chốc	cokp˦˥
chóc	cɔkp˦˥
chọc	cɔkp˨ˀ˩ʔ
chơ	cɤ˧˥
chớ	cɤ˩˧
chờ	cɤ˦˨
chở	cɤ˧˩˨
chợ	cɤ˨ˀ˩ʔ
chợ,	cɤ˨ˀ˩ʔ
chô	co˧˥
chỗ	co˧˩˨
chỗ,	co˧˩˨
cho	cɔ˧˥
cho,	cɔ˧˥
chó	cɔ˩˧
chò	cɔ˦˨
chõ	cɔ˧˩˨
choe	cwe˧˥
choen	cwen˧˥
choèn	cwen˦˨
chơi	cɤj˧˥
chới	cɤj˩˧
chối	coj˩˧
chồi	coj˦˨
chổi	coj˧˩˨
choi	cɔj˧˥
chói	cɔj˩˧
chòi	cɔj˦˨
chọi	cɔj˨ˀ˩ʔ
chơm	cɤm˧˥
chớm	cɤm˩˧
chờm	cɤm˦˨
chôm	com˧˥
chồm	com˦˨
chòm	cɔm˦˨
chõm	cɔm˧˩˨
chỏm	cɔm˧˩˨
chơn	cɤŋ˧˥
chờn	cɤŋ˦˨
chôn	coŋm˧˥
chốn	coŋm˩˧
chồn	coŋm˦˨
chộn	coŋm˨ˀ˩ʔ
chon	cɔŋm˧˥
chỏn	cɔŋm˧˩˨
chọn	cɔŋm˨ˀ˩ʔ
chông	coŋm˧˥
chống	coŋm˩˧
chồng	coŋm˦˨
chổng	coŋm˧˩˨
chong	cɔŋm˧˥
chóng	cɔŋm˩˧
chóng,	cɔŋm˩˧
chòng	cɔŋm˦˨
chỏng	cɔŋm˧˩˨
chớp	cɤp˦˥
chợp	cɤp˨ˀ˩ʔ
chộp	cop˨ˀ˩ʔ
chóp	cɔp˦˥
chớt	cɤk˦˥
chốt	cokp˦˥
chột	cokp˨ˀ˩ʔ
chót	cɔkp˦˥
chua	cuə˧˥
chúa	cuə˩˧
chúa,	cuə˩˧
chúa;	cuə˩˧
chùa	cuə˦˨
chưa	cɯə˧˥
chứa	cɯə˩˧
chừa	cɯə˦˨
chữa	cɯə˧˩˨
chửa	cɯə˧˩˨
chuẩn	cwɤ̆ŋ˧˩˨
chúc	cukp˦˥
chục	cukp˨ˀ˩ʔ
chức	cɯk˦˥
chực	cɯk˨ˀ˩ʔ
chực,	cɯk˨ˀ˩ʔ
chu	cu˧˥
chú	cu˩˧
chù	cu˦˨
(chủ	cu˧˩˨
chủ	cu˧˩˨
chủ,	cu˧˩˨
chư	cɯ˧˥
chứ	cɯ˩˧
chừ	cɯ˦˨
chữ	cɯ˧˩˨
chuếch	cwet˦˥
chuệch	cwet˨ˀ˩ʔ
chuế	cwe˩˧
chuếnh	cwen˩˧
chuểnh	cwen˧˩˨
chuệnh	cwen˨ˀ˩ʔ
chui	cuj˧˥
chúi	cuj˩˧
chùi	cuj˦˨
chửi	cɯj˧˩˨
chum	cum˧˥
chúm	cum˩˧
chùm	cum˦˨
chũm	cum˧˩˨
chụm	cum˨ˀ˩ʔ
chun	cuŋm˧˥
chùn	cuŋm˦˨
chũn	cuŋm˧˩˨
chủn	cuŋm˧˩˨
chung	cuŋm˧˥
chúng	cuŋm˩˧
chùng	cuŋm˦˨
chùng,	cuŋm˦˨
chủng	cuŋm˧˩˨
chưng	cɯŋ˧˥
chứng	cɯŋ˩˧
chừng	cɯŋ˦˨
chừng,	cɯŋ˦˨
chững	cɯŋ˧˩˨
chuốc	cuək˦˥
chuộc	cuək˨ˀ˩ʔ
chước	cɯək˦˥
chuôi	cuəj˧˥
chuôi;	cuəj˧˥
chuối	cuəj˩˧
chuồi	cuəj˦˨
chuỗi	cuəj˧˩˨
chuội	cuəj˨ˀ˩ʔ
chuôm	cuəm˧˥
chuồn	cuəŋ˦˨
chuông	cuəŋ˧˥
chuồng	cuəŋ˦˨
chuộng	cuəŋ˨ˀ˩ʔ
chương	cɯəŋ˧˥
chướng	cɯəŋ˩˧
chưởng	cɯəŋ˧˩˨
chuốt	cuək˦˥
chuột	cuək˨ˀ˩ʔ
chụp	cup˨ˀ˩ʔ
chút	cukp˦˥
chụt	cukp˨ˀ˩ʔ
chuyên	cwiəŋ˧˥
chuyến	cwiəŋ˩˧
chuyền	cwiəŋ˦˨
chuyển	cwiəŋ˧˩˨
chuyện	cwiəŋ˨ˀ˩ʔ
cốc	kokp˦˥
cốc;	kokp˦˥
cộc	kokp˨ˀ˩ʔ
cóc	kɔkp˦˥
cóc,	kɔkp˦˥
cọc	kɔkp˨ˀ˩ʔ
cô-đê	ko˧˥-de˧˥
cơi	kɤj˧˥
cời	kɤj˦˨
cởi	kɤj˧˩˨
côi	koj˧˥
cối	koj˩˧
cỗi	koj˧˩˨
cổi	koj˧˩˨
cội	koj˨ˀ˩ʔ
cội,	koj˨ˀ˩ʔ
coi	kɔj˧˥
cói	kɔj˩˧
còi	kɔj˦˨
cõi	kɔj˧˩˨
cơ	kɤ˧˥
cớ	kɤ˩˧
cờ	kɤ˦˨
cờ,	kɤ˦˨
cô	ko˧˥
cố	ko˩˧
cồ	ko˦˨
cỗ	ko˧˩˨
cổ	ko˧˩˨
cổ,	ko˧˩˨
cổ;	ko˧˩˨
co	kɔ˧˥
có	kɔ˩˧
có,	kɔ˩˧
cò	kɔ˦˨
cò,	kɔ˦˨
cỏ	kɔ˧˩˨
cọ	kɔ˨ˀ˩ʔ
cơm	kɤm˧˥
cơm,	kɤm˧˥
côm	kom˧˥
cốm	kom˩˧
cồm	kom˦˨
com	kɔm˧˥
cóm	kɔm˩˧
còm	kɔm˦˨
cỏm	kɔm˧˩˨
cọm	kɔm˨ˀ˩ʔ
công	koŋm˧˥
cống	koŋm˩˧
cồng	koŋm˦˨
cổng	koŋm˧˩˨
cộng	koŋm˨ˀ˩ʔ
cong	kɔŋm˧˥
cong,	kɔŋm˧˥
cóng	kɔŋm˩˧
còng	kɔŋm˦˨
cõng	kɔŋm˧˩˨
cỏng	kɔŋm˧˩˨
công-xinh	koŋm˧˥-sin˧˥
cơn	kɤŋ˧˥
cớn	kɤŋ˩˧
cờn	kɤŋ˦˨
cỡn	kɤŋ˧˩˨
côn	koŋm˧˥
cồn	koŋm˦˨
cổn	koŋm˧˩˨
con	kɔŋm˧˥
con,	kɔŋm˧˥
còn	kɔŋm˦˨
cỏn	kɔŋm˧˩˨
coóc	kɔkp˦˥
cốp	kop˦˥
cóp	kɔp˦˥
cọp	kɔp˨ˀ˩ʔ
cớt	kɤk˦˥
cợt	kɤk˨ˀ˩ʔ
cốt	kokp˦˥
cột	kokp˨ˀ˩ʔ
cót	kɔkp˦˥
cọt	kɔkp˨ˀ˩ʔ
cua	kuə˧˥
của	kuə˧˩˨
của;	kuə˧˩˨
cưa	kɯə˧˥
cưa,	kɯə˧˥
cứa	kɯə˩˧
cửa	kɯə˧˩˨
cựa	kɯə˨ˀ˩ʔ
cúc	kukp˦˥
cục	kukp˨ˀ˩ʔ
cức	kɯk˦˥
cực	kɯk˨ˀ˩ʔ
cui	kuj˧˥
cúi	kuj˩˧
cùi	kuj˦˨
cũi	kuj˧˩˨
củi	kuj˧˩˨
cụi	kuj˨ˀ˩ʔ
cửi	kɯj˧˩˨
cu	ku˧˥
cú	ku˩˧
cù	ku˦˨
cũ	ku˧˩˨
cũ,	ku˧˩˨
củ	ku˧˩˨
cụ	ku˨ˀ˩ʔ
cư	kɯ˧˥
cứ	kɯ˩˧
cừ	kɯ˦˨
cử	kɯ˧˩˨
cự	kɯ˨ˀ˩ʔ
cum	kum˧˥
cúm	kum˩˧
cùm	kum˦˨
cụm	kum˨ˀ˩ʔ
cung	kuŋm˧˥
cúng	kuŋm˩˧
cùng	kuŋm˦˨
cũng	kuŋm˧˩˨
củng	kuŋm˧˩˨
cụng	kuŋm˨ˀ˩ʔ
cưng	kɯŋ˧˥
cứng	kɯŋ˩˧
cun	kuŋm˧˥
cùn	kuŋm˦˨
cũn	kuŋm˧˩˨
cuốc	kuək˦˥
cuộc	kuək˨ˀ˩ʔ
cước	kɯək˦˥
cuối	kuəj˩˧
cuội	kuəj˨ˀ˩ʔ
cưới	kɯəj˩˧
cười	kɯəj˦˨
cưỡi	kɯəj˧˩˨
cườm	kɯəm˦˨
cuống	kuəŋ˩˧
cuồng	kuəŋ˦˨
cuộng	kuəŋ˨ˀ˩ʔ
cương	kɯəŋ˧˥
cường	kɯəŋ˦˨
cưỡng	kɯəŋ˧˩˨
cuốn	kuəŋ˩˧
cuồn	kuəŋ˦˨
cuộn	kuəŋ˨ˀ˩ʔ
cướp	kɯəp˦˥
cúp	kup˦˥
cụp	kup˨ˀ˩ʔ
cút	kukp˦˥
cụt	kukp˨ˀ˩ʔ
cứt	kɯk˦˥
cưu	kɯw˧˥
cứu	kɯw˩˧
cừu	kɯw˦˨
cửu	kɯw˧˩˨
cựu	kɯw˨ˀ˩ʔ
đắc	dăk˦˥
Đắc	dăk˦˥
đắc	dăk˦˥
đạc	dak˨ˀ˩ʔ
đặc	dăk˨ˀ˩ʔ
đách	dak˦˥
dạc	jak˨ˀ˩ʔ
dặc	jăk˨ˀ˩ʔ
Đa	da˧˥
đa	da˧˥
đá	da˩˧
đá,	da˩˧
Đà	da˦˨
đà	da˦˨
Đà	da˦˨
đà	da˦˨
đã	da˧˩˨
đả	da˧˩˨
đai	daj˧˥
đái	daj˩˧
đài	daj˦˨
đãi	daj˧˩˨
đại	daj˨ˀ˩ʔ
Đại	daj˨ˀ˩ʔ
đại	daj˨ˀ˩ʔ
Đại	daj˨ˀ˩ʔ
đại	daj˨ˀ˩ʔ
Đại	daj˨ˀ˩ʔ
đại	daj˨ˀ˩ʔ
Đại	daj˨ˀ˩ʔ
đại	daj˨ˀ˩ʔ
đại,	daj˨ˀ˩ʔ
dai	jaj˧˥
dái	jaj˩˧
dài	jaj˦˨
dài,	jaj˦˨
dãi	jaj˧˩˨
dải	jaj˧˩˨
dại	jaj˨ˀ˩ʔ
dại,	jaj˨ˀ˩ʔ
da	ja˧˥
da,	ja˧˥
dà	ja˦˨
dã	ja˧˩˨
dạ	ja˨ˀ˩ʔ
dạ,	ja˨ˀ˩ʔ
dạ;	ja˨ˀ˩ʔ
đam	dam˧˥
đám	dam˩˧
đàm	dam˦˨
đăm	dăm˧˥
đắm	dăm˩˧
đằm	dăm˦˨
đẵm	dăm˧˩˨
đảm	dam˧˩˨
đạm	dam˨ˀ˩ʔ
đặm	dăm˨ˀ˩ʔ
đâm	dɤ̆m˧˥
đấm	dɤ̆m˩˧
đầm	dɤ̆m˦˨
đẫm	dɤ̆m˧˩˨
đậm	dɤ̆m˨ˀ˩ʔ
dám	jam˩˧
dăm	jăm˧˥
dắm	jăm˩˧
dạm	jam˨ˀ˩ʔ
dặm	jăm˨ˀ˩ʔ
dâm	jɤ̆m˧˥
dấm	jɤ̆m˩˧
dầm	jɤ̆m˦˨
dẫm	jɤ̆m˧˩˨
dậm	jɤ̆m˨ˀ˩ʔ
đan	daŋ˧˥
Đan	daŋ˧˥
đan	daŋ˧˥
đàn	daŋ˦˨
đàn,	daŋ˦˨
đắn	dăŋ˩˧
đản	daŋ˧˩˨
đạn	daŋ˨ˀ˩ʔ
đần	dɤ̆ŋ˦˨
đẫn	dɤ̆ŋ˧˩˨
đận	dɤ̆ŋ˨ˀ˩ʔ
đang	daŋ˧˥
đáng	daŋ˩˧
đàng	daŋ˦˨
đăng	dăŋ˧˥
Đăng	dăŋ˧˥
đắng	dăŋ˩˧
đằng	dăŋ˦˨
đẳng	dăŋ˧˩˨
đãng	daŋ˧˩˨
đảng	daŋ˧˩˨
Đảng	daŋ˧˩˨
đảng	daŋ˧˩˨
đấng	dɤ̆ŋ˩˧
đấng,	dɤ̆ŋ˩˧
dang	jaŋ˧˥
dáng	jaŋ˩˧
dàng	jaŋ˦˨
dăng	jăŋ˧˥
dằng	jăŋ˦˨
dằng;	jăŋ˦˨
dẳng	jăŋ˧˩˨
dạng	jaŋ˨ˀ˩ʔ
dặng	jăŋ˨ˀ˩ʔ
dâng	jɤ̆ŋ˧˥
đanh	dan˧˥
đánh	dan˩˧
Đánh	dan˩˧
đánh	dan˩˧
đành	dan˦˨
danh	jan˧˥
dành	jan˦˨
dan	jaŋ˧˥
dán	jaŋ˩˧
dàn	jaŋ˦˨
dăn	jăŋ˧˥
dằn	jăŋ˦˨
dẳn	jăŋ˧˩˨
dãn	jaŋ˧˩˨
dạn	jaŋ˨ˀ˩ʔ
dặn	jăŋ˨ˀ˩ʔ
(dân	jɤ̆ŋ˧˥
dân	jɤ̆ŋ˧˥
dấn	jɤ̆ŋ˩˧
dần	jɤ̆ŋ˦˨
dẫn	jɤ̆ŋ˧˩˨
dận	jɤ̆ŋ˨ˀ˩ʔ
đao	daw˧˥
đáo	daw˩˧
đào	daw˦˨
đảo	daw˧˩˨
đảo;	daw˧˩˨
đạo	daw˨ˀ˩ʔ
Đạo	daw˨ˀ˩ʔ
đạo	daw˨ˀ˩ʔ
dao	jaw˧˥
dáo	jaw˩˧
dào	jaw˦˨
dạo	jaw˨ˀ˩ʔ
đáp	dap˦˥
đắp	dăp˦˥
đạp	dap˨ˀ˩ʔ
đập	dɤ̆p˨ˀ˩ʔ
dấp	jɤ̆p˦˥
dập	jɤ̆p˨ˀ˩ʔ
đắt	dăk˦˥
đạt	dak˨ˀ˩ʔ
đặt	dăk˨ˀ˩ʔ
đất	dɤ̆k˦˥
Đất	dɤ̆k˦˥
đất	dɤ̆k˦˥
đất,	dɤ̆k˦˥
dát	jak˦˥
dắt	jăk˦˥
dạt	jak˨ˀ˩ʔ
dặt	jăk˨ˀ˩ʔ
dật	jɤ̆k˨ˀ˩ʔ
đạt-lai	dak˨ˀ˩ʔ-laj˧˥
đau	dăw˧˥
đau,	dăw˧˥
đâu	dɤ̆w˧˥
đâu,	dɤ̆w˧˥
đấu	dɤ̆w˩˧
đầu	dɤ̆w˦˨
đầu,	dɤ̆w˦˨
đẩu	dɤ̆w˧˩˨
đậu	dɤ̆w˨ˀ˩ʔ
đậu,	dɤ̆w˨ˀ˩ʔ
dáu	jăw˩˧
dàu	jăw˦˨
dâu	jɤ̆w˧˥
dấu	jɤ̆w˩˧
dầu	jɤ̆w˦˨
dẫu	jɤ̆w˧˩˨
dậu	jɤ̆w˨ˀ˩ʔ
đay	dăj˧˥
đáy	dăj˩˧
đày	dăj˦˨
đây	dɤ̆j˧˥
đấy	dɤ̆j˩˧
đầy	dɤ̆j˦˨
đẫy	dɤ̆j˧˩˨
đẩy	dɤ̆j˧˩˨
đậy	dɤ̆j˨ˀ˩ʔ
day	jăj˧˥
dày	jăj˦˨
dãy	jăj˧˩˨
dảy	jăj˧˩˨
dạy	jăj˨ˀ˩ʔ
dây	jɤ̆j˧˥
dây,	jɤ̆j˧˥
dấy	jɤ̆j˩˧
dẫy	jɤ̆j˧˩˨
dậy	jɤ̆j˨ˀ˩ʔ
đếch	det˦˥
đê	de˧˥
đế	de˩˧
Đế	de˩˧
đế	de˩˧
đề	de˦˨
để	de˧˩˨
để,	de˧˩˨
đệ	de˨ˀ˩ʔ
đệ;	de˨ˀ˩ʔ
đe	dɛ˧˥
đè	dɛ˦˨
đẻ	dɛ˧˩˨
đẻ,	dɛ˧˩˨
dê	je˧˥
dế	je˩˧
dề	je˦˨
dễ	je˧˩˨
dể	je˧˩˨
de	jɛ˧˥
dé	jɛ˩˧
dè	jɛ˦˨
dẽ	jɛ˧˩˨
dẻ	jɛ˧˩˨
đêm	dem˧˥
đếm	dem˩˧
đệm	dem˨ˀ˩ʔ
đem	dɛm˧˥
đèm	dɛm˦˨
đến	den˩˧
đền	den˦˨
Đền	den˦˨
đền	den˦˨
đen	dɛŋ˧˥
đèn	dɛŋ˦˨
Đèn	dɛŋ˦˨
đèn	dɛŋ˦˨
đèn,	dɛŋ˦˨
đẹn	dɛŋ˨ˀ˩ʔ
đềnh	den˦˨
đễnh	den˧˩˨
đểnh	den˧˩˨
dềnh	jen˦˨
dệnh	jen˨ˀ˩ʔ
dền	jen˦˨
dèn	jɛŋ˦˨
đeo	deo˧˥
đéo	deo˩˧
đèo	deo˦˨
đẽo	deo˧˩˨
deo	jeo˧˥
dẻo	jeo˧˩˨
dẻo,	jeo˧˩˨
đẹp	dɛp˨ˀ˩ʔ
dép	jɛp˦˥
dẹp	jɛp˨ˀ˩ʔ
đẹt	dɛk˨ˀ˩ʔ
dệt	jet˨ˀ˩ʔ
dẹt	jɛk˨ˀ˩ʔ
đều	dɛu˦˨
đều,	dɛu˦˨
đểu	dɛu˧˩˨
đĩa	diə˧˩˨
đĩa,	diə˧˩˨
đỉa	diə˧˩˨
đỉa;	diə˧˩˨
địa	diə˨ˀ˩ʔ
Địa	diə˨ˀ˩ʔ
địa	diə˨ˀ˩ʔ
đích	dit˦˥
địch	dit˨ˀ˩ʔ
dích	jit˦˥
dịch	jit˨ˀ˩ʔ
đi	di˧˥
đi,	di˧˥
đí	di˩˧
đì	di˦˨
đĩ	di˧˩˨
điếc	diək˦˥
diếc	jiək˦˥
diệc	jiək˨ˀ˩ʔ
điếm	diəm˩˧
điềm	diəm˦˨
điểm	diəm˧˩˨
diêm	jiəm˧˥
diềm	jiəm˦˨
diễm	jiəm˧˩˨
diệm	jiəm˨ˀ˩ʔ
điên	diəŋ˧˥
điền	diəŋ˦˨
điển	diəŋ˧˩˨
điện	diəŋ˨ˀ˩ʔ
diên	jiəŋ˧˥
diễn	jiəŋ˧˩˨
diện	jiəŋ˨ˀ˩ʔ
điệp	diəp˨ˀ˩ʔ
diếp	jiəp˦˥
diệp	jiəp˨ˀ˩ʔ
diệt	jiək˨ˀ˩ʔ
điêu	diəw˧˥
Điêu	diəw˧˥
điêu	diəw˧˥
Điêu	diəw˧˥
điêu	diəw˧˥
điếu	diəw˩˧
điều	diəw˦˨
điều,	diəw˦˨
điểu	diəw˧˩˨
điệu	diəw˨ˀ˩ʔ
diều	jiəw˦˨
diễu	jiəw˧˩˨
diệu	jiəw˨ˀ˩ʔ
di	ji˧˥
dí	ji˩˧
dì	ji˦˨
dĩ	ji˧˩˨
dỉ	ji˧˩˨
dị	ji˨ˀ˩ʔ
đinh	din˧˥
đính	din˩˧
đình	din˦˨
Đình	din˦˨
đình	din˦˨
Đình	din˦˨
đình	din˦˨
Đình	din˦˨
đình	din˦˨
Đình	din˦˨
đình	din˦˨
đĩnh	din˧˩˨
đỉnh	din˧˩˨
Định	din˨ˀ˩ʔ
định	din˨ˀ˩ʔ
Định	din˨ˀ˩ʔ
định	din˨ˀ˩ʔ
dinh	jin˧˥
dính	jin˩˧
dĩnh	jin˧˩˨
díp	jip˦˥
dịp	jip˨ˀ˩ʔ
đít	dit˦˥
địt	dit˨ˀ˩ʔ
đìu	diw˦˨
díu;	jiw˩˧
dìu	jiw˦˨
dịu	jiw˨ˀ˩ʔ
đoạ	dwa˨ˀ˩ʔ
đọa	dwa˨ˀ˩ʔ
đoái	dwaj˩˧
doạ	jwa˨ˀ˩ʔ
dọa	jwa˨ˀ˩ʔ
đoan	dwaŋ˧˥
Đoan	dwaŋ˧˥
đoan	dwaŋ˧˥
Đoan	dwaŋ˧˥
đoan	dwaŋ˧˥
Đoan	dwaŋ˧˥
đoan	dwaŋ˧˥
đoán	dwaŋ˩˧
(đoàn)	dwaŋ˦˨
đoàn	dwaŋ˦˨
đoản	dwaŋ˧˩˨
đoạn	dwaŋ˨ˀ˩ʔ
đoàng	dwaŋ˦˨
đoàng;	dwaŋ˦˨
đoảng	dwaŋ˧˩˨
đoảng,	dwaŋ˧˩˨
đoành	dwan˦˨
doanh	jwan˧˥
đoạt	dwak˨ˀ˩ʔ
đốc	dokp˦˥
Đốc	dokp˦˥
đốc	dokp˦˥
độc	dokp˨ˀ˩ʔ
đọc	dɔkp˨ˀ˩ʔ
dốc	jokp˦˥
dóc	jɔkp˦˥
dọc	jɔkp˨ˀ˩ʔ
đốc-tơ;	dokp˦˥-tɤ˧˥
đớ	dɤ˩˧
đờ	dɤ˦˨
đỡ	dɤ˧˩˨
đợ	dɤ˨ˀ˩ʔ
đô	do˧˥
đố	do˩˧
đồ	do˦˨
đỗ	do˧˩˨
đổ	do˧˩˨
"độ	do˨ˀ˩ʔ
độ	do˨ˀ˩ʔ
Độ	do˨ˀ˩ʔ
độ	do˨ˀ˩ʔ
Độ	do˨ˀ˩ʔ
độ	do˨ˀ˩ʔ
đo	dɔ˧˥
đó	dɔ˩˧
đó,	dɔ˩˧
đò	dɔ˦˨
đỏ	dɔ˧˩˨
đọ	dɔ˨ˀ˩ʔ
đới	dɤj˩˧
đời	dɤj˦˨
đời;	dɤj˦˨
đợi	dɤj˨ˀ˩ʔ
đôi	doj˧˥
Đôi	doj˧˥
đôi	doj˧˥
đối	doj˩˧
đồi	doj˦˨
đổi	doj˧˩˨
đội	doj˨ˀ˩ʔ
đoi	dɔj˧˥
đói	dɔj˩˧
đói,	dɔj˩˧
đòi	dɔj˦˨
đòi,	dɔj˦˨
đọi	dɔj˨ˀ˩ʔ
đọi,	dɔj˨ˀ˩ʔ
dơi	jɤj˧˥
dời	jɤj˦˨
dôi	joj˧˥
dối	joj˩˧
dồi	joj˦˨
dội	joj˨ˀ˩ʔ
doi	jɔj˧˥
dòi	jɔj˦˨
dõi	jɔj˧˩˨
dơ	jɤ˧˥
dớ	jɤ˩˧
dỡ	jɤ˧˩˨
dở	jɤ˧˩˨
dô	jo˧˥
dỗ	jo˧˩˨
do	jɔ˧˥
dó	jɔ˩˧
dò	jɔ˦˨
dò,	jɔ˦˨
dọ	jɔ˨ˀ˩ʔ
đơm	dɤm˧˥
đởm	dɤm˧˩˨
đôm	dom˧˥
đốm	dom˩˧
đồm	dom˦˨
đom	dɔm˧˥
đóm	dɔm˩˧
đòm	dɔm˦˨
đỏm	dɔm˧˩˨
đờ-mi	dɤ˦˨-mi˧˥
dòm	jɔm˦˨
đơn	dɤŋ˧˥
đớn	dɤŋ˩˧
đờn	dɤŋ˦˨
Đôn	doŋm˧˥
đôn	doŋm˧˥
đốn	doŋm˩˧
đồn	doŋm˦˨
độn	doŋm˨ˀ˩ʔ
đon	dɔŋm˧˥
đón	dɔŋm˩˧
đòn	dɔŋm˦˨
đông	doŋm˧˥
Đông	doŋm˧˥
đông	doŋm˧˥
Đông	doŋm˧˥
đông	doŋm˧˥
đông,	doŋm˧˥
đống	doŋm˩˧
đồng	doŋm˦˨
đồng,	doŋm˦˨
Đổng	doŋm˧˩˨
đổng	doŋm˧˩˨
động	doŋm˨ˀ˩ʔ
đong	dɔŋm˧˥
đóng	dɔŋm˩˧
đòng	dɔŋm˦˨
đỏng	dɔŋm˧˩˨
đọng	dɔŋm˨ˀ˩ʔ
dông	joŋm˧˥
dồng	joŋm˦˨
dộng	joŋm˨ˀ˩ʔ
dong	jɔŋm˧˥
dong;	jɔŋm˧˥
dóng	jɔŋm˩˧
dòng	jɔŋm˦˨
dõng	jɔŋm˧˩˨
Đông-nam	doŋm˧˥-nam˧˥
dớn	jɤŋ˩˧
dờn	jɤŋ˦˨
dồn	joŋm˦˨
dọn	jɔŋm˨ˀ˩ʔ
đớp	dɤp˦˥
đốp	dop˦˥
độp	dop˨ˀ˩ʔ
đốt	dokp˦˥
đột	dokp˨ˀ˩ʔ
dốt	jokp˦˥
dột	jokp˨ˀ˩ʔ
đua	duə˧˥
đùa	duə˦˨
đũa	duə˧˩˨
đũa;	duə˧˩˨
đưa	dɯə˧˥
đứa	dɯə˩˧
dua	juə˧˥
dưa	jɯə˧˥
dưa,	jɯə˧˥
dứa	jɯə˩˧
dừa	jɯə˦˨
dựa	jɯə˨ˀ˩ʔ
duật	jwɤ̆k˨ˀ˩ʔ
đúc	dukp˦˥
đục	dukp˨ˀ˩ʔ
đục,	dukp˨ˀ˩ʔ
Đức	dɯk˦˥
đức	dɯk˦˥
Đức	dɯk˦˥
đức	dɯk˦˥
Đức	dɯk˦˥
đực	dɯk˨ˀ˩ʔ
dục	jukp˨ˀ˩ʔ
dức	jɯk˦˥
đu	du˧˥
đú	du˩˧
đú,	du˩˧
đù	du˦˨
đủ	du˧˩˨
đụ	du˨ˀ˩ʔ
đứ	dɯ˩˧
đử	dɯ˧˩˨
đuềnh	dwen˦˨
đuễnh	dwen˧˩˨
đuểnh	dwen˧˩˨
duềnh	jwen˦˨
đui	duj˧˥
đùi	duj˦˨
dúi	juj˩˧
dùi	juj˦˨
du	ju˧˥
dù	ju˦˨
dũ	ju˧˩˨
dụ	ju˨ˀ˩ʔ
dư	jɯ˧˥
dừ	jɯ˦˨
dừ;	jɯ˦˨
dữ	jɯ˧˩˨
dử	jɯ˧˩˨
dự	jɯ˨ˀ˩ʔ
đum	dum˧˥
đùm	dum˦˨
dúm	jum˩˧
dụm	jum˨ˀ˩ʔ
đun	duŋm˧˥
đún	duŋm˩˧
đùn	duŋm˦˨
đụn	duŋm˨ˀ˩ʔ
đung	duŋm˧˥
đúng	duŋm˩˧
đùng	duŋm˦˨
đũng	duŋm˧˩˨
đủng	duŋm˧˩˨
đụng	duŋm˨ˀ˩ʔ
đứng	dɯŋ˩˧
đừng	dɯŋ˦˨
đựng	dɯŋ˨ˀ˩ʔ
dung	juŋm˧˥
dúng	juŋm˩˧
dùng	juŋm˦˨
dũng	juŋm˧˩˨
dụng	juŋm˨ˀ˩ʔ
dưng	jɯŋ˧˥
dừng	jɯŋ˦˨
dửng	jɯŋ˧˩˨
dựng	jɯŋ˨ˀ˩ʔ
dun	juŋm˧˥
dún	juŋm˩˧
đuốc	duək˦˥
được	dɯək˨ˀ˩ʔ
được,	dɯək˨ˀ˩ʔ
duốc	juək˦˥
dược	jɯək˨ˀ˩ʔ
đuôi	duəj˧˥
đuối	duəj˩˧
đuổi	duəj˧˩˨
đười	dɯəj˦˨
duỗi	juəj˧˩˨
dưới	jɯəj˩˧
đượm	dɯəm˨ˀ˩ʔ
đuồn	duəŋ˦˨
đườn	dɯəŋ˦˨
đương	dɯəŋ˧˥
đường	dɯəŋ˦˨
Đường	dɯəŋ˦˨
đường	dɯəŋ˦˨
Đường	dɯəŋ˦˨
đường	dɯəŋ˦˨
Đường	dɯəŋ˦˨
đường	dɯəŋ˦˨
Đường	dɯəŋ˦˨
đường	dɯəŋ˦˨
đường,	dɯəŋ˦˨
dương	jɯəŋ˧˥
dường	jɯəŋ˦˨
dưỡng	jɯəŋ˧˩˨
đút	dukp˦˥
đứt	dɯk˦˥
dút	jukp˦˥
dứt	jɯk˦˥
duyên	jwiəŋ˧˥
duyệt	jwiək˨ˀ˩ʔ
duy	jwi˧˥
éc	ɛk˦˥
ẹc	ɛk˨ˀ˩ʔ
ếch	et˦˥
ê	e˧˥
ê,	e˧˥
ế	e˩˧
ề	e˦˨
e	ɛ˧˥
é	ɛ˩˧
è	ɛ˦˨
ẹ	ɛ˨ˀ˩ʔ
êm	em˧˥
Êm	em˧˥
êm	em˧˥
em	ɛm˧˥
ém	ɛm˩˧
en	ɛŋ˧˥
én	ɛŋ˩˧
ễng	en˧˩˨
eng	ɛŋ˧˥
èng	ɛŋ˦˨
ềnh	en˦˨
ễnh	en˧˩˨
eo	eo˧˥
éo	eo˩˧
èo	eo˦˨
ẽo	eo˧˩˨
ẻo	eo˧˩˨
ẹo	eo˨ˀ˩ʔ
ép	ɛp˦˥
ét	ɛk˦˥
êu	ɛu˧˥
gác	ɣak˦˥
gạc	ɣak˨ˀ˩ʔ
gặc	ɣăk˨ˀ˩ʔ
gạch	ɣak˨ˀ˩ʔ
ga	ɣa˧˥
gá	ɣa˩˧
gà	ɣa˦˨
gà,	ɣa˦˨
gả	ɣa˧˩˨
gạ	ɣa˨ˀ˩ʔ
gai	ɣaj˧˥
gái	ɣaj˩˧
gái,	ɣaj˩˧
gài	ɣaj˦˨
gãi	ɣaj˧˩˨
gãi,	ɣaj˧˩˨
găm	ɣăm˧˥
gắm	ɣăm˩˧
gằm	ɣăm˦˨
gặm	ɣăm˨ˀ˩ʔ
gâm	ɣɤ̆m˧˥
gấm	ɣɤ̆m˩˧
gầm	ɣɤ̆m˦˨
gậm	ɣɤ̆m˨ˀ˩ʔ
gang	ɣaŋ˧˥
găng	ɣăŋ˧˥
gắng	ɣăŋ˩˧
gặng	ɣăŋ˨ˀ˩ʔ
gan	ɣaŋ˧˥
gan,	ɣaŋ˧˥
gán	ɣaŋ˩˧
gàn	ɣaŋ˦˨
găn	ɣăŋ˧˥
gắn	ɣăŋ˩˧
gằn	ɣăŋ˦˨
gạn	ɣaŋ˨ˀ˩ʔ
gân	ɣɤ̆ŋ˧˥
gần	ɣɤ̆ŋ˦˨
ganh	ɣan˧˥
gánh	ɣan˩˧
gáo	ɣaw˩˧
gáo,	ɣaw˩˧
gào	ɣaw˦˨
gạo	ɣaw˨ˀ˩ʔ
gạo,	ɣaw˨ˀ˩ʔ
gắp	ɣăp˦˥
gặp	ɣăp˨ˀ˩ʔ
gấp	ɣɤ̆p˦˥
gập	ɣɤ̆p˨ˀ˩ʔ
gắt	ɣăk˦˥
gạt	ɣak˨ˀ˩ʔ
gặt	ɣăk˨ˀ˩ʔ
gật	ɣɤ̆k˨ˀ˩ʔ
gau	ɣăw˧˥
gàu	ɣăw˦˨
gâu	ɣɤ̆w˧˥
gấu	ɣɤ̆w˩˧
gầu	ɣɤ̆w˦˨
gẫu	ɣɤ̆w˧˩˨
gay	ɣăj˧˥
gáy	ɣăj˩˧
gày	ɣăj˦˨
gãy	ɣăj˧˩˨
gảy	ɣăj˧˩˨
gây	ɣɤ̆j˧˥
gấy	ɣɤ̆j˩˧
gầy	ɣɤ̆j˦˨
gẫy	ɣɤ̆j˧˩˨
gẩy	ɣɤ̆j˧˩˨
gậy	ɣɤ̆j˨ˀ˩ʔ
ghê	ɣe˧˥
ghế	ɣe˩˧
ghe	ɣɛ˧˥
ghé	ɣɛ˩˧
ghè	ɣɛ˦˨
ghẻ	ɣɛ˧˩˨
ghẹ	ɣɛ˨ˀ˩ʔ
ghen	ɣɛŋ˧˥
ghèn	ɣɛŋ˦˨
ghểnh	ɣen˧˩˨
ghẹo	ɣeo˨ˀ˩ʔ
ghép	ɣɛp˦˥
ghét	ɣɛk˦˥
ghiền	ɣiəŋ˦˨
ghi	ɣi˧˥
ghim	ɣim˧˥
giác	jak˦˥
giạc	jak˨ˀ˩ʔ
giặc	jăk˨ˀ˩ʔ
giặc,	jăk˨ˀ˩ʔ
giấc	jɤ̆k˦˥
giai	jaj˧˥
giãi	jaj˧˩˨
giải	jaj˧˩˨
gia	ja˧˥
giá	ja˩˧
già	ja˦˨
già,	ja˦˨
giã	ja˧˩˨
(giả)	ja˧˩˨
giả	ja˧˩˨
giả,	ja˧˩˨
giam	jam˧˥
giám	jam˩˧
giăm	jăm˧˥
giắm	jăm˩˧
giảm	jam˧˩˨
giấm	jɤ̆m˩˧
giầm	jɤ̆m˦˨
giẫm	jɤ̆m˧˩˨
giậm	jɤ̆m˨ˀ˩ʔ
giang	jaŋ˧˥
giáng	jaŋ˩˧
giàng	jaŋ˦˨
giăng	jăŋ˧˥
giắng	jăŋ˩˧
giằng	jăŋ˦˨
giảng	jaŋ˧˩˨
giạng	jaŋ˨ˀ˩ʔ
giành	jan˦˨
gian	jaŋ˧˥
gián	jaŋ˩˧
giàn	jaŋ˦˨
giằn	jăŋ˦˨
giãn	jaŋ˧˩˨
giản	jaŋ˧˩˨
giấn	jɤ̆ŋ˩˧
giần	jɤ̆ŋ˦˨
giận	jɤ̆ŋ˨ˀ˩ʔ
giao	jaw˧˥
giáo	jaw˩˧
giảo	jaw˧˩˨
giáp	jap˦˥
giấp	jɤ̆p˦˥
giập	jɤ̆p˨ˀ˩ʔ
giát	jak˦˥
giắt	jăk˦˥
giạt	jak˨ˀ˩ʔ
giặt	jăk˨ˀ˩ʔ
giật	jɤ̆k˨ˀ˩ʔ
giau	jăw˧˥
giàu	jăw˦˨
giàu,	jăw˦˨
giảu	jăw˧˩˨
giâu	jɤ̆w˧˥
giấu	jɤ̆w˩˧
giầu	jɤ̆w˦˨
giậu	jɤ̆w˨ˀ˩ʔ
giày	jăj˦˨
giãy	jăj˧˩˨
giây	jɤ̆j˧˥
giấy	jɤ̆j˩˧
giầy	jɤ̆j˦˨
giẫy	jɤ̆j˧˩˨
giếc	jet˦˥
giẻ	jɛ˧˩˨
giẻ,	jɛ˧˩˨
gièm	jɛm˦˨
giêng	jen˧˥
giếng	jen˩˧
giếng,	jen˩˧
giềng	jen˦˨
giền	jen˦˨
gieo	jeo˧˥
giéo	jeo˩˧
giẹo	jeo˨ˀ˩ʔ
giẹp	jɛp˨ˀ˩ʔ
giết	jet˦˥
giễu	jɛu˧˩˨
gì	ɣi˦˨
gỉ	ɣi˧˩˨
gi	ji˧˥
gìn	zin˦˨
giới	jɤj˩˧
giời	jɤj˦˨
giối	joj˩˧
giồi	joj˦˨
giội	joj˨ˀ˩ʔ
giòi	jɔj˦˨
giỏi	jɔj˧˩˨
giơ	jɤ˧˥
giờ	jɤ˦˨
giở	jɤ˧˩˨
giỗ	jo˧˩˨
gio	jɔ˧˥
gió	jɔ˩˧
gió,	jɔ˩˧
gió;	jɔ˩˧
giò	jɔ˦˨
giò,	jɔ˦˨
giỏ	jɔ˧˩˨
giông	joŋm˧˥
giống	joŋm˩˧
giồng	joŋm˦˨
giong	jɔŋm˧˥
gióng	jɔŋm˩˧
giỏng	jɔŋm˧˩˨
giọng	jɔŋm˨ˀ˩ʔ
giôn	joŋm˧˥
gion	jɔŋm˧˥
giòn	jɔŋm˦˨
giọt	jɔkp˨ˀ˩ʔ
giũa	juə˧˩˨
giữa	jɯə˧˩˨
giục	jukp˨ˀ˩ʔ
giúi	juj˩˧
giùi	juj˦˨
giu	ju˧˥
giũ	ju˧˩˨
giữ	jɯ˧˩˨
giùm	jum˦˨
giun	juŋm˧˥
giương	jɯəŋ˧˥
giường	jɯəŋ˦˨
giường,	jɯəŋ˦˨
giúp	jup˦˥
goá	ɣwa˩˧
góa	ɣwa˩˧
gốc	ɣokp˦˥
gốc,	ɣokp˦˥
góc	ɣɔkp˦˥
gờ	ɣɤ˦˨
gỡ	ɣɤ˧˩˨
gở	ɣɤ˧˩˨
gô	ɣo˧˥
gồ	ɣo˦˨
gỗ	ɣo˧˩˨
gò	ɣɔ˦˨
gõ	ɣɔ˧˩˨
gọ	ɣɔ˨ˀ˩ʔ
gởi	ɣɤj˧˩˨
gợi	ɣɤj˨ˀ˩ʔ
gối	ɣoj˩˧
gội	ɣoj˨ˀ˩ʔ
gói	ɣɔj˩˧
gỏi	ɣɔj˧˩˨
gọi	ɣɔj˨ˀ˩ʔ
gớm	ɣɤm˩˧
gờm	ɣɤm˦˨
gôm	ɣom˧˥
gom	ɣɔm˧˥
gông	ɣoŋm˧˥
gồng	ɣoŋm˦˨
gọng	ɣɔŋm˨ˀ˩ʔ
gòn-gia	ɣɔŋm˦˨-ja˧˥
gờn	ɣɤŋ˦˨
gợn	ɣɤŋ˨ˀ˩ʔ
gòn	ɣɔŋm˦˨
gọn	ɣɔŋm˨ˀ˩ʔ
goòng	ɣɔŋm˦˨
gộp	ɣop˨ˀ˩ʔ
góp	ɣɔp˦˥
gột	ɣokp˨ˀ˩ʔ
gót	ɣɔkp˦˥
gọt	ɣɔkp˨ˀ˩ʔ
gục	ɣukp˨ˀ˩ʔ
gừ	ɣɯ˦˨
gửi	ɣɯj˧˩˨
gừng	ɣɯŋ˦˨
gùn	ɣuŋm˦˨
guốc	ɣuək˦˥
guốc,	ɣuək˦˥
gươm	ɣɯəm˧˥
gườm	ɣɯəm˦˨
guồng	ɣuəŋ˦˨
gương	ɣɯəŋ˧˥
gường	ɣɯəŋ˦˨
gượng	ɣɯəŋ˨ˀ˩ʔ
guột	ɣuək˨ˀ˩ʔ
gút	ɣukp˦˥
hắc	hăk˦˥
hạc	hak˨ˀ˩ʔ
hặc	hăk˨ˀ˩ʔ
hách	hak˦˥
hạch	hak˨ˀ˩ʔ
hà-đông	ha˦˨-doŋm˧˥
ha	ha˧˥
há	ha˩˧
hà	ha˦˨
hả	ha˧˩˨
hạ	ha˨ˀ˩ʔ
hai	haj˧˥
hai,	haj˧˥
hái	haj˩˧
hài	haj˦˨
hãi	haj˧˩˨
hải	haj˧˩˨
hại	haj˨ˀ˩ʔ
ham	ham˧˥
hám	ham˩˧
hàm	ham˦˨
hăm	hăm˧˥
hằm	hăm˦˨
hãm	ham˧˩˨
hạm	ham˨ˀ˩ʔ
hặm	hăm˨ˀ˩ʔ
hâm	hɤ̆m˧˥
hấm	hɤ̆m˩˧
hầm	hɤ̆m˦˨
hẩm	hɤ̆m˧˩˨
hậm	hɤ̆m˨ˀ˩ʔ
hang	haŋ˧˥
hàng	haŋ˦˨
hăng	hăŋ˧˥
hắng	hăŋ˩˧
hằng	hăŋ˦˨
hãng	haŋ˧˩˨
hạng	haŋ˨ˀ˩ʔ
hẫng	hɤ̆ŋ˧˩˨
han	haŋ˧˥
hán	haŋ˩˧
hàn	haŋ˦˨
hắn	hăŋ˩˧
hằn	hăŋ˦˨
hẳn	hăŋ˧˩˨
hãn	haŋ˧˩˨
hạn	haŋ˨ˀ˩ʔ
hân	hɤ̆ŋ˧˥
hấn	hɤ̆ŋ˩˧
hận	hɤ̆ŋ˨ˀ˩ʔ
hanh	han˧˥
hánh	han˩˧
hành	han˦˨
hãnh	han˧˩˨
hạnh	han˨ˀ˩ʔ
hao	haw˧˥
háo	haw˩˧
hào	haw˦˨
hão	haw˧˩˨
hảo	haw˧˩˨
hạo	haw˨ˀ˩ʔ
hạp	hap˨ˀ˩ʔ
hấp	hɤ̆p˦˥
hát	hak˦˥
hắt	hăk˦˥
hạt	hak˨ˀ˩ʔ
hất	hɤ̆k˦˥
hau	hăw˧˥
háu	hăw˩˧
hầu	hɤ̆w˦˨
hẩu	hɤ̆w˧˩˨
hậu	hɤ̆w˨ˀ˩ʔ
hậu,	hɤ̆w˨ˀ˩ʔ
hay	hăj˧˥
háy	hăj˩˧
hãy	hăj˧˩˨
hây	hɤ̆j˧˥
héc	hɛk˦˥
hếch	het˦˥
hệch	het˨ˀ˩ʔ
hề	he˦˨
hể	he˧˩˨
hệ	he˨ˀ˩ʔ
hé	hɛ˩˧
hè	hɛ˦˨
hèm	hɛm˦˨
hẻm	hɛm˧˩˨
hên	hen˧˥
hen	hɛŋ˧˥
hèn	hɛŋ˦˨
hẹn	hɛŋ˨ˀ˩ʔ
hênh	hen˧˥
hềnh	hen˦˨
hểnh	hen˧˩˨
heo	heo˧˥
héo	heo˩˧
hèo	heo˦˨
hẻo	heo˧˩˨
hẹp	hɛp˨ˀ˩ʔ
hết	het˦˥
hét	hɛk˦˥
hểu	hɛu˧˩˨
hịch	hit˨ˀ˩ʔ
hiếm	hiəm˩˧
hiềm	hiəm˦˨
hiểm	hiəm˧˩˨
hiêng	hiəŋ˧˥
hiên	hiəŋ˧˥
hiến	hiəŋ˩˧
hiền	hiəŋ˦˨
hiển	hiəŋ˧˩˨
hiện	hiəŋ˨ˀ˩ʔ
hiếp	hiəp˦˥
hiệp	hiəp˨ˀ˩ʔ
hiếu	hiəw˩˧
hiểu	hiəw˧˩˨
hiệu	hiəw˨ˀ˩ʔ
hi	hi˧˥
hí	hi˩˧
hì	hi˦˨
hỉ	hi˧˩˨
him	him˧˥
hinh	hin˧˥
hình	hin˦˨
hình,	hin˦˨
hỉnh	hin˧˩˨
híp	hip˦˥
hít	hit˦˥
hiu	hiw˧˥
hoạch	hwak˨ˀ˩ʔ
hoác	hwak˦˥
hoắc	hwăk˦˥
hoặc	hwăk˨ˀ˩ʔ
hoa	hwa˧˥
hoa,	hwa˧˥
hoá	hwa˩˧
hoà	hwa˦˨
hoả	hwa˧˩˨
hóa	hwa˩˧
hòa	hwa˦˨
hỏa	hwa˧˩˨
hoạ	hwa˨ˀ˩ʔ
họa	hwa˨ˀ˩ʔ
hoài	hwaj˦˨
hoải	hwaj˧˩˨
hoại	hwaj˨ˀ˩ʔ
hoăm	hwăm˧˥
hoắm	hwăm˩˧
hoang	hwaŋ˧˥
hoàng	hwaŋ˦˨
hoăng	hwăŋ˧˥
hoảng	hwaŋ˧˩˨
hoành	hwan˦˨
hoạnh	hwan˨ˀ˩ʔ
hoan	hwaŋ˧˥
hoán	hwaŋ˩˧
hoàn	hwaŋ˦˨
hoãn	hwaŋ˧˩˨
hoạn	hwaŋ˨ˀ˩ʔ
hoặn	hwăŋ˨ˀ˩ʔ
hoạt	hwak˨ˀ˩ʔ
hoay	hwăj˧˥
hốc	hokp˦˥
hộc	hokp˨ˀ˩ʔ
hóc	hɔkp˦˥
học	hɔkp˨ˀ˩ʔ
hoe	hwe˧˥
hoè	hwe˦˨
hoen	hwen˧˥
hơ	hɤ˧˥
hớ	hɤ˩˧
hờ	hɤ˦˨
hở	hɤ˧˩˨
hô	ho˧˥
hố	ho˩˧
hồ	ho˦˨
hồ,	ho˦˨
hỗ	ho˧˩˨
hổ	ho˧˩˨
hộ	ho˨ˀ˩ʔ
ho	hɔ˧˥
hó	hɔ˩˧
hò	hɔ˦˨
họ	hɔ˨ˀ˩ʔ
họ,	hɔ˨ˀ˩ʔ
hơi	hɤj˧˥
hời	hɤj˦˨
hỡi	hɤj˧˩˨
hởi	hɤj˧˩˨
hôi	hoj˧˥
hối	hoj˩˧
hồi	hoj˦˨
hổi	hoj˧˩˨
hội	hoj˨ˀ˩ʔ
hoi	hɔj˧˥
hói	hɔj˩˧
hỏi	hɔj˧˩˨
hợm	hɤm˨ˀ˩ʔ
hôm	hom˧˥
hôm,	hom˧˥
hổm	hom˧˩˨
hom	hɔm˧˥
hóm	hɔm˩˧
hòm	hɔm˦˨
hỏm	hɔm˧˩˨
hông	hoŋm˧˥
hống	hoŋm˩˧
hồng	hoŋm˦˨
hỗng	hoŋm˧˩˨
hổng	hoŋm˧˩˨
hong	hɔŋm˧˥
hóng	hɔŋm˩˧
hòng	hɔŋm˦˨
hỏng	hɔŋm˧˩˨
hỏng,	hɔŋm˧˩˨
họng	hɔŋm˨ˀ˩ʔ
hơn	hɤŋ˧˥
hớn	hɤŋ˩˧
hờn	hɤŋ˦˨
hôn	hoŋm˧˥
hồn	hoŋm˦˨
hỗn	hoŋm˧˩˨
hổn	hoŋm˧˩˨
hộn	hoŋm˨ˀ˩ʔ
hon	hɔŋm˧˥
hòn	hɔŋm˦˨
hỏn	hɔŋm˧˩˨
hớp	hɤp˦˥
hợp	hɤp˨ˀ˩ʔ
hộp	hop˨ˀ˩ʔ
hóp	hɔp˦˥
họp	hɔp˨ˀ˩ʔ
hớt	hɤk˦˥
hốt	hokp˦˥
hột	hokp˨ˀ˩ʔ
hót	hɔkp˦˥
hứa	hɯə˩˧
huân	hwɤ̆ŋ˧˥
huấn	hwɤ̆ŋ˩˧
húc	hukp˦˥
hục	hukp˨ˀ˩ʔ
hực	hɯk˨ˀ˩ʔ
huếch	hwet˦˥
huê	hwe˧˥
huề	hwe˦˨
huệ	hwe˨ˀ˩ʔ
huênh	hwen˧˥
hu	hu˧˥
hú	hu˩˧
hù	hu˦˨
hũ	hu˧˩˨
hủ	hu˧˩˨
hư	hɯ˧˥
hừ	hɯ˦˨
hui	huj˧˥
hùi	huj˦˨
hum	hum˧˥
hùm	hum˦˨
hung	huŋm˧˥
húng	huŋm˩˧
hùng	huŋm˦˨
hùng,	huŋm˦˨
hủng	huŋm˧˩˨
hưng	hɯŋ˧˥
hứng	hɯŋ˩˧
hừng	hɯŋ˦˨
hững	hɯŋ˧˩˨
hửng	hɯŋ˧˩˨
hun	huŋm˧˥
hùn	huŋm˦˨
hủn	huŋm˧˩˨
huơ	huə˧˥
huống	huəŋ˩˧
hương	hɯəŋ˧˥
hương;	hɯəŋ˧˥
hướng	hɯəŋ˩˧
hưởng	hɯəŋ˧˩˨
hươu	hɯəw˧˥
húp	hup˦˥
hụp	hup˨ˀ˩ʔ
hút	hukp˦˥
hụt	hukp˨ˀ˩ʔ
hưu	hɯw˧˥
hữu	hɯw˧˩˨
hữu,	hɯw˧˩˨
huých	hwit˦˥
huỵch	hwit˨ˀ˩ʔ
huyên	hwiəŋ˧˥
huyền	hwiəŋ˦˨
huyễn	hwiəŋ˧˩˨
huyện	hwiəŋ˨ˀ˩ʔ
huyết	hwiək˦˥
huyệt	hwiək˨ˀ˩ʔ
húy	huj˩˧
hủy	huj˧˩˨
huy	hwi˧˥
huý	hwi˩˧
huỷ	hwi˧˩˨
huynh	hwin˧˥
huỳnh	hwin˦˨
huýt	hwit˦˥
hy	hi˧˥
ỉa	iə˧˩˨
ích	it˦˥
ic,	it˧˥
i	i˧˥
í	i˩˧
ì	i˦˨
ỉ	i˧˩˨
ị	i˨ˀ˩ʔ
im	im˧˥
ỉm	im˧˩˨
inh	in˧˥
ình	in˦˨
ĩnh	in˧˩˨
in	in˧˥
ìn	in˦˨
i-ôn	i˧˥-oŋm˧˥
ít	it˦˥
ít,	it˦˥
ịt	it˨ˀ˩ʔ
iu	iw˧˥
ỉu	iw˧˩˨
ka	ka˧˥
ka-li	ka˧˥-li˧˥
kếch	ket˦˥
kệch	ket˨ˀ˩ʔ
kê	ke˧˥
kế	ke˩˧
kề	ke˦˨
kể	ke˧˩˨
kệ	ke˨ˀ˩ʔ
ke	kɛ˧˥
ké	kɛ˩˧
kè	kɛ˦˨
kẽ	kɛ˧˩˨
kẻ	kɛ˧˩˨
kềm	kem˦˨
kem	kɛm˧˥
kém	kɛm˩˧
kèm	kɛm˦˨
kẽm	kɛm˧˩˨
kẻm	kɛm˧˩˨
keng	kɛŋ˧˥
kênh	ken˧˥
kềnh	ken˦˨
kễnh	ken˧˩˨
kên	ken˧˥
kền	ken˦˨
ken	kɛŋ˧˥
kén	kɛŋ˩˧
kèn	kɛŋ˦˨
kẹn	kɛŋ˨ˀ˩ʔ
keo	keo˧˥
keo,	keo˧˥
kéo	keo˩˧
kèo	keo˦˨
kẽo	keo˧˩˨
kẻo	keo˧˩˨
kẹo	keo˨ˀ˩ʔ
kép	kɛp˦˥
kẹp	kɛp˨ˀ˩ʔ
kết	ket˦˥
két	kɛk˦˥
két,	kɛk˦˥
kẹt	kɛk˨ˀ˩ʔ
kêu	kɛu˧˥
khách	xak˦˥
khảch	xak˧˩˨
khác	xak˦˥
khắc	xăk˦˥
khạc	xak˨ˀ˩ʔ
khặc	xăk˨ˀ˩ʔ
khai	xaj˧˥
khái	xaj˩˧
khải	xaj˧˩˨
kham	xam˧˥
khám	xam˩˧
khăm	xăm˧˥
khắm	xăm˩˧
khảm	xam˧˩˨
khâm	xɤ̆m˧˥
khấm	xɤ̆m˩˧
khậm	xɤ̆m˨ˀ˩ʔ
khang	xaŋ˧˥
kháng	xaŋ˩˧
khăng	xăŋ˧˥
khắng	xăŋ˩˧
khằng	xăŋ˦˨
khẳng	xăŋ˧˩˨
khảng	xaŋ˧˩˨
khảng;	xaŋ˧˩˨
khạng	xaŋ˨ˀ˩ʔ
khâng	xɤ̆ŋ˧˥
khầng	xɤ̆ŋ˦˨
khánh-hạ	xan˩˧-ha˨ˀ˩ʔ
khanh	xan˧˥
khánh	xan˩˧
khành	xan˦˨
khảnh	xan˧˩˨
khan	xaŋ˧˥
khán	xaŋ˩˧
khàn	xaŋ˦˨
khăn	xăŋ˧˥
khắn	xăŋ˩˧
khẳn	xăŋ˧˩˨
khản	xaŋ˧˩˨
khấn	xɤ̆ŋ˩˧
khẩn	xɤ̆ŋ˧˩˨
khao	xaw˧˥
khảo	xaw˧˩˨
khắp	xăp˦˥
khấp	xɤ̆p˦˥
khập	xɤ̆p˨ˀ˩ʔ
khát	xak˦˥
khắt	xăk˦˥
khất	xɤ̆k˦˥
khật	xɤ̆k˨ˀ˩ʔ
kháu	xăw˩˧
khâu	xɤ̆w˧˥
khấu	xɤ̆w˩˧
khẩu	xɤ̆w˧˩˨
kha	xa˧˥
khá	xa˩˧
khà	xa˦˨
khả	xa˧˩˨
khạ	xa˨ˀ˩ʔ
khay	xăj˧˥
khem	xɛm˧˥
khèng	xɛŋ˦˨
khềnh	xen˦˨
khễnh;	xen˧˩˨
khểnh	xen˧˩˨
khệnh	xen˨ˀ˩ʔ
khen	xɛŋ˧˥
khèn	xɛŋ˦˨
kheo	xeo˧˥
kheo;	xeo˧˥
khéo	xeo˩˧
khép	xɛp˦˥
khét	xɛk˦˥
khêu	xɛu˧˥
khều	xɛu˦˨
khê	xe˧˥
khế	xe˩˧
khề	xe˦˨
khệ	xe˨ˀ˩ʔ
khe	xɛ˧˥
khé	xɛ˩˧
khè	xɛ˦˨
khẽ	xɛ˧˩˨
khẻ	xɛ˧˩˨
khía	xiə˩˧
khích	xit˦˥
khiêm	xiəm˧˥
khiếm	xiəm˩˧
khiêng	xiəŋ˧˥
khiên	xiəŋ˧˥
khiển	xiəŋ˧˩˨
khiếp	xiəp˦˥
khiêu	xiəw˧˥
khiếu	xiəw˩˧
khinh	xin˧˥
khin	xin˧˥
khìn	xin˦˨
khít	xit˦˥
khịt	xit˨ˀ˩ʔ
khi	xi˧˥
khí	xi˩˧
khì	xi˦˨
khỉ	xi˧˩˨
khoác	xwak˦˥
khoai	xwaj˧˥
khoái	xwaj˩˧
khoăm	xwăm˧˥
khoằm	xwăm˦˨
khoang	xwaŋ˧˥
khoáng	xwaŋ˩˧
khoảng	xwaŋ˧˩˨
khoanh	xwan˧˥
khoành	xwan˦˨
khoảnh	xwan˧˩˨
khoan	xwaŋ˧˥
khoán	xwaŋ˩˧
khoản	xwaŋ˧˩˨
khoát	xwak˦˥
khoa	xwa˧˥
khoá	xwa˩˧
khoả	xwa˧˩˨
khóa	xwa˩˧
khỏa	xwa˧˩˨
khốc	xokp˦˥
khóc	xɔkp˦˥
khóc,	xɔkp˦˥
khoen	xwen˧˥
khoeo	xwew˧˥
khoèo	xwew˦˨
khoét	xwet˦˥
khoe	xwe˧˥
khoé	xwe˩˧
khoẻ	xwe˧˩˨
khóe	xwe˩˧
khòe	xwe˦˨
khỏe	xwe˧˩˨
khơi	xɤj˧˥
khởi	xɤj˧˩˨
khôi	xoj˧˥
khối	xoj˩˧
khói	xɔj˩˧
khỏi	xɔj˧˩˨
khơ-me	xɤ˧˥-mɛ˧˥
khơ-mú	xɤ˧˥-mu˩˧
khom	xɔm˧˥
khòm	xɔm˦˨
khọm	xɔm˨ˀ˩ʔ
không	xoŋm˧˥
không	xoŋm˧˥
khống	xoŋm˩˧
khổng	xoŋm˧˩˨
khòng	xɔŋm˦˨
khôn	xoŋm˧˥
khốn	xoŋm˩˧
khổn	xoŋm˧˩˨
khớp	xɤp˦˥
khơ	xɤ˧˥
khờ	xɤ˦˨
khô	xo˧˥
khố	xo˩˧
khổ	xo˧˩˨
kho	xɔ˧˥
khó	xɔ˩˧
khó,	xɔ˩˧
khò	xɔ˦˨
khuân	xwɤ̆ŋ˧˥
khuẩn	xwɤ̆ŋ˧˩˨
khuất	xwɤ̆k˦˥
khua	xuə˧˥
khuây	xwɤ̆j˧˥
khuấy	xwɤ̆j˩˧
khúc	xukp˦˥
khúc,	xukp˦˥
khục	xukp˨ˀ˩ʔ
khuếch	xwet˦˥
khuê	xwe˧˥
khum	xum˧˥
khúm	xum˩˧
khung	xuŋm˧˥
khúng	xuŋm˩˧
khùng	xuŋm˦˨
khủng	xuŋm˧˩˨
khụng	xuŋm˨ˀ˩ʔ
khước	xɯək˦˥
khươm	xɯəm˧˥
khuông	xuəŋ˧˥
khuôn	xuəŋ˧˥
khướt	xɯək˦˥
khướu	xɯəw˩˧
khuờ	xuə˦˨
khụt	xukp˨ˀ˩ʔ
khứu	xɯw˩˧
khu	xu˧˥
khú	xu˩˧
khù	xu˦˨
khủ	xu˧˩˨
khụ	xu˨ˀ˩ʔ
khư	xɯ˧˥
khứ	xɯ˩˧
khừ	xɯ˦˨
khử	xɯ˧˩˨
khự	xɯ˨ˀ˩ʔ
khuya	xwiə˧˥
khuyên	xwiəŋ˧˥
khuyến	xwiəŋ˩˧
khuyển	xwiəŋ˧˩˨
khuyết	xwiək˦˥
khuynh	xwin˧˥
khuỳnh	xwin˦˨
khuy	xwi˧˥
khyển	xiɛŋ˧˩˨
kia	kiə˧˥
kìa	kiə˦˨
kích	kit˦˥
kịch	kit˨ˀ˩ʔ
kiêm	kiəm˧˥
kiếm	kiəm˩˧
kiềm	kiəm˦˨
kiểm	kiəm˧˩˨
kiệm	kiəm˨ˀ˩ʔ
kiêng	kiəŋ˧˥
kiềng	kiəŋ˦˨
kiên	kiəŋ˧˥
kiến	kiəŋ˩˧
kiền	kiəŋ˦˨
kiện	kiəŋ˨ˀ˩ʔ
kiếp	kiəp˦˥
kiết	kiək˦˥
kiệt	kiək˨ˀ˩ʔ
kiệt;	kiək˨ˀ˩ʔ
kiêu	kiəw˧˥
kiếu	kiəw˩˧
kiều	kiəw˦˨
kiểu	kiəw˧˩˨
kiệu	kiəw˨ˀ˩ʔ
ki	ki˧˥
kí	ki˩˧
kì	ki˦˨
kì,	ki˦˨
kĩ	ki˧˩˨
kỉ	ki˧˩˨
kỉ,	ki˧˩˨
kị	ki˨ˀ˩ʔ
ki-lô	ki˧˥-lo˧˥
ki-lô-oát	ki˧˥-lo˧˥-wak˦˥
kim	kim˧˥
kìm	kim˦˨
kinh	kin˧˥
kính	kin˩˧
kính,	kin˩˧
kình	kin˦˨
kin	kin˧˥
kín	kin˩˧
kín,	kin˩˧
kìn	kin˦˨
kíp	kip˦˥
kịp	kip˨ˀ˩ʔ
ki-tô	ki˧˥-to˧˥
kíu	kiw˩˧
kĩu	kiw˧˩˨
ky	ki˧˥
ký	ki˩˧
kỳ	ki˦˨
kỹ	ki˧˩˨
kỷ	ki˧˩˨
kỵ	ki˨ˀ˩ʔ
lách	lak˦˥
lạch	lak˨ˀ˩ʔ
lác	lak˦˥
lác;	lak˦˥
lắc	lăk˦˥
lạc	lak˨ˀ˩ʔ
lặc	lăk˨ˀ˩ʔ
lấc	lɤ̆k˦˥
lai-Đa	laj˧˥-da˧˥
lai	laj˧˥
lai,	laj˧˥
lái	laj˩˧
lái,	laj˩˧
lài	laj˦˨
lãi	laj˧˩˨
lải	laj˧˩˨
lại	laj˨ˀ˩ʔ
lại,	laj˨ˀ˩ʔ
lai-ly	laj˧˥-li˧˥
la	la˧˥
lá	la˩˧
lá,	la˩˧
là	la˦˨
lã	la˧˩˨
lả	la˧˩˨
lạ	la˨ˀ˩ʔ
lạ,	la˨ˀ˩ʔ
la-mã	la˧˥-ma˧˩˨
lam	lam˧˥
làm	lam˦˨
làm,	lam˦˨
lăm	lăm˧˥
(lắm)	lăm˩˧
lắm	lăm˩˧
lắm,	lăm˩˧
lằm	lăm˦˨
lãm	lam˧˩˨
lảm	lam˧˩˨
lạm	lam˨ˀ˩ʔ
lâm	lɤ̆m˧˥
lấm	lɤ̆m˩˧
lầm	lɤ̆m˦˨
lẫm	lɤ̆m˧˩˨
lẩm	lɤ̆m˧˩˨
lang	laŋ˧˥
láng	laŋ˩˧
làng	laŋ˦˨
lăng	lăŋ˧˥
lắng	lăŋ˩˧
lằng	lăŋ˦˨
lẵng	lăŋ˧˩˨
lẳng	lăŋ˧˩˨
lãng	laŋ˧˩˨
lảng	laŋ˧˩˨
lạng	laŋ˨ˀ˩ʔ
lạng,	laŋ˨ˀ˩ʔ
lặng	lăŋ˨ˀ˩ʔ
lặng,	lăŋ˨ˀ˩ʔ
lâng	lɤ̆ŋ˧˥
lanh	lan˧˥
lánh	lan˩˧
lành	lan˦˨
lành,	lan˦˨
lãnh	lan˧˩˨
lảnh	lan˧˩˨
lạnh	lan˨ˀ˩ʔ
lan	laŋ˧˥
lan;	laŋ˧˥
lán	laŋ˩˧
làn	laŋ˦˨
lăn	lăŋ˧˥
lằn	lăŋ˦˨
lẳn	lăŋ˧˩˨
lãn	laŋ˧˩˨
lặn	lăŋ˨ˀ˩ʔ
lân	lɤ̆ŋ˧˥
lấn	lɤ̆ŋ˩˧
lần	lɤ̆ŋ˦˨
lẫn	lɤ̆ŋ˧˩˨
lẩn	lɤ̆ŋ˧˩˨
lận	lɤ̆ŋ˨ˀ˩ʔ
lao	law˧˥
lao,	law˧˥
láo	law˩˧
lào	law˦˨
lão	law˧˩˨
lảo	law˧˩˨
lạo	law˨ˀ˩ʔ
láp	lap˦˥
lắp	lăp˦˥
lạp	lap˨ˀ˩ʔ
lặp	lăp˨ˀ˩ʔ
lâp	lɤ̆p˧˥
lấp	lɤ̆p˦˥
lập	lɤ̆p˨ˀ˩ʔ
la-tê-rít	la˧˥-te˧˥-ʐit˦˥
la-tinh	la˧˥-tin˧˥
lát	lak˦˥
lắt	lăk˦˥
lạt	lak˨ˀ˩ʔ
lạt,	lak˨ˀ˩ʔ
lặt	lăk˨ˀ˩ʔ
lất	lɤ̆k˦˥
lật	lɤ̆k˨ˀ˩ʔ
lau	lăw˧˥
láu	lăw˩˧
làu	lăw˦˨
lảu	lăw˧˩˨
lạu	lăw˨ˀ˩ʔ
lâu	lɤ̆w˧˥
lấu	lɤ̆w˩˧
lầu	lɤ̆w˦˨
lẩu	lɤ̆w˧˩˨
lậu	lɤ̆w˨ˀ˩ʔ
lay	lăj˧˥
láy	lăj˩˧
lày	lăj˦˨
lảy	lăj˧˩˨
lạy	lăj˨ˀ˩ʔ
lây	lɤ̆j˧˥
lấy	lɤ̆j˩˧
lầy	lɤ̆j˦˨
lẫy	lɤ̆j˧˩˨
lẩy	lɤ̆j˧˩˨
lậy	lɤ̆j˨ˀ˩ʔ
lếch	let˦˥
lệch	let˨ˀ˩ʔ
lê	le˧˥
lê,	le˧˥
lề	le˦˨
lề,	le˦˨
lễ	le˧˩˨
lễ,	le˧˩˨
lể	le˧˩˨
lệ	le˨ˀ˩ʔ
le	lɛ˧˥
lé	lɛ˩˧
lè	lɛ˦˨
lẽ	lɛ˧˩˨
lẽ,	lɛ˧˩˨
lẻ	lɛ˧˩˨
lẹ	lɛ˨ˀ˩ʔ
lem	lɛm˧˥
lém	lɛm˩˧
lèm	lɛm˦˨
lẹm	lɛm˨ˀ˩ʔ
leng	lɛŋ˧˥
léng	lɛŋ˩˧
lẻng	lɛŋ˧˩˨
lênh	len˧˥
lềnh	len˦˨
lệnh	len˨ˀ˩ʔ
lệnh,	len˨ˀ˩ʔ
lên	len˧˥
len	lɛŋ˧˥
lén	lɛŋ˩˧
lèn	lɛŋ˦˨
lẻn	lɛŋ˧˩˨
leo	leo˧˥
leo,	leo˧˥
léo	leo˩˧
lèo	leo˦˨
lẽo	leo˧˩˨
lẻo	leo˧˩˨
lẹo	leo˨ˀ˩ʔ
lép	lɛp˦˥
lẹp	lɛp˨ˀ˩ʔ
lết	let˦˥
lệt	let˨ˀ˩ʔ
lét	lɛk˦˥
lẹt	lɛk˨ˀ˩ʔ
lêu	lɛu˧˥
lếu	lɛu˩˧
lều	lɛu˦˨
lễu	lɛu˧˩˨
lểu	lɛu˧˩˨
lia	liə˧˥
lìa	liə˦˨
lích	lit˦˥
lịch	lit˨ˀ˩ʔ
liếc	liək˦˥
liêm	liəm˧˥
liếm	liəm˩˧
liềm	liəm˦˨
liệm	liəm˨ˀ˩ʔ
liêng	liəŋ˧˥
liểng	liəŋ˧˩˨
liên	liəŋ˧˥
liến	liəŋ˩˧
liền	liəŋ˦˨
liếp	liəp˦˥
liệt	liək˨ˀ˩ʔ
liêu	liəw˧˥
liếu	liəw˩˧
liều	liəw˦˨
liễu	liəw˧˩˨
liệu	liəw˨ˀ˩ʔ
li	li˧˥
lí	li˩˧
lì	li˦˨
lị	li˨ˀ˩ʔ
lị,	li˨ˀ˩ʔ
lim	lim˧˥
lìm	lim˦˨
linh	lin˧˥
lính	lin˩˧
lình	lin˦˨
lĩnh	lin˧˩˨
lỉnh	lin˧˩˨
líp	lip˦˥
lít	lit˦˥
liu	liw˧˥
líu	liw˩˧
lịu	liw˨ˀ˩ʔ
loạch	lwak˨ˀ˩ʔ
loạc	lwak˨ˀ˩ʔ
loai	lwaj˧˥
loài	lwaj˦˨
loại	lwaj˨ˀ˩ʔ
loại;	lwaj˨ˀ˩ʔ
loa	lwa˧˥
loá	lwa˩˧
loà	lwa˦˨
loã	lwa˧˩˨
loả	lwa˧˩˨
lòa	lwa˦˨
lõa	lwa˧˩˨
lỏa	lwa˧˩˨
loang	lwaŋ˧˥
loáng	lwaŋ˩˧
loàng	lwaŋ˦˨
loăng	lwăŋ˧˥
loằng	lwăŋ˦˨
loãng	lwaŋ˧˩˨
loảng	lwaŋ˧˩˨
loạng	lwaŋ˨ˀ˩ʔ
loanh	lwan˧˥
loan	lwaŋ˧˥
loăn	lwăŋ˧˥
loắn	lwăŋ˩˧
loằn	lwăŋ˦˨
loạn	lwaŋ˨ˀ˩ʔ
loạn,	lwaŋ˨ˀ˩ʔ
loáo	lwaw˩˧
loát	lwak˦˥
loắt	lwăk˦˥
loạt	lwak˨ˀ˩ʔ
loay	lwăj˧˥
loáy	lwăj˩˧
lốc	lokp˦˥
lộc	lokp˨ˀ˩ʔ
lóc	lɔkp˦˥
lọc	lɔkp˨ˀ˩ʔ
loe	lwe˧˥
loé	lwe˩˧
loè	lwe˦˨
lòe	lwe˦˨
loẻng	lwen˧˩˨
loen	lwen˧˥
loẻo	lwew˧˩˨
loét	lwet˦˥
loẹt	lwet˨ˀ˩ʔ
lô-gích	lo˧˥-ɣit˦˥
lơi	lɤj˧˥
lời	lɤj˦˨
lợi	lɤj˨ˀ˩ʔ
lôi	loj˧˥
lối	loj˩˧
lối,	loj˩˧
lồi	loj˦˨
lỗi	loj˧˩˨
lội	loj˨ˀ˩ʔ
loi	lɔj˧˥
lòi	lɔj˦˨
lõi	lɔj˧˩˨
lọi	lɔj˨ˀ˩ʔ
lơ	lɤ˧˥
lớ	lɤ˩˧
lờ	lɤ˦˨
lỡ	lɤ˧˩˨
lở	lɤ˧˩˨
lợ	lɤ˨ˀ˩ʔ
lô	lo˧˥
lố	lo˩˧
lồ	lo˦˨
lỗ	lo˧˩˨
lỗ,	lo˧˩˨
lổ	lo˧˩˨
lộ	lo˨ˀ˩ʔ
lo	lɔ˧˥
lo,	lɔ˧˥
ló	lɔ˩˧
lò	lɔ˦˨
lõ	lɔ˧˩˨
lọ	lɔ˨ˀ˩ʔ
lờm	lɤm˦˨
lởm	lɤm˧˩˨
lợm	lɤm˨ˀ˩ʔ
lôm	lom˧˥
lốm	lom˩˧
lồm	lom˦˨
lỗm	lom˧˩˨
lổm	lom˧˩˨
lộm	lom˨ˀ˩ʔ
lom	lɔm˧˥
lóm	lɔm˩˧
lòm	lɔm˦˨
lõm	lɔm˧˩˨
lỏm	lɔm˧˩˨
lọm	lɔm˨ˀ˩ʔ
lông	loŋm˧˥
lồng	loŋm˦˨
lồng,	loŋm˦˨
lổng	loŋm˧˩˨
lộng	loŋm˨ˀ˩ʔ
long	lɔŋm˧˥
lóng	lɔŋm˩˧
lòng	lɔŋm˦˨
lòng,	lɔŋm˦˨
lõng	lɔŋm˧˩˨
lỏng	lɔŋm˧˩˨
lọng	lɔŋm˨ˀ˩ʔ
lơn	lɤŋ˧˥
lớn	lɤŋ˩˧
lờn	lɤŋ˦˨
lởn	lɤŋ˧˩˨
lợn	lɤŋ˨ˀ˩ʔ
lốn	loŋm˩˧
lồn	loŋm˦˨
lổn	loŋm˧˩˨
lộn	loŋm˨ˀ˩ʔ
lon	lɔŋm˧˥
lòn	lɔŋm˦˨
lỏn	lɔŋm˧˩˨
lọn	lɔŋm˨ˀ˩ʔ
loong	lɔŋm˧˥
lớp	lɤp˦˥
lợp	lɤp˨ˀ˩ʔ
lốp	lop˦˥
lộp	lop˨ˀ˩ʔ
lóp	lɔp˦˥
lọp	lɔp˨ˀ˩ʔ
lớt	lɤk˦˥
lợt	lɤk˨ˀ˩ʔ
lốt	lokp˦˥
lột	lokp˨ˀ˩ʔ
lột,	lokp˨ˀ˩ʔ
lót	lɔkp˦˥
lọt	lɔkp˨ˀ˩ʔ
lua	luə˧˥
lúa	luə˩˧
lủa	luə˧˩˨
lụa	luə˨ˀ˩ʔ
lụa,	luə˨ˀ˩ʔ
lưa	lɯə˧˥
lứa	lɯə˩˧
lừa	lɯə˦˨
lửa	lɯə˧˩˨
lửa,	lɯə˧˩˨
lựa	lɯə˨ˀ˩ʔ
luân	lwɤ̆ŋ˧˥
luấn	lwɤ̆ŋ˩˧
luẩn	lwɤ̆ŋ˧˩˨
luận	lwɤ̆ŋ˨ˀ˩ʔ
luật	lwɤ̆k˨ˀ˩ʔ
lúc	lukp˦˥
lục	lukp˨ˀ˩ʔ
lực	lɯk˨ˀ˩ʔ
lui	luj˧˥
lúi	luj˩˧
lùi	luj˦˨
lủi	luj˧˩˨
lụi	luj˨ˀ˩ʔ
lu	lu˧˥
lú	lu˩˧
lú,	lu˩˧
lù	lu˦˨
lũ	lu˧˩˨
lủ	lu˧˩˨
lụ	lu˨ˀ˩ʔ
lư	lɯ˧˥
lừ	lɯ˦˨
lữ	lɯ˧˩˨
lử	lɯ˧˩˨
lự;	lɯ˨ˀ˩ʔ
lum	lum˧˥
lúm	lum˩˧
lùm	lum˦˨
lũm	lum˧˩˨
lủm	lum˧˩˨
lụm	lum˨ˀ˩ʔ
lung	luŋm˧˥
lúng	luŋm˩˧
lùng	luŋm˦˨
lũng	luŋm˧˩˨
lủng	luŋm˧˩˨
lụng	luŋm˨ˀ˩ʔ
lưng	lɯŋ˧˥
lưng;	lɯŋ˧˥
lừng	lɯŋ˦˨
lững	lɯŋ˧˩˨
lửng	lɯŋ˧˩˨
lựng	lɯŋ˨ˀ˩ʔ
lún	luŋm˩˧
lùn	luŋm˦˨
lũn	luŋm˧˩˨
lủn	luŋm˧˩˨
lụn	luŋm˨ˀ˩ʔ
lược	lɯək˨ˀ˩ʔ
lưới	lɯəj˩˧
lưới,	lɯəj˩˧
lười	lɯəj˦˨
lười,	lɯəj˦˨
lưỡi	lɯəj˧˩˨
lưởi	lɯəj˧˩˨
luôm	luəm˧˥
luộm	luəm˨ˀ˩ʔ
lươm	lɯəm˧˥
lườm	lɯəm˦˨
lượm	lɯəm˨ˀ˩ʔ
luông	luəŋ˧˥
luống	luəŋ˩˧
luồng	luəŋ˦˨
lương	lɯəŋ˧˥
lướng	lɯəŋ˩˧
lường	lɯəŋ˦˨
lưỡng	lɯəŋ˧˩˨
lượng	lɯəŋ˨ˀ˩ʔ
luôn	luəŋ˧˥
luồn	luəŋ˦˨
lươn	lɯəŋ˧˥
lượn	lɯəŋ˨ˀ˩ʔ
lướp	lɯəp˦˥
luốt	luək˦˥
lướt	lɯək˦˥
lượt	lɯək˨ˀ˩ʔ
lướu	lɯəw˩˧
lúp	lup˦˥
lụp	lup˨ˀ˩ʔ
lút	lukp˦˥
lụt	lukp˨ˀ˩ʔ
lưu	lɯw˧˥
lựu	lɯw˨ˀ˩ʔ
lựu,	lɯw˨ˀ˩ʔ
luyên	lwiəŋ˧˥
luyến	lwiəŋ˩˧
luyện	lwiəŋ˨ˀ˩ʔ
lũy	luj˧˩˨
lũy,	luj˧˩˨
lụy	luj˨ˀ˩ʔ
luy	lwi˧˥
luỹ	lwi˧˩˨
luỵ	lwi˨ˀ˩ʔ
luýnh	lwin˩˧
ly	li˧˥
lý	li˩˧
lỵ	li˨ˀ˩ʔ
ma-cà-bông	ma˧˥-ka˦˨-boŋm˧˥
mách	mak˦˥
mạch	mak˨ˀ˩ʔ
mạch,	mak˨ˀ˩ʔ
mác	mak˦˥
mắc	măk˦˥
mạc	mak˨ˀ˩ʔ
mặc	măk˨ˀ˩ʔ
mạc-sê	mak˨ˀ˩ʔ-ʂe˧˥
mác-xít	mak˦˥-sit˦˥
mai	maj˧˥
mai,	maj˧˥
mái	maj˩˧
mài	maj˦˨
mãi	maj˧˩˨
mãi;	maj˧˩˨
mải	maj˧˩˨
mại	maj˨ˀ˩ʔ
mại,	maj˨ˀ˩ʔ
ma	ma˧˥
ma,	ma˧˥
má	ma˩˧
mà	ma˦˨
mã	ma˧˩˨
mả	ma˧˩˨
mả,	ma˧˩˨
mả;	ma˧˩˨
mạ	ma˨ˀ˩ʔ
mạ,	ma˨ˀ˩ʔ
măm	măm˧˥
mắm	măm˩˧
mẵm	măm˧˩˨
mâm	mɤ̆m˧˥
mâm,	mɤ̆m˧˥
mầm	mɤ̆m˦˨
mẫm	mɤ̆m˧˩˨
mẩm	mɤ̆m˧˩˨
mang	maŋ˧˥
mang,	maŋ˧˥
máng	maŋ˩˧
màng	maŋ˦˨
măng	măŋ˧˥
mắng	măŋ˩˧
mãng	maŋ˧˩˨
mảng	maŋ˧˩˨
mạng	maŋ˨ˀ˩ʔ
mâng	mɤ̆ŋ˧˥
manh	man˧˥
mánh	man˩˧
mành	man˦˨
mãnh	man˧˩˨
mảnh	man˧˩˨
mạnh	man˨ˀ˩ʔ
man	maŋ˧˥
mán	maŋ˩˧
màn	maŋ˦˨
măn	măŋ˧˥
mắn	măŋ˩˧
mằn	măŋ˦˨
mãn	maŋ˧˩˨
mạn	maŋ˨ˀ˩ʔ
mặn	măŋ˨ˀ˩ʔ
mân	mɤ̆ŋ˧˥
mấn	mɤ̆ŋ˩˧
mần	mɤ̆ŋ˦˨
mẫn	mɤ̆ŋ˧˩˨
mẩn	mɤ̆ŋ˧˩˨
mận	mɤ̆ŋ˨ˀ˩ʔ
mao	maw˧˥
mào	maw˦˨
mạo	maw˨ˀ˩ʔ
mấp	mɤ̆p˦˥
mập	mɤ̆p˨ˀ˩ʔ
mát	mak˦˥
mắt	măk˦˥
mắt,	măk˦˥
mạt	mak˨ˀ˩ʔ
mặt	măk˨ˀ˩ʔ
mặt,	măk˨ˀ˩ʔ
mất	mɤ̆k˦˥
mật	mɤ̆k˨ˀ˩ʔ
mau	măw˧˥
máu	măw˩˧
màu	măw˦˨
mâu	mɤ̆w˧˥
mấu	mɤ̆w˩˧
mầu	mɤ̆w˦˨
mẫu	mɤ̆w˧˩˨
mậu	mɤ̆w˨ˀ˩ʔ
may	măj˧˥
máy	măj˩˧
máy;	măj˩˧
mày	măj˦˨
mảy	măj˧˩˨
mạy	măj˨ˀ˩ʔ
mây	mɤ̆j˧˥
mấy	mɤ̆j˩˧
mầy	mɤ̆j˦˨
mẩy	mɤ̆j˧˩˨
mếch	met˦˥
mê	me˧˥
mề	me˦˨
mễ	me˧˩˨
me	mɛ˧˥
mè	mɛ˦˨
mẽ	mɛ˧˩˨
mẻ	mɛ˧˩˨
mẹ	mɛ˨ˀ˩ʔ
mềm	mem˦˨
mênh	men˧˥
mệnh	men˨ˀ˩ʔ
mên	men˧˥
mến	men˩˧
mền	men˦˨
men	mɛŋ˧˥
meo	meo˧˥
méo	meo˩˧
mèo	meo˦˨
mèo,	meo˦˨
mẹo	meo˨ˀ˩ʔ
mép	mɛp˦˥
mệt	met˨ˀ˩ʔ
mét	mɛk˦˥
mếu	mɛu˩˧
mía	miə˩˧
mỉa	miə˧˩˨
mích	mit˦˥
miếng	miəŋ˩˧
miệng	miəŋ˨ˀ˩ʔ
miên	miəŋ˧˥
miền	miəŋ˦˨
miễn	miəŋ˧˩˨
miệt	miək˨ˀ˩ʔ
miêu	miəw˧˥
miếu	miəw˩˧
miều	miəw˦˨
mi	mi˧˥
mì	mi˦˨
mĩ	mi˧˩˨
mỉ	mi˧˩˨
mị	mi˨ˀ˩ʔ
mim	mim˧˥
mỉm	mim˧˩˨
minh	min˧˥
mình	min˦˨
mình,	min˦˨
mìn	min˦˨
mịn	min˨ˀ˩ʔ
mít	mit˦˥
mít,	mit˦˥
mịt	mit˨ˀ˩ʔ
mỉu	miw˧˩˨
moay	mwăj˧˥
mô-bin	mo˧˥-bin˧˥
mốc	mokp˦˥
mộc	mokp˨ˀ˩ʔ
móc	mɔkp˦˥
mọc	mɔkp˨ˀ˩ʔ
mọc,	mɔkp˨ˀ˩ʔ
mới	mɤj˩˧
mới,	mɤj˩˧
mời	mɤj˦˨
mời,	mɤj˦˨
môi	moj˧˥
mối	moj˩˧
mồi	moj˦˨
mỗi	moj˧˩˨
moi	mɔj˧˥
mòi	mɔj˦˨
mỏi	mɔj˧˩˨
mọi	mɔj˨ˀ˩ʔ
mô-men	mo˧˥-mɛŋ˧˥
mơ	mɤ˧˥
mớ	mɤ˩˧
mờ	mɤ˦˨
mỡ	mɤ˧˩˨
mở	mɤ˧˩˨
mớm	mɤm˩˧
mồm	mom˦˨
móm	mɔm˩˧
mòm	mɔm˦˨
mõm	mɔm˧˩˨
mỏm	mɔm˧˩˨
mô	mo˧˥
mố	mo˩˧
mồ	mo˦˨
mổ	mo˧˩˨
mộ	mo˨ˀ˩ʔ
mo	mɔ˧˥
mó	mɔ˩˧
mò	mɔ˦˨
mõ	mɔ˧˩˨
mỏ	mɔ˧˩˨
mông	moŋm˧˥
mống	moŋm˩˧
mồng	moŋm˦˨
mộng	moŋm˨ˀ˩ʔ
mong	mɔŋm˧˥
móng	mɔŋm˩˧
mòng	mɔŋm˦˨
mỏng	mɔŋm˧˩˨
mọng	mɔŋm˨ˀ˩ʔ
mơn	mɤŋ˧˥
mớn	mɤŋ˩˧
mởn	mɤŋ˧˩˨
môn	moŋm˧˥
mồn	moŋm˦˨
mon	mɔŋm˧˥
món	mɔŋm˩˧
mòn	mɔŋm˦˨
moóc	mɔkp˦˥
móp	mɔp˦˥
mốt	mokp˦˥
mốt,	mokp˦˥
(một)	mokp˨ˀ˩ʔ
một	mokp˨ˀ˩ʔ
một,	mokp˨ˀ˩ʔ
mót	mɔkp˦˥
mọt	mɔkp˨ˀ˩ʔ
mô-tô	mo˧˥-to˧˥
mua	muə˧˥
múa	muə˩˧
mùa	muə˦˨
mưa	mɯə˧˥
mưa,	mɯə˧˥
mưa;	mɯə˧˥
mửa	mɯə˧˩˨
mục	mukp˨ˀ˩ʔ
mức	mɯk˦˥
mực	mɯk˨ˀ˩ʔ
mui	muj˧˥
múi	muj˩˧
mùi	muj˦˨
mũi	muj˧˩˨
mủi	muj˧˩˨
mum	mum˧˥
múm	mum˩˧
mũm	mum˧˩˨
mủm	mum˧˩˨
mú	mu˩˧
mù	mu˦˨
mũ	mu˧˩˨
mủ	mu˧˩˨
mụ	mu˨ˀ˩ʔ
mung	muŋm˧˥
mùng	muŋm˦˨
mủng	muŋm˧˩˨
mưng	mɯŋ˧˥
mừng	mɯŋ˦˨
mun	muŋm˧˥
mùn	muŋm˦˨
mụn	muŋm˨ˀ˩ʔ
mứn	mɯŋ˩˧
muối	muəj˩˧
muối,	muəj˩˧
muỗi	muəj˧˩˨
muội	muəj˨ˀ˩ʔ
mươi	mɯəj˧˥
mười	mɯəj˦˨
mười,	mɯəj˦˨
muồm	muəm˦˨
muông	muəŋ˧˥
muống	muəŋ˩˧
mương	mɯəŋ˧˥
mường	mɯəŋ˦˨
muôn	muəŋ˧˥
muốn	muəŋ˩˧
muộn	muəŋ˨ˀ˩ʔ
mươn	mɯəŋ˧˥
mướn	mɯəŋ˩˧
mườn	mɯəŋ˦˨
mượn	mɯəŋ˨ˀ˩ʔ
mướp	mɯəp˦˥
mướt	mɯək˦˥
mượt	mɯək˨ˀ˩ʔ
múp	mup˦˥
mút	mukp˦˥
mụt	mukp˨ˀ˩ʔ
mứt	mɯk˦˥
mưu	mɯw˧˥
mỹ	mi˧˩˨
nách	nak˦˥
nắc	năk˦˥
nạc	nak˨ˀ˩ʔ
nặc	năk˨ˀ˩ʔ
nấc	nɤ̆k˦˥
nai	naj˧˥
nái	naj˩˧
nái,	naj˩˧
nài	naj˦˨
nại	naj˨ˀ˩ʔ
nam-Đà	nam˧˥-da˦˨
nam-hạ	nam˧˥-ha˨ˀ˩ʔ
nam	nam˧˥
năm	năm˧˥
năm,	năm˧˥
nắm	năm˩˧
nằm	năm˦˨
nằm,	năm˦˨
nạm	nam˨ˀ˩ʔ
nấm	nɤ̆m˩˧
nầm	nɤ̆m˦˨
nam-sang	nam˧˥-ʂaŋ˧˥
na	na˧˥
ná	na˩˧
ná,	na˩˧
nà	na˦˨
nạ	na˨ˀ˩ʔ
nạ,	na˨ˀ˩ʔ
nang	naŋ˧˥
nàng	naŋ˦˨
năng	năŋ˧˥
nắng	năŋ˩˧
nắng,	năŋ˩˧
nằng	năŋ˦˨
nạng	naŋ˨ˀ˩ʔ
nặng	năŋ˨ˀ˩ʔ
nâng	nɤ̆ŋ˧˥
nẫng	nɤ̆ŋ˧˩˨
nanh	nan˧˥
nan	naŋ˧˥
nan,	naŋ˧˥
năn	năŋ˧˥
nắn	năŋ˩˧
nằn	năŋ˦˨
nản	naŋ˧˩˨
nạn	naŋ˨ˀ˩ʔ
nặn	năŋ˨ˀ˩ʔ
nân	nɤ̆ŋ˧˥
nấn	nɤ̆ŋ˩˧
nần	nɤ̆ŋ˦˨
nao	naw˧˥
náo	naw˩˧
nào	naw˦˨
nào,	naw˦˨
nào	naw˦˨
não	naw˧˩˨
nảo	naw˧˩˨
nạo	naw˨ˀ˩ʔ
náp	nap˦˥
nắp	năp˦˥
nạp	nap˨ˀ˩ʔ
nấp	nɤ̆p˦˥
nát	nak˦˥
nát,	nak˦˥
nạt	nak˨ˀ˩ʔ
náu	năw˩˧
nâu	nɤ̆w˧˥
nấu	nɤ̆w˩˧
nẫu	nɤ̆w˧˩˨
nay	năj˧˥
nay,	năj˧˥
này	năj˦˨
nãy	năj˧˩˨
nảy	năj˧˩˨
nây	nɤ̆j˧˥
nấy	nɤ̆j˩˧
nẩy	nɤ̆j˧˩˨
nêm	nem˧˥
nếm	nem˩˧
nệm	nem˨ˀ˩ʔ
nem	nɛm˧˥
ném	nɛm˩˧
nê	ne˧˥
nề	ne˦˨
nể	ne˧˩˨
nệ	ne˨ˀ˩ʔ
ne	nɛ˧˥
né	nɛ˩˧
nẻ	nɛ˧˩˨
nên	nen˧˥
nến	nen˩˧
nền	nen˦˨
nen	nɛŋ˧˥
nén	nɛŋ˩˧
neo	neo˧˥
néo	neo˩˧
nẻo	neo˧˩˨
nếp	nep˦˥
nẹp	nɛp˨ˀ˩ʔ
nết	net˦˥
nết,	net˦˥
nét	nɛk˦˥
nẹt	nɛk˨ˀ˩ʔ
nêu	nɛu˧˥
nếu	nɛu˩˧
ngạch	ŋak˨ˀ˩ʔ
ngác	ŋak˦˥
ngắc	ŋăk˦˥
ngạc	ŋak˨ˀ˩ʔ
ngấc	ŋɤ̆k˦˥
ngai	ŋaj˧˥
ngái	ŋaj˩˧
ngài	ŋaj˦˨
ngãi	ŋaj˧˩˨
ngãi,	ŋaj˧˩˨
ngải	ŋaj˧˩˨
ngại	ŋaj˨ˀ˩ʔ
ngam	ŋam˧˥
ngàm	ŋam˦˨
ngăm	ŋăm˧˥
ngắm	ŋăm˩˧
ngâm	ŋɤ̆m˧˥
ngấm	ŋɤ̆m˩˧
ngầm	ŋɤ̆m˦˨
ngẫm	ŋɤ̆m˧˩˨
ngẩm	ŋɤ̆m˧˩˨
ngậm	ŋɤ̆m˨ˀ˩ʔ
ngang	ŋaŋ˧˥
ngáng	ŋaŋ˩˧
ngẳng	ŋăŋ˧˩˨
ngãng	ŋaŋ˧˩˨
ngẩng	ŋɤ̆ŋ˧˩˨
ngành	ŋan˦˨
ngảnh	ŋan˧˩˨
ngan	ŋaŋ˧˥
ngán	ŋaŋ˩˧
ngàn	ŋaŋ˦˨
ngàn;	ŋaŋ˦˨
ngăn	ŋăŋ˧˥
ngắn	ŋăŋ˩˧
ngằn	ŋăŋ˦˨
ngạn	ŋaŋ˨ˀ˩ʔ
ngân	ŋɤ̆ŋ˧˥
ngấn	ŋɤ̆ŋ˩˧
ngần	ŋɤ̆ŋ˦˨
ngẩn	ŋɤ̆ŋ˧˩˨
ngận	ŋɤ̆ŋ˨ˀ˩ʔ
nga	ŋa˧˥
ngà	ŋa˦˨
ngà,	ŋa˦˨
ngã	ŋa˧˩˨
ngả	ŋa˧˩˨
ngao	ŋaw˧˥
ngáo	ŋaw˩˧
ngào	ŋaw˦˨
ngạo	ŋaw˨ˀ˩ʔ
ngáp	ŋap˦˥
ngấp	ŋɤ̆p˦˥
ngập	ŋɤ̆p˨ˀ˩ʔ
ngát	ŋak˦˥
ngắt	ŋăk˦˥
ngạt	ŋak˨ˀ˩ʔ
ngặt	ŋăk˨ˀ˩ʔ
ngất	ŋɤ̆k˦˥
ngật	ŋɤ̆k˨ˀ˩ʔ
ngau	ŋăw˧˥
ngàu	ŋăw˦˨
ngâu	ŋɤ̆w˧˥
ngấu	ŋɤ̆w˩˧
ngầu	ŋɤ̆w˦˨
ngẫu	ŋɤ̆w˧˩˨
ngậu	ŋɤ̆w˨ˀ˩ʔ
ngay	ŋăj˧˥
ngáy	ŋăj˩˧
(ngày)	ŋăj˦˨
ngày	ŋăj˦˨
ngày,	ŋăj˦˨
ngây	ŋɤ̆j˧˥
ngấy	ŋɤ̆j˩˧
ngầy	ŋɤ̆j˦˨
nghếch	ŋet˦˥
nghệch	ŋet˨ˀ˩ʔ
nghênh	ŋen˧˥
nghềnh	ŋen˦˨
nghễnh	ŋen˧˩˨
nghền	ŋen˦˨
nghển	ŋen˧˩˨
nghèn	ŋɛŋ˦˨
nghẽn	ŋɛŋ˧˩˨
nghẹn	ŋɛŋ˨ˀ˩ʔ
nghê	ŋe˧˥
nghề	ŋe˦˨
nghể	ŋe˧˩˨
nghệ	ŋe˨ˀ˩ʔ
nghe	ŋɛ˧˥
nghé	ŋɛ˩˧
nghè	ŋɛ˦˨
nghèo	ŋeo˦˨
nghệt	ŋet˨ˀ˩ʔ
nghẹt	ŋɛk˨ˀ˩ʔ
nghêu	ŋɛu˧˥
nghều	ŋɛu˦˨
nghễu	ŋɛu˧˩˨
nghĩa	ŋiə˧˩˨
nghĩa,	ŋiə˧˩˨
nghịch	ŋit˨ˀ˩ʔ
nghiêm	ŋiəm˧˥
nghiễm	ŋiəm˧˩˨
nghiệm	ŋiəm˨ˀ˩ʔ
nghiêng	ŋiəŋ˧˥
nghiên	ŋiəŋ˧˥
nghiến	ŋiəŋ˩˧
nghiền	ŋiəŋ˦˨
nghiện	ŋiəŋ˨ˀ˩ʔ
nghiệp	ŋiəp˨ˀ˩ʔ
nghiệt	ŋiək˨ˀ˩ʔ
nghiêu	ŋiəw˧˥
nghim	ŋim˧˥
nghinh	ŋin˧˥
nghìn	ŋin˦˨
nghi	ŋi˧˥
nghí	ŋi˩˧
nghì	ŋi˦˨
nghĩ	ŋi˧˩˨
nghỉ	ŋi˧˩˨
nghị	ŋi˨ˀ˩ʔ
nghỉu	ŋiw˧˩˨
ngoạch	ŋwak˨ˀ˩ʔ
ngoắc	ŋwăk˦˥
ngoặc	ŋwăk˨ˀ˩ʔ
ngoai	ŋwaj˧˥
ngoái	ŋwaj˩˧
ngoài	ŋwaj˦˨
ngoài,	ŋwaj˦˨
ngoại	ŋwaj˨ˀ˩ʔ
ngoam	ŋwam˧˥
ngoang	ŋwaŋ˧˥
ngoằng	ŋwăŋ˦˨
ngoảnh	ŋwan˧˩˨
ngoan	ŋwaŋ˧˥
ngoan,	ŋwaŋ˧˥
ngoăn	ŋwăŋ˧˥
ngoằn	ŋwăŋ˦˨
ngoạn	ŋwaŋ˨ˀ˩ʔ
ngoa	ŋwa˧˥
ngoã	ŋwa˧˩˨
ngoạ	ŋwa˨ˀ˩ʔ
ngoao	ŋwaw˧˥
ngoáo	ŋwaw˩˧
ngoắt	ŋwăk˦˥
ngoặt	ŋwăk˨ˀ˩ʔ
ngoay	ŋwăj˧˥
ngốc	ŋokp˦˥
ngộc	ŋokp˨ˀ˩ʔ
ngóc	ŋɔkp˦˥
ngọc	ŋɔkp˨ˀ˩ʔ
ngọc,	ŋɔkp˨ˀ˩ʔ
ngoem	ŋwem˧˥
ngoen	ŋwen˧˥
ngoe	ŋwe˧˥
ngoeo	ŋwew˧˥
ngoéo	ŋwew˩˧
ngoèo	ŋwew˦˨
ngoẻo	ŋwew˧˩˨
ngóeo	ŋwew˩˧
ngơi	ŋɤj˧˥
ngời	ŋɤj˦˨
ngợi	ŋɤj˨ˀ˩ʔ
ngôi	ŋoj˧˥
ngồi	ŋoj˦˨
ngoi	ŋɔj˧˥
ngói	ŋɔj˩˧
ngòi	ŋɔj˦˨
ngơm	ŋɤm˧˥
ngờm	ŋɤm˦˨
ngợm	ŋɤm˨ˀ˩ʔ
ngồm	ŋom˦˨
ngổm	ŋom˧˩˨
ngòm	ŋɔm˦˨
ngỏm	ŋɔm˧˩˨
ngông	ŋoŋm˧˥
ngồng	ŋoŋm˦˨
ngỗng	ŋoŋm˧˩˨
ngổng	ŋoŋm˧˩˨
ngong	ŋɔŋm˧˥
ngóng	ŋɔŋm˩˧
ngòng	ŋɔŋm˦˨
ngỏng	ŋɔŋm˧˩˨
ngỏng,	ŋɔŋm˧˩˨
ngọng	ŋɔŋm˨ˀ˩ʔ
ngơn	ŋɤŋ˧˥
ngôn	ŋoŋm˧˥
ngốn	ŋoŋm˩˧
ngồn	ŋoŋm˦˨
ngổn	ŋoŋm˧˩˨
ngon	ŋɔŋm˧˥
ngon,	ŋɔŋm˧˥
ngón	ŋɔŋm˩˧
ngòn	ŋɔŋm˦˨
ngỏn	ŋɔŋm˧˩˨
ngọn	ŋɔŋm˨ˀ˩ʔ
ngơ	ŋɤ˧˥
ngớ	ŋɤ˩˧
ngờ	ŋɤ˦˨
ngỡ	ŋɤ˧˩˨
ngô	ŋo˧˥
ngồ	ŋo˦˨
ngỗ	ŋo˧˩˨
ngổ	ŋo˧˩˨
ngộ	ŋo˨ˀ˩ʔ
ngo	ŋɔ˧˥
ngó	ŋɔ˩˧
ngò	ŋɔ˦˨
ngõ	ŋɔ˧˩˨
ngỏ	ŋɔ˧˩˨
ngọ	ŋɔ˨ˀ˩ʔ
ngợp	ŋɤp˨ˀ˩ʔ
ngớt	ŋɤk˦˥
ngốt	ŋokp˦˥
ngột	ŋokp˨ˀ˩ʔ
ngót	ŋɔkp˦˥
ngọt	ŋɔkp˨ˀ˩ʔ
ngọt,	ŋɔkp˨ˀ˩ʔ
ngưa	ŋɯə˧˥
ngứa	ŋɯə˩˧
ngửa	ŋɯə˧˩˨
ngựa	ŋɯə˨ˀ˩ʔ
nguây	ŋwɤ̆j˧˥
nguầy	ŋwɤ̆j˦˨
nguẩy	ŋwɤ̆j˧˩˨
ngúc	ŋukp˦˥
ngục	ŋukp˨ˀ˩ʔ
ngực	ŋɯk˨ˀ˩ʔ
nguếch	ŋwet˦˥
nguệch	ŋwet˨ˀ˩ʔ
ngùi	ŋuj˦˨
ngửi	ŋɯj˧˩˨
ngúng	ŋuŋm˩˧
ngũng	ŋuŋm˧˩˨
ngủng	ŋuŋm˧˩˨
ngưng	ŋɯŋ˧˥
ngừng	ŋɯŋ˦˨
ngửng	ŋɯŋ˧˩˨
ngun	ŋuŋm˧˥
ngùn	ŋuŋm˦˨
ngũn	ŋuŋm˧˩˨
ngủn	ŋuŋm˧˩˨
ngu	ŋu˧˥
ngú	ŋu˩˧
ngù	ŋu˦˨
ngũ	ŋu˧˩˨
ngủ	ŋu˧˩˨
ngụ	ŋu˨ˀ˩ʔ
ngư	ŋɯ˧˥
ngữ	ŋɯ˧˩˨
ngự	ŋɯ˨ˀ˩ʔ
ngước	ŋɯək˦˥
ngược	ŋɯək˨ˀ˩ʔ
nguôi	ŋuəj˧˥
nguồi	ŋuəj˦˨
nguội	ŋuəj˨ˀ˩ʔ
nguội,	ŋuəj˨ˀ˩ʔ
ngươi	ŋɯəj˧˥
người	ŋɯəj˦˨
người,	ŋɯəj˦˨
ngường	ŋɯəŋ˦˨
ngưỡng	ŋɯəŋ˧˩˨
ngượng	ŋɯəŋ˨ˀ˩ʔ
nguồn	ŋuəŋ˦˨
ngườ	ŋɯə˦˨
ngụp	ŋup˨ˀ˩ʔ
ngút	ŋukp˦˥
ngưu	ŋɯw˧˥
ngưu,	ŋɯw˧˥
nguých	ŋwit˦˥
nguyên	ŋwiəŋ˧˥
nguyền	ŋwiəŋ˦˨
nguyện	ŋwiəŋ˨ˀ˩ʔ
nguyệt	ŋwiək˨ˀ˩ʔ
ngụy	ŋuj˨ˀ˩ʔ
nguy	ŋwi˧˥
nguỵ	ŋwi˨ˀ˩ʔ
nguýt	ŋwit˦˥
nhác	ɲak˦˥
nhắc	ɲăk˦˥
nhạc	ɲak˨ˀ˩ʔ
nhấc	ɲɤ̆k˦˥
nhai	ɲaj˧˥
nhai,	ɲaj˧˥
nhai;	ɲaj˧˥
nhái	ɲaj˩˧
nhái,	ɲaj˩˧
nhài	ɲaj˦˨
nhãi	ɲaj˧˩˨
nham	ɲam˧˥
nhám	ɲam˩˧
nhàm	ɲam˦˨
nhăm	ɲăm˧˥
nhắm	ɲăm˩˧
nhằm	ɲăm˦˨
nhảm	ɲam˧˩˨
nhặm	ɲăm˨ˀ˩ʔ
nhâm	ɲɤ̆m˧˥
nhấm	ɲɤ̆m˩˧
nhầm	ɲɤ̆m˦˨
nhậm	ɲɤ̆m˨ˀ˩ʔ
nhậm,	ɲɤ̆m˨ˀ˩ʔ
nhang	ɲaŋ˧˥
nhàng	ɲaŋ˦˨
nhăng	ɲăŋ˧˥
nhắng	ɲăŋ˩˧
nhằng	ɲăŋ˦˨
nhẳng	ɲăŋ˧˩˨
nhãng	ɲaŋ˧˩˨
nhặng	ɲăŋ˨ˀ˩ʔ
nhâng	ɲɤ̆ŋ˧˥
nhanh	ɲan˧˥
nhan	ɲaŋ˧˥
nhàn	ɲaŋ˦˨
nhăn	ɲăŋ˧˥
nhắn	ɲăŋ˩˧
nhẵn	ɲăŋ˧˩˨
nhẳn	ɲăŋ˧˩˨
nhãn	ɲaŋ˧˩˨
nhạn	ɲaŋ˨ˀ˩ʔ
nhân	ɲɤ̆ŋ˧˥
nhân,	ɲɤ̆ŋ˧˥
nhấn	ɲɤ̆ŋ˩˧
nhần	ɲɤ̆ŋ˦˨
nhẫn	ɲɤ̆ŋ˧˩˨
nhẩn	ɲɤ̆ŋ˧˩˨
nhận	ɲɤ̆ŋ˨ˀ˩ʔ
nha	ɲa˧˥
nhá	ɲa˩˧
nhà	ɲa˦˨
nhà,	ɲa˦˨
nhã	ɲa˧˩˨
nhả	ɲa˧˩˨
nhao	ɲaw˧˥
nháo	ɲaw˩˧
nhào	ɲaw˦˨
nhão	ɲaw˧˩˨
nhạo	ɲaw˨ˀ˩ʔ
nhắp	ɲăp˦˥
nhấp	ɲɤ̆p˦˥
nhập	ɲɤ̆p˨ˀ˩ʔ
nhát	ɲak˦˥
nhạt	ɲak˨ˀ˩ʔ
nhặt	ɲăk˨ˀ˩ʔ
nhất	ɲɤ̆k˦˥
nhật	ɲɤ̆k˨ˀ˩ʔ
nhau	ɲăw˧˥
nhàu	ɲăw˦˨
nhảu	ɲăw˧˩˨
nhâu	ɲɤ̆w˧˥
nhầu	ɲɤ̆w˦˨
nhậu	ɲɤ̆w˨ˀ˩ʔ
nhay	ɲăj˧˥
nháy	ɲăj˩˧
nhày	ɲăj˦˨
nhảy	ɲăj˧˩˨
nhạy	ɲăj˨ˀ˩ʔ
nhây	ɲɤ̆j˧˥
nhầy	ɲɤ̆j˦˨
nhẩy	ɲɤ̆j˧˩˨
nhếch	ɲet˦˥
nhem	ɲɛm˧˥
nhèm	ɲɛm˦˨
nhẻm	ɲɛm˧˩˨
nhênh	ɲen˧˥
nhện	ɲen˨ˀ˩ʔ
nhen	ɲɛŋ˧˥
nhèn	ɲɛŋ˦˨
nhễ	ɲe˧˩˨
nhe	ɲɛ˧˥
(nhè)	ɲɛ˦˨
nhè	ɲɛ˦˨
nhẽ	ɲɛ˧˩˨
nhẻ	ɲɛ˧˩˨
nhẹ	ɲɛ˨ˀ˩ʔ
nheo	ɲeo˧˥
nhèo	ɲeo˦˨
nhẽo	ɲeo˧˩˨
nhếu	ɲɛu˩˧
nhều	ɲɛu˦˨
nhệu	ɲɛu˨ˀ˩ʔ
nhiếc	ɲiək˦˥
nhiễm	ɲiəm˧˩˨
nhiệm	ɲiəm˨ˀ˩ʔ
nhiên	ɲiəŋ˧˥
nhiếp	ɲiəp˦˥
nhiệt	ɲiək˨ˀ˩ʔ
nhiêu	ɲiəw˧˥
nhiều	ɲiəw˦˨
nhiễu	ɲiəw˧˩˨
nhím	ɲim˩˧
nhinh	ɲin˧˥
nhìn	ɲin˦˨
nhịn	ɲin˨ˀ˩ʔ
nhi	ɲi˧˥
nhí	ɲi˩˧
nhì	ɲi˦˨
nhĩ	ɲi˧˩˨
nhị	ɲi˨ˀ˩ʔ
nhíp	ɲip˦˥
nhịp	ɲip˨ˀ˩ʔ
nhiu	ɲiw˧˥
nhịu	ɲiw˨ˀ˩ʔ
nhoang	ɲwaŋ˧˥
nhoáng	ɲwaŋ˩˧
nhoay	ɲwăj˧˥
nhóc	ɲɔkp˦˥
nhọc	ɲɔkp˨ˀ˩ʔ
nhoen	ɲwen˧˥
nhoẻn	ɲwen˧˩˨
nhoe	ɲwe˧˥
nhoè	ɲwe˦˨
nhòe	ɲwe˦˨
nhoét	ɲwet˦˥
nhời	ɲɤj˦˨
nhồi	ɲoj˦˨
nhoi	ɲɔj˧˥
nhơm	ɲɤm˧˥
nhôm	ɲom˧˥
nhồm	ɲom˦˨
nhom	ɲɔm˧˥
nhóm	ɲɔm˩˧
nhòm	ɲɔm˦˨
nhỏm	ɲɔm˧˩˨
nhông	ɲoŋm˧˥
nhộng	ɲoŋm˨ˀ˩ʔ
nhong	ɲɔŋm˧˥
nhóng	ɲɔŋm˩˧
nhõng	ɲɔŋm˧˩˨
nhỏng	ɲɔŋm˧˩˨
nhơn	ɲɤŋ˧˥
nhớn	ɲɤŋ˩˧
nhờn	ɲɤŋ˦˨
nhỡn	ɲɤŋ˧˩˨
nhởn	ɲɤŋ˧˩˨
nhôn	ɲoŋm˧˥
nhốn	ɲoŋm˩˧
nhồn	ɲoŋm˦˨
nhộn	ɲoŋm˨ˀ˩ʔ
nhon	ɲɔŋm˧˥
nhón	ɲɔŋm˩˧
nhỏn	ɲɔŋm˧˩˨
nhọn	ɲɔŋm˨ˀ˩ʔ
nhọn,	ɲɔŋm˨ˀ˩ʔ
nhơ	ɲɤ˧˥
nhớ	ɲɤ˩˧
nhờ	ɲɤ˦˨
nhỡ	ɲɤ˧˩˨
nhố	ɲo˩˧
nhổ	ɲo˧˩˨
nho	ɲɔ˧˥
nhỏ	ɲɔ˧˩˨
nhọ	ɲɔ˨ˀ˩ʔ
nhớp	ɲɤp˦˥
nhóp	ɲɔp˦˥
nhớt	ɲɤk˦˥
nhợt	ɲɤk˨ˀ˩ʔ
nhột	ɲokp˨ˀ˩ʔ
nhót	ɲɔkp˦˥
nhọt	ɲɔkp˨ˀ˩ʔ
nhuần	ɲwɤ̆ŋ˦˨
nhuận	ɲwɤ̆ŋ˨ˀ˩ʔ
nhựa	ɲɯə˨ˀ˩ʔ
nhúc	ɲukp˦˥
nhục	ɲukp˨ˀ˩ʔ
nhức	ɲɯk˦˥
nhuế	ɲwe˩˧
nhuệ	ɲwe˨ˀ˩ʔ
nhúm	ɲum˩˧
nhung	ɲuŋm˧˥
nhúng	ɲuŋm˩˧
nhùng	ɲuŋm˦˨
nhũng	ɲuŋm˧˩˨
nhủng	ɲuŋm˧˩˨
nhụng	ɲuŋm˨ˀ˩ʔ
nhưng	ɲɯŋ˧˥
những	ɲɯŋ˧˩˨
nhửng	ɲɯŋ˧˩˨
nhun	ɲuŋm˧˥
nhún	ɲuŋm˩˧
nhùn	ɲuŋm˦˨
nhũn	ɲuŋm˧˩˨
nhủn	ɲuŋm˧˩˨
nhu	ɲu˧˥
nhù	ɲu˦˨
nhũ	ɲu˧˩˨
nhủ	ɲu˧˩˨
như	ɲɯ˧˥
nhừ	ɲɯ˦˨
nhữ	ɲɯ˧˩˨
nhuốc	ɲuək˦˥
nhược	ɲɯək˨ˀ˩ʔ
nhuôm	ɲuəm˧˥
nhuốm	ɲuəm˩˧
nhuộm	ɲuəm˨ˀ˩ʔ
nhường	ɲɯəŋ˦˨
nhường;	ɲɯəŋ˦˨
nhưỡng	ɲɯəŋ˧˩˨
nhượng	ɲɯəŋ˨ˀ˩ʔ
nhút	ɲukp˦˥
nhụt	ɲukp˨ˀ˩ʔ
nhựt	ɲɯk˨ˀ˩ʔ
nhuyễn	ɲwiəŋ˧˩˨
ních	nit˦˥
nịch	nit˨ˀ˩ʔ
niêm	niəm˧˥
niềm	niəm˦˨
niệm	niəm˨ˀ˩ʔ
niềng	niəŋ˦˨
niên	niəŋ˧˥
niết	niək˦˥
niêu	niəw˧˥
niệu	niəw˨ˀ˩ʔ
ninh	nin˧˥
nình	nin˦˨
nịnh	nin˨ˀ˩ʔ
ni	ni˧˥
nì	ni˦˨
nỉ	ni˧˩˨
nin	nin˧˥
nín	nin˩˧
nịt	nit˨ˀ˩ʔ
niu	niw˧˥
níu	niw˩˧
noãn	nwaŋ˧˩˨
nốc	nokp˦˥
nóc	nɔkp˦˥
nóc,	nɔkp˦˥
nọc	nɔkp˨ˀ˩ʔ
nơi	nɤj˧˥
nơi,	nɤj˧˥
nới	nɤj˩˧
nối	noj˩˧
nồi	noj˦˨
nồi,	noj˦˨
nỗi	noj˧˩˨
nổi	noj˧˩˨
nội	noj˨ˀ˩ʔ
nội,	noj˨ˀ˩ʔ
noi	nɔj˧˥
nói	nɔj˩˧
nói,	nɔj˩˧
nòi	nɔj˦˨
nơm	nɤm˧˥
nờm	nɤm˦˨
nôm	nom˧˥
nơ	nɤ˧˥
nỡ	nɤ˧˩˨
nở	nɤ˧˩˨
nợ	nɤ˨ˀ˩ʔ
nợ,	nɤ˨ˀ˩ʔ
nông	noŋm˧˥
nông,	noŋm˧˥
nồng	noŋm˦˨
nong	nɔŋm˧˥
nóng	nɔŋm˩˧
nòng	nɔŋm˦˨
nôn	noŋm˧˥
nộn	noŋm˨ˀ˩ʔ
non	nɔŋm˧˥
nón	nɔŋm˩˧
nõn	nɔŋm˧˩˨
nô	no˧˥
nỗ	no˧˩˨
nổ	no˧˩˨
nộ	no˨ˀ˩ʔ
no	nɔ˧˥
no,	nɔ˧˥
no;	nɔ˧˥
nó	nɔ˩˧
nõ	nɔ˧˩˨
nỏ	nɔ˧˩˨
nọ	nɔ˨ˀ˩ʔ
nọ,	nɔ˨ˀ˩ʔ
noong	nɔŋm˧˥
nớp	nɤp˦˥
nộp	nop˨ˀ˩ʔ
nốt	nokp˦˥
nót	nɔkp˦˥
nua	nuə˧˥
núa	nuə˩˧
nứa	nɯə˩˧
nữa	nɯə˧˩˨
nữa;	nɯə˧˩˨
nửa	nɯə˧˩˨
núc	nukp˦˥
nục	nukp˨ˀ˩ʔ
nức	nɯk˦˥
nực	nɯk˨ˀ˩ʔ
núi	nuj˩˧
num	num˧˥
núm	num˩˧
nung	nuŋm˧˥
núng	nuŋm˩˧
nùng	nuŋm˦˨
nũng	nuŋm˧˩˨
nưng	nɯŋ˧˥
nựng	nɯŋ˨ˀ˩ʔ
nu	nu˧˥
nụ	nu˨ˀ˩ʔ
nữ	nɯ˧˩˨
nử	nɯ˧˩˨
nước	nɯək˦˥
nước,	nɯək˦˥
nuôi	nuəj˧˥
nuôi,	nuəj˧˥
nuối	nuəj˩˧
nườm	nɯəm˦˨
nuông	nuəŋ˧˥
nương	nɯəŋ˧˥
nướng	nɯəŋ˩˧
nuốt	nuək˦˥
nuột	nuək˨ˀ˩ʔ
núp	nup˦˥
nút	nukp˦˥
nứt	nɯk˦˥
oác	wak˦˥
oai	waj˧˥
oái	waj˩˧
oải	waj˧˩˨
oàm	wam˦˨
oang	waŋ˧˥
oàng	waŋ˦˨
oăng	wăŋ˧˥
oanh	wan˧˥
oành	wan˦˨
oan	waŋ˧˥
oán	waŋ˩˧
oăn	wăŋ˧˥
oằn	wăŋ˦˨
oẳn	wăŋ˧˩˨
oản	waŋ˧˩˨
oát	wak˦˥
oắt	wăk˦˥
oặt	wăk˨ˀ˩ʔ
oa	wa˧˥
ốc	okp˦˥
ốc,	okp˦˥
ộc	okp˨ˀ˩ʔ
óc	ɔkp˦˥
óc,	ɔkp˦˥
ọc	ɔkp˨ˀ˩ʔ
oeng	wen˧˥
oe	we˧˥
oé	we˩˧
oẻ	we˧˩˨
ỏe	we˧˩˨
ơ	ɤ˧˥
ớ	ɤ˩˧
ờ	ɤ˦˨
ở	ɤ˧˩˨
ở,	ɤ˧˩˨
ợ	ɤ˨ˀ˩ʔ
ơi	ɤj˧˥
ời	ɤj˦˨
ôi	oj˧˥
ối	oj˩˧
ồi	oj˦˨
ổi	oj˧˩˨
oi	ɔj˧˥
ói	ɔj˩˧
òi	ɔj˦˨
ỏi	ɔj˧˩˨
ỡm	ɤm˧˩˨
ôm	om˧˥
ốm	om˩˧
ồm	om˦˨
ổm	om˧˩˨
om	ɔm˧˥
òm	ɔm˦˨
ỏm	ɔm˧˩˨
ơn	ɤŋ˧˥
ớn	ɤŋ˩˧
ờn	ɤŋ˦˨
ông	oŋm˧˥
ống	oŋm˩˧
ồng	oŋm˦˨
ong	ɔŋm˧˥
óng	ɔŋm˩˧
òng	ɔŋm˦˨
õng	ɔŋm˧˩˨
ỏng	ɔŋm˧˩˨
ôn	oŋm˧˥
ồn	oŋm˦˨
ổn	oŋm˧˩˨
ộn	oŋm˨ˀ˩ʔ
ỏn	ɔŋm˧˩˨
ô	o˧˥
ô,	o˧˥
ố	o˩˧
ồ	o˦˨
ổ	o˧˩˨
oong	ɔŋm˧˥
ộ	o˨ˀ˩ʔ
o	ɔ˧˥
o,	ɔ˧˥
ó	ɔ˩˧
ò	ɔ˦˨
ọ	ɔ˨ˀ˩ʔ
ốp	op˦˥
ộp	op˨ˀ˩ʔ
óp	ɔp˦˥
ọp	ɔp˨ˀ˩ʔ
ớt	ɤk˦˥
ớt,	ɤk˦˥
ốt	okp˦˥
ô-tô	o˧˥-to˧˥
ót	ɔkp˦˥
ọt	ɔkp˨ˀ˩ʔ
o-xi	ɔ˧˥-si˧˥
o-xít	ɔ˧˥-sit˦˥
o-xy	ɔ˧˥-si˧˥
pác	pak˦˥
pa	pa˧˥
pà	pa˦˨
pát	pak˦˥
pâu	pɤ̆w˧˥
pe-man-ga-nát	pɛ˧˥-maŋ˧˥-ɣa˧˥-nak˦˥
pen	pɛŋ˧˥
pê	pe˧˥
phác	fak˦˥
phắc	făk˦˥
phách	fak˦˥
phạch	fak˨ˀ˩ʔ
pha	fa˧˥
phá	fa˩˧
phà	fa˦˨
phả	fa˧˩˨
phai	faj˧˥
phái	faj˩˧
phải	faj˧˩˨
phải,	faj˧˩˨
phàm	fam˦˨
phăm	făm˧˥
phạm	fam˨ˀ˩ʔ
phầm	fɤ̆m˦˨
phẩm	fɤ̆m˧˩˨
phán	faŋ˩˧
phàn	faŋ˦˨
phăn	făŋ˧˥
phản	faŋ˧˩˨
phạn	faŋ˨ˀ˩ʔ
phân	fɤ̆ŋ˧˥
phân,	fɤ̆ŋ˧˥
phấn	fɤ̆ŋ˩˧
phần	fɤ̆ŋ˦˨
phẫn	fɤ̆ŋ˧˩˨
phận	fɤ̆ŋ˨ˀ˩ʔ
phang	faŋ˧˥
phăng	făŋ˧˥
phẳng	făŋ˧˩˨
phảng	faŋ˧˩˨
phanh	fan˧˥
phành	fan˦˨
phao	faw˧˥
pháo	faw˩˧
pháp	fap˦˥
pháp;	fap˦˥
phấp	fɤ̆p˦˥
phập	fɤ̆p˨ˀ˩ʔ
phát	fak˦˥
phát,	fak˦˥
phắt	făk˦˥
phạt	fak˨ˀ˩ʔ
phất	fɤ̆k˦˥
phật	fɤ̆k˨ˀ˩ʔ
phau	făw˧˥
phẫu	fɤ̆w˧˩˨
phay	făj˧˥
phây	fɤ̆j˧˥
phẩy	fɤ̆j˧˩˨
phéc	fɛk˦˥
phê	fe˧˥
phế	fe˩˧
phề	fe˦˨
phệ	fe˨ˀ˩ʔ
phe	fɛ˧˥
phè	fɛ˦˨
phên	fen˧˥
phèn	fɛŋ˦˨
phèng	fɛŋ˦˨
phềnh	fen˦˨
phệnh	fen˨ˀ˩ʔ
phép	fɛp˦˥
phét	fɛk˦˥
phẹt	fɛk˨ˀ˩ʔ
phều	fɛu˦˨
phìa	fiə˦˨
phiếm	fiəm˩˧
phiên	fiəŋ˧˥
phiên,	fiəŋ˧˥
phiến	fiəŋ˩˧
phiền	fiəŋ˦˨
phiệt	fiək˨ˀ˩ʔ
phiêu	fiəw˧˥
phiếu	fiəw˩˧
phi	fi˧˥
phí	fi˩˧
phì	fi˦˨
phỉ	fi˧˩˨
phim	fim˧˥
phím	fim˩˧
phin	fin˧˥
phìn	fin˦˨
phinh	fin˧˥
phình	fin˦˨
phĩnh	fin˧˩˨
phỉnh	fin˧˩˨
phịu	fiw˨ˀ˩ʔ
phốc	fokp˦˥
phơ	fɤ˧˥
phờ	fɤ˦˨
phở	fɤ˧˩˨
phô	fo˧˥
phố	fo˩˧
phổ	fo˧˩˨
pho	fɔ˧˥
phó	fɔ˩˧
phò	fɔ˦˨
phơi	fɤj˧˥
phới	fɤj˩˧
phôi	foj˧˥
phối	foj˩˧
phổi	foj˧˩˨
phòi	fɔj˦˨
phôm	fom˧˥
phồm	fom˦˨
phơn	fɤŋ˧˥
phớn	fɤŋ˩˧
phởn	fɤŋ˧˩˨
phồn	foŋm˦˨
phông	foŋm˧˥
phồng	foŋm˦˨
phỗng	foŋm˧˩˨
phổng	foŋm˧˩˨
phộng;	foŋm˨ˀ˩ʔ
phong	fɔŋm˧˥
phóng	fɔŋm˩˧
phòng	fɔŋm˦˨
phỏng	fɔŋm˧˩˨
phọng,	fɔŋm˨ˀ˩ʔ
phoóc	fɔkp˦˥
phốp	fop˦˥
phớt	fɤk˦˥
phốt	fokp˦˥
phọt	fɔkp˨ˀ˩ʔ
phứa	fɯə˩˧
phúc	fukp˦˥
phúc,	fukp˦˥
phục	fukp˨ˀ˩ʔ
phức	fɯk˦˥
phu	fu˧˥
phú	fu˩˧
phù	fu˦˨
phũ	fu˧˩˨
phủ	fu˧˩˨
phủ;	fu˧˩˨
phụ	fu˨ˀ˩ʔ
phui	fuj˧˥
phủi	fuj˧˩˨
phun	fuŋm˧˥
phún	fuŋm˩˧
phùn	fuŋm˦˨
phừn	fɯŋ˦˨
phung	fuŋm˧˥
phúng	fuŋm˩˧
phùng	fuŋm˦˨
phụng	fuŋm˨ˀ˩ʔ
phưng	fɯŋ˧˥
phừng	fɯŋ˦˨
phước	fɯək˦˥
phướn	fɯəŋ˩˧
phương	fɯəŋ˧˥
phường	fɯəŋ˦˨
phượng	fɯəŋ˨ˀ˩ʔ
phút	fukp˦˥
pin	pin˧˥
pi	pi˧˥
pít	pit˦˥
pô-li-me	po˧˥-li˧˥-mɛ˧˥
pom	pɔm˧˥
pơ	pɤ˧˥
pô	po˧˥
puốc	puək˦˥
pu	pu˧˥
quách	wak˦˥
quác	wak˦˥
quắc	wăk˦˥
quạc	wak˨ˀ˩ʔ
quai	waj˧˥
quái	waj˩˧
quái,	waj˩˧
quài	waj˦˨
quải	waj˧˩˨
quăm	wăm˧˥
quằm	wăm˦˨
quặm	wăm˨ˀ˩ʔ
quang	waŋ˧˥
quáng	waŋ˩˧
quáng,	waŋ˩˧
quàng	waŋ˦˨
quăng	wăŋ˧˥
quẳng	wăŋ˧˩˨
quãng	waŋ˧˩˨
quảng	waŋ˧˩˨
quầng	wɤ̆ŋ˦˨
quẩng	wɤ̆ŋ˧˩˨
quanh	wan˧˥
quánh	wan˩˧
quành	wan˦˨
quạnh	wan˨ˀ˩ʔ
quan	waŋ˧˥
quán	waŋ˩˧
quăn	wăŋ˧˥
quằn	wăŋ˦˨
quản	waŋ˧˩˨
quặn	wăŋ˨ˀ˩ʔ
quân	wɤ̆ŋ˧˥
quấn	wɤ̆ŋ˩˧
quần	wɤ̆ŋ˦˨
quẫn	wɤ̆ŋ˧˩˨
quẩn	wɤ̆ŋ˧˩˨
quận	wɤ̆ŋ˨ˀ˩ʔ
quắp	wăp˦˥
quặp	wăp˨ˀ˩ʔ
quát	wak˦˥
quắt	wăk˦˥
quạt	wak˨ˀ˩ʔ
quặt	wăk˨ˀ˩ʔ
quất	wɤ̆k˦˥
quật	wɤ̆k˨ˀ˩ʔ
quau	wăw˧˥
quàu	wăw˦˨
quạu	wăw˨ˀ˩ʔ
qua	wa˧˥
qua,	wa˧˥
(quá	wa˩˧
quá	wa˩˧
quá,	wa˩˧
quà	wa˦˨
quả	wa˧˩˨
quạ	wa˨ˀ˩ʔ
quay	wăj˧˥
quày	wăj˦˨
quảy	wăj˧˩˨
quây	wɤ̆j˧˥
quấy	wɤ̆j˩˧
quầy	wɤ̆j˦˨
quậy	wɤ̆j˨ˀ˩ʔ
quếch	wet˦˥
quệch	wet˨ˀ˩ʔ
queng	wɛŋ˧˥
quếnh	wen˩˧
quềnh	wen˦˨
quệnh	wen˨ˀ˩ʔ
quên	wen˧˥
quến	wen˩˧
quen	wɛŋ˧˥
quèn	wɛŋ˦˨
queo	weo˧˥
quèo	weo˦˨
quẹo	weo˨ˀ˩ʔ
quết	wet˦˥
quét	wɛk˦˥
quẹt	wɛk˨ˀ˩ʔ
quếu	wɛu˩˧
quều	wɛu˦˨
quê	we˧˥
quế	we˩˧
quế,	we˩˧
quề	we˦˨
que	wɛ˧˥
què	wɛ˦˨
quẻ	wɛ˧˩˨
quình	win˦˨
quít	wit˦˥
qui	wi˧˥
quí	wi˩˧
quì	wi˦˨
quĩ	wi˧˩˨
quỉ	wi˧˩˨
quỉ,	wi˧˩˨
quị	wi˨ˀ˩ʔ
quốc	wokp˦˥
quới	wɤj˩˧
quờn	wɤŋ˦˨
quơ	wɤ˧˥
quờ	wɤ˦˨
quở	wɤ˧˩˨
quyên	wiɛŋ˧˥
quyến	wiɛŋ˩˧
quyền	wiɛŋ˦˨
quyển	wiɛŋ˧˩˨
quyết	wiɛk˦˥
quýnh	win˩˧
quỳnh	win˦˨
quýt	wit˦˥
quy	wi˧˥
quý	wi˩˧
quỳ	wi˦˨
quỹ	wi˧˩˨
quỷ	wi˧˩˨
quỵ	wi˨ˀ˩ʔ
rách	ʐak˦˥
rạch	ʐak˨ˀ˩ʔ
rác	ʐak˦˥
rắc	ʐăk˦˥
rạc	ʐak˨ˀ˩ʔ
ra-đi-ô	ʐa˧˥-di˧˥-o˧˥
rái	ʐaj˩˧
rãi	ʐaj˧˩˨
rải	ʐaj˧˩˨
ram	ʐam˧˥
rám	ʐam˩˧
răm	ʐăm˧˥
rắm	ʐăm˩˧
rằm	ʐăm˦˨
rặm	ʐăm˨ˀ˩ʔ
râm	ʐɤ̆m˧˥
rấm	ʐɤ̆m˩˧
rầm	ʐɤ̆m˦˨
rậm	ʐɤ̆m˨ˀ˩ʔ
rang	ʐaŋ˧˥
ráng	ʐaŋ˩˧
ràng	ʐaŋ˦˨
răng	ʐăŋ˧˥
răng,	ʐăŋ˧˥
rằng	ʐăŋ˦˨
rạng	ʐaŋ˨ˀ˩ʔ
ranh	ʐan˧˥
rành	ʐan˦˨
rãnh	ʐan˧˩˨
rảnh	ʐan˧˩˨
ran	ʐaŋ˧˥
rán	ʐaŋ˩˧
ràn	ʐaŋ˦˨
răn	ʐăŋ˧˥
rắn	ʐăŋ˩˧
rắn,	ʐăŋ˩˧
rằn	ʐăŋ˦˨
rạn	ʐaŋ˨ˀ˩ʔ
rân	ʐɤ̆ŋ˧˥
rấn	ʐɤ̆ŋ˩˧
rần	ʐɤ̆ŋ˦˨
rận	ʐɤ̆ŋ˨ˀ˩ʔ
rao	ʐaw˧˥
ráo	ʐaw˩˧
rào	ʐaw˦˨
rảo	ʐaw˧˩˨
rạo	ʐaw˨ˀ˩ʔ
ráp	ʐap˦˥
rắp	ʐăp˦˥
rạp	ʐap˨ˀ˩ʔ
rấp	ʐɤ̆p˦˥
rập	ʐɤ̆p˨ˀ˩ʔ
rát	ʐak˦˥
rặt	ʐăk˨ˀ˩ʔ
rất	ʐɤ̆k˦˥
rau	ʐăw˧˥
rau,	ʐăw˧˥
ráu	ʐăw˩˧
râu	ʐɤ̆w˧˥
râu,	ʐɤ̆w˧˥
rầu	ʐɤ̆w˦˨
ray	ʐăj˧˥
ráy	ʐăj˩˧
rày	ʐăj˦˨
rầy	ʐɤ̆j˦˨
rẫy	ʐɤ̆j˧˩˨
(ra)	ʐa˧˥
ra	ʐa˧˥
ra,	ʐa˧˥
rá	ʐa˩˧
rá,	ʐa˩˧
rà	ʐa˦˨
rã	ʐa˧˩˨
rả	ʐa˧˩˨
rạ	ʐa˨ˀ˩ʔ
rếch	ʐet˦˥
reng	ʐɛŋ˧˥
rềnh	ʐen˦˨
rểnh	ʐen˧˩˨
rên	ʐen˧˥
rền	ʐen˦˨
ren	ʐɛŋ˧˥
rén	ʐɛŋ˩˧
rèn	ʐɛŋ˦˨
reo	ʐeo˧˥
réo	ʐeo˩˧
rèo	ʐeo˦˨
rẻo	ʐeo˧˩˨
rẹo	ʐeo˨ˀ˩ʔ
rệp	ʐep˨ˀ˩ʔ
rết	ʐet˦˥
rét	ʐɛk˦˥
rêu	ʐɛu˧˥
rệu	ʐɛu˨ˀ˩ʔ
rế	ʐe˩˧
rề	ʐe˦˨
rề,	ʐe˦˨
rễ	ʐe˧˩˨
rể	ʐe˧˩˨
re	ʐɛ˧˥
ré	ʐɛ˩˧
rè	ʐɛ˦˨
rẽ	ʐɛ˧˩˨
rẻ	ʐɛ˧˩˨
rịa-vũng	ʐiə˨ˀ˩ʔ-juŋm˧˩˨
rìa	ʐiə˦˨
rỉa	ʐiə˧˩˨
rích	ʐit˦˥
rịch	ʐit˨ˀ˩ʔ
riêng	ʐiəŋ˧˥
riềng	ʐiəŋ˦˨
riết	ʐiək˦˥
riêu	ʐiəw˧˥
rinh	ʐin˧˥
rình	ʐin˦˨
rin	ʐin˧˥
rít	ʐit˦˥
riu	ʐiw˧˥
ríu	ʐiw˩˧
rìu	ʐiw˦˨
ri	ʐi˧˥
rí	ʐi˩˧
rì	ʐi˦˨
rĩ	ʐi˧˩˨
rỉ	ʐi˧˩˨
rị	ʐi˨ˀ˩ʔ
rốc	ʐokp˦˥
rộc	ʐokp˨ˀ˩ʔ
róc	ʐɔkp˦˥
rọc	ʐɔkp˨ˀ˩ʔ
rơi	ʐɤj˧˥
rơi,	ʐɤj˧˥
rời	ʐɤj˦˨
rối	ʐoj˩˧
rồi	ʐoj˦˨
rỗi	ʐoj˧˩˨
roi	ʐɔj˧˥
rơm	ʐɤm˧˥
rờm	ʐɤm˦˨
rởm	ʐɤm˧˩˨
rôm	ʐom˧˥
rồm	ʐom˦˨
ròm	ʐɔm˦˨
rông	ʐoŋm˧˥
rống	ʐoŋm˩˧
rồng	ʐoŋm˦˨
rỗng	ʐoŋm˧˩˨
rộng	ʐoŋm˨ˀ˩ʔ
rong	ʐɔŋm˧˥
ròng	ʐɔŋm˦˨
rơn	ʐɤŋ˧˥
rờn	ʐɤŋ˦˨
rởn	ʐɤŋ˧˩˨
rợn	ʐɤŋ˨ˀ˩ʔ
rôn	ʐoŋm˧˥
rốn	ʐoŋm˩˧
rồn	ʐoŋm˦˨
rổn	ʐoŋm˧˩˨
rộn	ʐoŋm˨ˀ˩ʔ
rón	ʐɔŋm˩˧
ròn	ʐɔŋm˦˨
rợp	ʐɤp˨ˀ˩ʔ
rớt	ʐɤk˦˥
rốt	ʐokp˦˥
rột	ʐokp˨ˀ˩ʔ
rót	ʐɔkp˦˥
rọt	ʐɔkp˨ˀ˩ʔ
rơ	ʐɤ˧˥
rờ	ʐɤ˦˨
rỡ	ʐɤ˧˩˨
rợ	ʐɤ˨ˀ˩ʔ
rô	ʐo˧˥
rồ	ʐo˦˨
rỗ	ʐo˧˩˨
rổ	ʐo˧˩˨
rộ	ʐo˨ˀ˩ʔ
ro	ʐɔ˧˥
ró	ʐɔ˩˧
rò	ʐɔ˦˨
rõ	ʐɔ˧˩˨
rỏ	ʐɔ˧˩˨
rọ	ʐɔ˨ˀ˩ʔ
rùa	ʐuə˦˨
rủa	ʐuə˧˩˨
rưa	ʐɯə˧˥
rữa	ʐɯə˧˩˨
rửa	ʐɯə˧˩˨
rựa	ʐɯə˨ˀ˩ʔ
rúc	ʐukp˦˥
rục	ʐukp˨ˀ˩ʔ
rực	ʐɯk˨ˀ˩ʔ
rúi	ʐuj˩˧
rủi	ʐuj˧˩˨
rúm	ʐum˩˧
rùm	ʐum˦˨
rung	ʐuŋm˧˥
rúng	ʐuŋm˩˧
rùng	ʐuŋm˦˨
rủng	ʐuŋm˧˩˨
rụng	ʐuŋm˨ˀ˩ʔ
rưng	ʐɯŋ˧˥
rừng	ʐɯŋ˦˨
rửng	ʐɯŋ˧˩˨
run	ʐuŋm˧˥
rún	ʐuŋm˩˧
rủn	ʐuŋm˧˩˨
ruốc	ʐuək˦˥
rước	ʐɯək˦˥
ruồi	ʐuəj˦˨
ruổi	ʐuəj˧˩˨
rươi	ʐɯəj˧˥
rười	ʐɯəj˦˨
rươm	ʐɯəm˧˥
rườm	ʐɯəm˦˨
ruồng	ʐuəŋ˦˨
ruỗng	ʐuəŋ˧˩˨
ruộng	ʐuəŋ˨ˀ˩ʔ
rương	ʐɯəŋ˧˥
rường	ʐɯəŋ˦˨
ruôn	ʐuəŋ˧˥
rướn	ʐɯəŋ˩˧
rườn	ʐɯəŋ˦˨
rượn	ʐɯəŋ˨ˀ˩ʔ
ruột	ʐuək˨ˀ˩ʔ
rượu	ʐɯəw˨ˀ˩ʔ
rụp	ʐup˨ˀ˩ʔ
rút	ʐukp˦˥
rụt	ʐukp˨ˀ˩ʔ
rứt	ʐɯk˦˥
ru	ʐu˧˥
rú	ʐu˩˧
rù	ʐu˦˨
rũ	ʐu˧˩˨
rủ	ʐu˧˩˨
rụ;	ʐu˨ˀ˩ʔ
sách	ʂak˦˥
sạch	ʂak˨ˀ˩ʔ
sạch,	ʂak˨ˀ˩ʔ
sắc	ʂăk˦˥
sặc	ʂăk˨ˀ˩ʔ
sai	ʂaj˧˥
sái	ʂaj˩˧
sài	ʂaj˦˨
sãi	ʂaj˧˩˨
sải	ʂaj˧˩˨
sam	ʂam˧˥
sám	ʂam˩˧
sàm	ʂam˦˨
săm	ʂăm˧˥
sắm	ʂăm˩˧
sạm	ʂam˨ˀ˩ʔ
sặm	ʂăm˨ˀ˩ʔ
sâm	ʂɤ̆m˧˥
sấm	ʂɤ̆m˩˧
sầm	ʂɤ̆m˦˨
sẩm	ʂɤ̆m˧˩˨
sậm	ʂɤ̆m˨ˀ˩ʔ
sang	ʂaŋ˧˥
sang,	ʂaŋ˧˥
sáng	ʂaŋ˩˧
sáng,	ʂaŋ˩˧
sàng	ʂaŋ˦˨
sàng,	ʂaŋ˦˨
săng	ʂăŋ˧˥
sằng	ʂăŋ˦˨
sảng	ʂaŋ˧˩˨
sanh	ʂan˧˥
sánh	ʂan˩˧
sành	ʂan˦˨
sảnh	ʂan˧˩˨
san	ʂaŋ˧˥
sán	ʂaŋ˩˧
sàn	ʂaŋ˦˨
săn	ʂăŋ˧˥
sắn	ʂăŋ˩˧
sẵn	ʂăŋ˧˩˨
sản	ʂaŋ˧˩˨
sạn	ʂaŋ˨ˀ˩ʔ
sân	ʂɤ̆ŋ˧˥
sấn	ʂɤ̆ŋ˩˧
sần	ʂɤ̆ŋ˦˨
sao	ʂaw˧˥
sao,	ʂaw˧˥
sáo	ʂaw˩˧
sào	ʂaw˦˨
sảo	ʂaw˧˩˨
sạo	ʂaw˨ˀ˩ʔ
sáp	ʂap˦˥
sắp	ʂăp˦˥
sẵp	ʂăp˧˩˨
sạp	ʂap˨ˀ˩ʔ
sấp	ʂɤ̆p˦˥
sập	ʂɤ̆p˨ˀ˩ʔ
sa	ʂa˧˥
sa,	ʂa˧˥
sá	ʂa˩˧
sà	ʂa˦˨
sã	ʂa˧˩˨
sả	ʂa˧˩˨
sát	ʂak˦˥
sắt	ʂăk˦˥
sạt	ʂak˨ˀ˩ʔ
sặt	ʂăk˨ˀ˩ʔ
sau	ʂăw˧˥
sáu	ʂăw˩˧
sâu	ʂɤ̆w˧˥
sầu	ʂɤ̆w˦˨
say	ʂăj˧˥
sảy	ʂăj˧˩˨
sây	ʂɤ̆j˧˥
sấy	ʂɤ̆j˩˧
sầy	ʂɤ̆j˦˨
sẩy	ʂɤ̆j˧˩˨
sém	ʂɛm˩˧
sênh	ʂen˧˥
sềnh	ʂen˦˨
sểnh	ʂen˧˩˨
sên	ʂen˧˥
sến	ʂen˩˧
sền	ʂen˦˨
sen	ʂɛŋ˧˥
sẻn	ʂɛŋ˧˩˨
seo	ʂeo˧˥
sẹo	ʂeo˨ˀ˩ʔ
sếp	ʂep˦˥
sê	ʂe˧˥
sề	ʂe˦˨
sệ	ʂe˨ˀ˩ʔ
se	ʂɛ˧˥
sè	ʂɛ˦˨
sẽ	ʂɛ˧˩˨
sẻ	ʂɛ˧˩˨
sét	ʂɛk˦˥
sêu	ʂɛu˧˥
sếu	ʂɛu˩˧
sỉa	ʂiə˧˩˨
siểm	ʂiəm˧˩˨
siêng	ʂiəŋ˧˥
siết	ʂiək˦˥
siêu	ʂiəw˧˥
sim	ʂim˧˥
sinh	ʂin˧˥
sính	ʂin˩˧
sình	ʂin˦˨
sin	ʂin˧˥
sín	ʂin˩˧
sìn	ʂin˦˨
si	ʂi˧˥
si,	ʂi˧˥
sì	ʂi˦˨
sĩ	ʂi˧˩˨
sỉ	ʂi˧˩˨
sít	ʂit˦˥
sịt	ʂit˨ˀ˩ʔ
soái	ʂwaj˩˧
soái,	ʂwaj˩˧
soàm	ʂwam˦˨
soán	ʂwaŋ˩˧
soàn	ʂwaŋ˦˨
soạn	ʂwaŋ˨ˀ˩ʔ
soát	ʂwak˦˥
sộc	ʂokp˨ˀ˩ʔ
sóc	ʂɔkp˦˥
sợi	ʂɤj˨ˀ˩ʔ
sôi	ʂoj˧˥
sôi,	ʂoj˧˥
sồi	ʂoj˦˨
soi	ʂɔj˧˥
sói	ʂɔj˩˧
sõi	ʂɔj˧˩˨
sỏi	ʂɔj˧˩˨
sơm	ʂɤm˧˥
sớm	ʂɤm˩˧
sờm	ʂɤm˦˨
sóm	ʂɔm˩˧
sòm	ʂɔm˦˨
sọm	ʂɔm˨ˀ˩ʔ
sông	ʂoŋm˧˥
sống	ʂoŋm˩˧
sống,	ʂoŋm˩˧
sồng	ʂoŋm˦˨
sổng	ʂoŋm˧˩˨
song	ʂɔŋm˧˥
sóng	ʂɔŋm˩˧
sòng	ʂɔŋm˦˨
sõng	ʂɔŋm˧˩˨
sơn	ʂɤŋ˧˥
sớn	ʂɤŋ˩˧
sờn	ʂɤŋ˦˨
sởn	ʂɤŋ˧˩˨
sồn	ʂoŋm˦˨
son	ʂɔŋm˧˥
son,	ʂɔŋm˧˥
sòn	ʂɔŋm˦˨
sốp	ʂop˦˥
sơ	ʂɤ˧˥
sớ	ʂɤ˩˧
sờ	ʂɤ˦˨
sở	ʂɤ˧˩˨
sở,	ʂɤ˧˩˨
sợ	ʂɤ˨ˀ˩ʔ
sô	ʂo˧˥
số	ʂo˩˧
sồ	ʂo˦˨
sỗ	ʂo˧˩˨
sổ	ʂo˧˩˨
so	ʂɔ˧˥
sò	ʂɔ˦˨
sọ	ʂɔ˨ˀ˩ʔ
sốt	ʂokp˦˥
sột	ʂokp˨ˀ˩ʔ
sót	ʂɔkp˦˥
sọt	ʂɔkp˨ˀ˩ʔ
sô-vanh	ʂo˧˥-jan˧˥
sủa	ʂuə˧˩˨
sứa	ʂɯə˩˧
sữa	ʂɯə˧˩˨
sửa	ʂɯə˧˩˨
suất	ʂwɤ̆k˦˥
suất;	ʂwɤ̆k˦˥
súc	ʂukp˦˥
sục	ʂukp˨ˀ˩ʔ
sức	ʂɯk˦˥
sực	ʂɯk˨ˀ˩ʔ
sui	ʂuj˧˥
sùi	ʂuj˦˨
sủi	ʂuj˧˩˨
sum	ʂum˧˥
sùm	ʂum˦˨
sụm	ʂum˨ˀ˩ʔ
sung	ʂuŋm˧˥
súng	ʂuŋm˩˧
sùng	ʂuŋm˦˨
sủng	ʂuŋm˧˩˨
sưng	ʂɯŋ˧˥
sừng	ʂɯŋ˦˨
sững	ʂɯŋ˧˩˨
sửng	ʂɯŋ˧˩˨
sựng	ʂɯŋ˨ˀ˩ʔ
sun-phát	ʂuŋm˧˥-fak˦˥
sun	ʂuŋm˧˥
sún	ʂuŋm˩˧
sụn	ʂuŋm˨ˀ˩ʔ
sừn	ʂɯŋ˦˨
suối	ʂuəj˩˧
sưởi	ʂɯəj˧˩˨
suông	ʂuəŋ˧˥
suồng	ʂuəŋ˦˨
sương	ʂɯəŋ˧˥
sướng	ʂɯəŋ˩˧
sường	ʂɯəŋ˦˨
sượng	ʂɯəŋ˨ˀ˩ʔ
suôn	ʂuəŋ˧˥
sườn	ʂɯəŋ˦˨
suốt	ʂuək˦˥
sướt	ʂɯək˦˥
súp	ʂup˦˥
sụp	ʂup˨ˀ˩ʔ
su	ʂu˧˥
sú	ʂu˩˧
sù	ʂu˦˨
sù;	ʂu˦˨
sủ	ʂu˧˩˨
sụ	ʂu˨ˀ˩ʔ
sư	ʂɯ˧˥
sư,	ʂɯ˧˥
sứ	ʂɯ˩˧
sử	ʂɯ˧˩˨
sự	ʂɯ˨ˀ˩ʔ
sự,	ʂɯ˨ˀ˩ʔ
sút	ʂukp˦˥
sụt	ʂukp˨ˀ˩ʔ
sứt	ʂɯk˦˥
sưu	ʂɯw˧˥
súy	ʂuj˩˧
suy	ʂwi˧˥
suý	ʂwi˩˧
suýt	ʂwit˦˥
suỵt	ʂwit˨ˀ˩ʔ
sỹ	ʂi˧˩˨
tách	tak˦˥
tác	tak˦˥
tắc	tăk˦˥
tạc	tak˨ˀ˩ʔ
tặc	tăk˨ˀ˩ʔ
tấc	tɤ̆k˦˥
tai	taj˧˥
tai,	taj˧˥
tai;	taj˧˥
tái	taj˩˧
tài	taj˦˨
tải	taj˧˩˨
tại	taj˨ˀ˩ʔ
tam	tam˧˥
tám	tam˩˧
tám,	tam˩˧
tàm	tam˦˨
tăm	tăm˧˥
tắm	tăm˩˧
tằm	tăm˦˨
tằm,	tăm˦˨
tạm	tam˨ˀ˩ʔ
tâm	tɤ̆m˧˥
tấm	tɤ̆m˩˧
tấm,	tɤ̆m˩˧
tầm	tɤ̆m˦˨
tẩm	tɤ̆m˧˩˨
tậm	tɤ̆m˨ˀ˩ʔ
tang	taŋ˧˥
táng	taŋ˩˧
tàng	taŋ˦˨
tăng	tăŋ˧˥
tằng	tăŋ˦˨
tảng	taŋ˧˩˨
tạng	taŋ˨ˀ˩ʔ
tặng	tăŋ˨ˀ˩ʔ
tâng	tɤ̆ŋ˧˥
tầng	tɤ̆ŋ˦˨
tanh	tan˧˥
tánh	tan˩˧
tành	tan˦˨
tạnh	tan˨ˀ˩ʔ
tan	taŋ˧˥
tán	taŋ˩˧
tàn	taŋ˦˨
tằn	tăŋ˦˨
tẳn	tăŋ˧˩˨
tản	taŋ˧˩˨
tân	tɤ̆ŋ˧˥
tấn	tɤ̆ŋ˩˧
tần	tɤ̆ŋ˦˨
tẩn	tɤ̆ŋ˧˩˨
tận	tɤ̆ŋ˨ˀ˩ʔ
tao	taw˧˥
táo	taw˩˧
tào	taw˦˨
tảo	taw˧˩˨
tạo	taw˨ˀ˩ʔ
táp	tap˦˥
tắp	tăp˦˥
tạp	tap˨ˀ˩ʔ
tấp	tɤ̆p˦˥
tập	tɤ̆p˨ˀ˩ʔ
ta	ta˧˥
ta,	ta˧˥
tá	ta˩˧
tà	ta˦˨
tà;	ta˦˨
tã	ta˧˩˨
tả	ta˧˩˨
tạ	ta˨ˀ˩ʔ
tát	tak˦˥
tát,	tak˦˥
tắt	tăk˦˥
tạt	tak˨ˀ˩ʔ
tất	tɤ̆k˦˥
tật	tɤ̆k˨ˀ˩ʔ
tật,	tɤ̆k˨ˀ˩ʔ
tàu	tăw˦˨
tàu,	tăw˦˨
tâu	tɤ̆w˧˥
tấu	tɤ̆w˩˧
tầu	tɤ̆w˦˨
tẩu	tɤ̆w˧˩˨
tậu	tɤ̆w˨ˀ˩ʔ
tay	tăj˧˥
tay,	tăj˧˥
táy	tăj˩˧
tày	tăj˦˨
tây	tɤ̆j˧˥
tầy	tɤ̆j˦˨
tẩy	tɤ̆j˧˩˨
tếch	tet˦˥
têm	tem˧˥
tem	tɛm˧˥
tèm	tɛm˦˨
teng	tɛŋ˧˥
tèng	tɛŋ˦˨
tênh	ten˧˥
tềnh	ten˦˨
tên	ten˧˥
ten	tɛŋ˧˥
tén	tɛŋ˩˧
tèn	tɛŋ˦˨
tẽn	tɛŋ˧˩˨
teo	teo˧˥
tèo	teo˦˨
tẻo	teo˧˩˨
tép	tɛp˦˥
tẹp	tɛp˨ˀ˩ʔ
tê	te˧˥
tế	te˩˧
tề	te˦˨
tễ	te˧˩˨
tể	te˧˩˨
tệ	te˨ˀ˩ʔ
te	tɛ˧˥
té	tɛ˩˧
tè	tɛ˦˨
tẻ	tɛ˧˩˨
tết	tet˦˥
tết,	tet˦˥
tẹt	tɛk˨ˀ˩ʔ
tếu	tɛu˩˧
thách	tʰak˦˥
thạch	tʰak˨ˀ˩ʔ
thác	tʰak˦˥
thắc	tʰăk˦˥
thạc	tʰak˨ˀ˩ʔ
thai	tʰaj˧˥
thái	tʰaj˩˧
thài	tʰaj˦˨
thải	tʰaj˧˩˨
tham	tʰam˧˥
thám	tʰam˩˧
thàm	tʰam˦˨
thăm	tʰăm˧˥
thắm	tʰăm˩˧
thắm,	tʰăm˩˧
thẳm	tʰăm˧˩˨
thảm	tʰam˧˩˨
thâm	tʰɤ̆m˧˥
thấm	tʰɤ̆m˩˧
thầm	tʰɤ̆m˦˨
thẩm	tʰɤ̆m˧˩˨
thậm	tʰɤ̆m˨ˀ˩ʔ
thang	tʰaŋ˧˥
tháng	tʰaŋ˩˧
thăng	tʰăŋ˧˥
thắng	tʰăŋ˩˧
thắng,	tʰăŋ˩˧
thằng	tʰăŋ˦˨
thẳng	tʰăŋ˧˩˨
thảng	tʰaŋ˧˩˨
thặng	tʰăŋ˨ˀ˩ʔ
thanh	tʰan˧˥
thánh	tʰan˩˧
thành	tʰan˦˨
thành,	tʰan˦˨
thảnh	tʰan˧˩˨
thạnh	tʰan˨ˀ˩ʔ
than	tʰaŋ˧˥
thán	tʰaŋ˩˧
thăn	tʰăŋ˧˥
thằn	tʰăŋ˦˨
thản	tʰaŋ˧˩˨
thân	tʰɤ̆ŋ˧˥
thân,	tʰɤ̆ŋ˧˥
thần	tʰɤ̆ŋ˦˨
thẫn	tʰɤ̆ŋ˧˩˨
thẩn	tʰɤ̆ŋ˧˩˨
thận	tʰɤ̆ŋ˨ˀ˩ʔ
thao	tʰaw˧˥
tháo	tʰaw˩˧
thào	tʰaw˦˨
thảo	tʰaw˧˩˨
thạo	tʰaw˨ˀ˩ʔ
tháp	tʰap˦˥
thắp	tʰăp˦˥
thấp	tʰɤ̆p˦˥
thập	tʰɤ̆p˨ˀ˩ʔ
tha	tʰa˧˥
tha,	tʰa˧˥
thà	tʰa˦˨
thả	tʰa˧˩˨
thát	tʰak˦˥
thắt	tʰăk˦˥
thất	tʰɤ̆k˦˥
thật	tʰɤ̆k˨ˀ˩ʔ
thau	tʰăw˧˥
tháu	tʰăw˩˧
thâu	tʰɤ̆w˧˥
thấu	tʰɤ̆w˩˧
thầu	tʰɤ̆w˦˨
thẩu	tʰɤ̆w˧˩˨
thay	tʰăj˧˥
tháy	tʰăj˩˧
thày	tʰăj˦˨
thảy	tʰăj˧˩˨
thây	tʰɤ̆j˧˥
thấy	tʰɤ̆j˩˧
thầy	tʰɤ̆j˦˨
thêm	tʰem˧˥
thêm,	tʰem˧˥
thềm	tʰem˦˨
thèm	tʰɛm˦˨
thênh	tʰen˧˥
then	tʰɛŋ˧˥
thèn	tʰɛŋ˦˨
thẹn	tʰɛŋ˨ˀ˩ʔ
theo	tʰeo˧˥
thèo	tʰeo˦˨
thếp	tʰep˦˥
thép	tʰɛp˦˥
thẹp	tʰɛp˨ˀ˩ʔ
thê	tʰe˧˥
thế	tʰe˩˧
thề	tʰe˦˨
thể	tʰe˧˩˨
thệ	tʰe˨ˀ˩ʔ
the	tʰɛ˧˥
thè	tʰɛ˦˨
thẽ	tʰɛ˧˩˨
thẻ	tʰɛ˧˩˨
thết	tʰet˦˥
thét	tʰɛk˦˥
thêu	tʰɛu˧˥
thều	tʰɛu˦˨
thia	tʰiə˧˥
thìa	tʰiə˦˨
thích	tʰit˦˥
thịch	tʰit˨ˀ˩ʔ
thiếc	tʰiək˦˥
thiêm	tʰiəm˧˥
thiềm	tʰiəm˦˨
thiểm	tʰiəm˧˩˨
thiêng	tʰiəŋ˧˥
thiên	tʰiəŋ˧˥
thiền	tʰiəŋ˦˨
thiển	tʰiəŋ˧˩˨
thiện	tʰiəŋ˨ˀ˩ʔ
thiếp	tʰiəp˦˥
thiệp	tʰiəp˨ˀ˩ʔ
thiết	tʰiək˦˥
thiệt	tʰiək˨ˀ˩ʔ
thiêu	tʰiəw˧˥
thiếu	tʰiəw˩˧
thiếu,	tʰiəw˩˧
thiều	tʰiəw˦˨
thiểu	tʰiəw˧˩˨
thiệu	tʰiəw˨ˀ˩ʔ
thinh	tʰin˧˥
thính	tʰin˩˧
thình	tʰin˦˨
thỉnh	tʰin˧˩˨
thịnh	tʰin˨ˀ˩ʔ
thin	tʰin˧˥
thi	tʰi˧˥
thí	tʰi˩˧
thì	tʰi˦˨
thì,	tʰi˦˨
thỉ	tʰi˧˩˨
thị	tʰi˨ˀ˩ʔ
thít	tʰit˦˥
thịt	tʰit˨ˀ˩ʔ
thịt,	tʰit˨ˀ˩ʔ
thiu	tʰiw˧˥
thoai	tʰwaj˧˥
thoái	tʰwaj˩˧
thoải	tʰwaj˧˩˨
thoại	tʰwaj˨ˀ˩ʔ
thoang	tʰwaŋ˧˥
thoáng	tʰwaŋ˩˧
thoảng	tʰwaŋ˧˩˨
thoán	tʰwaŋ˩˧
thoăn	tʰwăŋ˧˥
thoa	tʰwa˧˥
thoá	tʰwa˩˧
thoả	tʰwa˧˩˨
thóa	tʰwa˩˧
thỏa	tʰwa˧˩˨
thoát	tʰwak˦˥
thoắt	tʰwăk˦˥
thoạt	tʰwak˨ˀ˩ʔ
thốc	tʰokp˦˥
thóc	tʰɔkp˦˥
thóc,	tʰɔkp˦˥
thọc	tʰɔkp˨ˀ˩ʔ
thới	tʰɤj˩˧
thời	tʰɤj˦˨
thời,	tʰɤj˦˨
thôi	tʰoj˧˥
thối	tʰoj˩˧
thổi	tʰoj˧˩˨
thoi	tʰɔj˧˥
thói	tʰɔj˩˧
thói,	tʰɔj˩˧
thòi	tʰɔj˦˨
thơm	tʰɤm˧˥
thồm	tʰom˦˨
thom	tʰɔm˧˥
thòm	tʰɔm˦˨
thông	tʰoŋm˧˥
thống	tʰoŋm˩˧
thong	tʰɔŋm˧˥
thòng	tʰɔŋm˦˨
thõng	tʰɔŋm˧˩˨
thơn	tʰɤŋ˧˥
thờn	tʰɤŋ˦˨
thôn	tʰoŋm˧˥
thốn	tʰoŋm˩˧
thồn	tʰoŋm˦˨
thỗn	tʰoŋm˧˩˨
thổn	tʰoŋm˧˩˨
thon	tʰɔŋm˧˥
thoòng	tʰɔŋm˦˨
thộp	tʰop˨ˀ˩ʔ
thơ	tʰɤ˧˥
thớ	tʰɤ˩˧
thờ	tʰɤ˦˨
thở	tʰɤ˧˩˨
thợ	tʰɤ˨ˀ˩ʔ
thô	tʰo˧˥
thố	tʰo˩˧
thồ	tʰo˦˨
thổ	tʰo˧˩˨
thò	tʰɔ˦˨
thỏ	tʰɔ˧˩˨
thọ	tʰɔ˨ˀ˩ʔ
thớt	tʰɤk˦˥
thốt	tʰokp˦˥
thuần	tʰwɤ̆ŋ˦˨
thuận	tʰwɤ̆ŋ˨ˀ˩ʔ
thua	tʰuə˧˥
thùa	tʰuə˦˨
thủa;	tʰuə˧˩˨
thưa	tʰɯə˧˥
thừa	tʰɯə˦˨
thuật	tʰwɤ̆k˨ˀ˩ʔ
thúc	tʰukp˦˥
thục	tʰukp˨ˀ˩ʔ
thức	tʰɯk˦˥
thực	tʰɯk˨ˀ˩ʔ
thuê	tʰwe˧˥
thuế	tʰwe˩˧
thuể	tʰwe˧˩˨
thui	tʰuj˧˥
thùi	tʰuj˦˨
thủi	tʰuj˧˩˨
thum	tʰum˧˥
thùm	tʰum˦˨
thung	tʰuŋm˧˥
thúng	tʰuŋm˩˧
thúng,	tʰuŋm˩˧
thùng	tʰuŋm˦˨
thũng	tʰuŋm˧˩˨
thủng	tʰuŋm˧˩˨
thụng	tʰuŋm˨ˀ˩ʔ
thưng	tʰɯŋ˧˥
thừng	tʰɯŋ˦˨
thun	tʰuŋm˧˥
thùn	tʰuŋm˦˨
thuốc	tʰuək˦˥
thuộc	tʰuək˨ˀ˩ʔ
thước	tʰɯək˦˥
thược	tʰɯək˨ˀ˩ʔ
thuồi	tʰuəj˦˨
thười	tʰɯəj˦˨
thuông	tʰuəŋ˧˥
thuồng	tʰuəŋ˦˨
thương	tʰɯəŋ˧˥
thường	tʰɯəŋ˦˨
thưởng	tʰɯəŋ˧˩˨
thượng	tʰɯəŋ˨ˀ˩ʔ
thuôn	tʰuəŋ˧˥
thuồn	tʰuəŋ˦˨
thườn	tʰɯəŋ˦˨
thưỡn	tʰɯəŋ˧˩˨
thuở	tʰuə˧˩˨
thuở,	tʰuə˧˩˨
thướt	tʰɯək˦˥
thụp	tʰup˨ˀ˩ʔ
thu	tʰu˧˥
thú	tʰu˩˧
thù	tʰu˦˨
thủ	tʰu˧˩˨
thủ,	tʰu˧˩˨
thụ	tʰu˨ˀ˩ʔ
thư	tʰɯ˧˥
thứ	tʰɯ˩˧
thử	tʰɯ˧˩˨
thự	tʰɯ˨ˀ˩ʔ
thút	tʰukp˦˥
thụt	tʰukp˨ˀ˩ʔ
thuyên	tʰwiəŋ˧˥
thuyền	tʰwiəŋ˦˨
thuyết	tʰwiək˦˥
thùy	tʰuj˦˨
thủy	tʰuj˧˩˨
thụy	tʰuj˨ˀ˩ʔ
thuý	tʰwi˩˧
thuỳ	tʰwi˦˨
thuỷ	tʰwi˧˩˨
thuỵ	tʰwi˨ˀ˩ʔ
tia	tiə˧˥
tía	tiə˩˧
tỉa	tiə˧˩˨
tích	tit˦˥
tịch	tit˨ˀ˩ʔ
tiếc	tiək˦˥
tiếc,	tiək˦˥
tiệc	tiək˨ˀ˩ʔ
tiêm	tiəm˧˥
tiếm	tiəm˩˧
tiềm	tiəm˦˨
tiệm	tiəm˨ˀ˩ʔ
tiêng	tiəŋ˧˥
tiếng	tiəŋ˩˧
tiếng,	tiəŋ˩˧
tiên	tiəŋ˧˥
tiến	tiəŋ˩˧
tiền	tiəŋ˦˨
tiền,	tiəŋ˦˨
tiễn	tiəŋ˧˩˨
tiện	tiəŋ˨ˀ˩ʔ
tiếp	tiəp˦˥
tiệp	tiəp˨ˀ˩ʔ
tiết	tiək˦˥
tiệt	tiək˨ˀ˩ʔ
tiêu	tiəw˧˥
tiếu	tiəw˩˧
tiều	tiəw˦˨
tiễu	tiəw˧˩˨
tiểu	tiəw˧˩˨
tim	tim˧˥
tím	tim˩˧
tìm	tim˦˨
tỉm	tim˧˩˨
tinh	tin˧˥
tinh,	tin˧˥
tính	tin˩˧
tính,	tin˩˧
tính;	tin˩˧
tình	tin˦˨
tĩnh	tin˧˩˨
tỉnh	tin˧˩˨
tịnh	tin˨ˀ˩ʔ
tin	tin˧˥
tín	tin˩˧
típ	tip˦˥
ti	ti˧˥
tí	ti˩˧
tì	ti˦˨
tỉ	ti˧˩˨
tị	ti˨ˀ˩ʔ
tít	tit˦˥
tịt	tit˨ˀ˩ʔ
tiu	tiw˧˥
tíu	tiw˩˧
tỉu	tiw˧˩˨
toác	twak˦˥
toạc	twak˨ˀ˩ʔ
toại	twaj˨ˀ˩ʔ
toang	twaŋ˧˥
toan	twaŋ˧˥
toán	twaŋ˩˧
toàn	twaŋ˦˨
toát	twak˦˥
toa	twa˧˥
toá	twa˩˧
toà	twa˦˨
toả	twa˧˩˨
tòa	twa˦˨
tỏa	twa˧˩˨
toạ	twa˨ˀ˩ʔ
tọa	twa˨ˀ˩ʔ
tộc-ngôn	tokp˨ˀ˩ʔ-ŋoŋm˧˥
tốc	tokp˦˥
tộc	tokp˨ˀ˩ʔ
tộc;	tokp˨ˀ˩ʔ
tóc	tɔkp˦˥
tóc,	tɔkp˦˥
tọc	tɔkp˨ˀ˩ʔ
toen	twen˧˥
toèn	twen˦˨
toét	twet˦˥
toe	twe˧˥
toé	twe˩˧
tóe	twe˩˧
tơi	tɤj˧˥
tới	tɤj˩˧
tới,	tɤj˩˧
tôi	toj˧˥
tối	toj˩˧
tồi	toj˦˨
tội	toj˨ˀ˩ʔ
toi	tɔj˧˥
tỏi	tɔj˧˩˨
tởm	tɤm˧˩˨
tôm	tom˧˥
tôm;	tom˧˥
tồm	tom˦˨
tom	tɔm˧˥
tóm	tɔm˩˧
tòm	tɔm˦˨
tỏm	tɔm˧˩˨
tông	toŋm˧˥
tống	toŋm˩˧
tồng	toŋm˦˨
tổng	toŋm˧˩˨
tong	tɔŋm˧˥
tòng	tɔŋm˦˨
tỏng	tɔŋm˧˩˨
tớn	tɤŋ˩˧
tợn	tɤŋ˨ˀ˩ʔ
tôn	toŋm˧˥
tốn	toŋm˩˧
tốn,	toŋm˩˧
tồn	toŋm˦˨
tổn	toŋm˧˩˨
ton	tɔŋm˧˥
tòn	tɔŋm˦˨
toong	tɔŋm˧˥
toòng	tɔŋm˦˨
tô-pô	to˧˥-po˧˥
tốp	top˦˥
top	tɔp˧˥
tóp	tɔp˦˥
tô-tem	to˧˥-tɛm˧˥
tơ	tɤ˧˥
tớ	tɤ˩˧
tờ	tɤ˦˨
tở	tɤ˧˩˨
tô	to˧˥
tố	to˩˧
tồ	to˦˨
tổ	to˧˩˨
to	tɔ˧˥
tò	tɔ˦˨
tỏ	tɔ˧˩˨
tỏ,	tɔ˧˩˨
tốt	tokp˦˥
tốt,	tokp˦˥
tột	tokp˨ˀ˩ʔ
tót	tɔkp˦˥
tọt	tɔkp˨ˀ˩ʔ
trách	ʈak˦˥
trạch	ʈak˨ˀ˩ʔ
trác	ʈak˦˥
trắc	ʈăk˦˥
trai	ʈaj˧˥
trái	ʈaj˩˧
trài	ʈaj˦˨
trải	ʈaj˧˩˨
trại	ʈaj˨ˀ˩ʔ
trám	ʈam˩˧
tràm	ʈam˦˨
trăm	ʈăm˧˥
trắm	ʈăm˩˧
trằm	ʈăm˦˨
trảm	ʈam˧˩˨
trạm	ʈam˨ˀ˩ʔ
trâm	ʈɤ̆m˧˥
trầm	ʈɤ̆m˦˨
trẫm	ʈɤ̆m˧˩˨
trậm	ʈɤ̆m˨ˀ˩ʔ
trang	ʈaŋ˧˥
tráng	ʈaŋ˩˧
tráng,	ʈaŋ˩˧
tràng	ʈaŋ˦˨
trăng	ʈăŋ˧˥
trắng	ʈăŋ˩˧
trằng	ʈăŋ˦˨
trảng	ʈaŋ˧˩˨
trạng	ʈaŋ˨ˀ˩ʔ
trâng	ʈɤ̆ŋ˧˥
tranh	ʈan˧˥
tránh	ʈan˩˧
trán	ʈaŋ˩˧
tràn	ʈaŋ˦˨
trăn	ʈăŋ˧˥
trằn	ʈăŋ˦˨
trân	ʈɤ̆ŋ˧˥
trấn	ʈɤ̆ŋ˩˧
trần	ʈɤ̆ŋ˦˨
trận	ʈɤ̆ŋ˨ˀ˩ʔ
trao	ʈaw˧˥
tráo	ʈaw˩˧
trào	ʈaw˦˨
trào,	ʈaw˦˨
trảo	ʈaw˧˩˨
trập	ʈɤ̆p˨ˀ˩ʔ
trát	ʈak˦˥
trất	ʈɤ̆k˦˥
trật	ʈɤ̆k˨ˀ˩ʔ
tra	ʈa˧˥
trá	ʈa˩˧
trà	ʈa˦˨
trả	ʈa˧˩˨
trả,	ʈa˧˩˨
trau	ʈăw˧˥
trâu	ʈɤ̆w˧˥
trấu	ʈɤ̆w˩˧
trầu	ʈɤ̆w˦˨
trẩu	ʈɤ̆w˧˩˨
trày	ʈăj˦˨
trây	ʈɤ̆j˧˥
trầy	ʈɤ̆j˦˨
trẩy	ʈɤ̆j˧˩˨
tréc	ʈɛk˦˥
trém	ʈɛm˩˧
trên	ʈen˧˥
trèn	ʈɛŋ˦˨
trẽn	ʈɛŋ˧˩˨
treo	ʈeo˧˥
treo,	ʈeo˧˥
tréo	ʈeo˩˧
trèo	ʈeo˦˨
trẽo	ʈeo˧˩˨
trẹo	ʈeo˨ˀ˩ʔ
trết	ʈet˦˥
trệt	ʈet˨ˀ˩ʔ
trét	ʈɛk˦˥
trẹt	ʈɛk˨ˀ˩ʔ
trê	ʈe˧˥
trề	ʈe˦˨
trễ	ʈe˧˩˨
trệ	ʈe˨ˀ˩ʔ
tre	ʈɛ˧˥
tre,	ʈɛ˧˥
trẻ	ʈɛ˧˩˨
trêu	ʈɛu˧˥
trếu	ʈɛu˩˧
trệu	ʈɛu˨ˀ˩ʔ
trích	ʈit˦˥
trịch	ʈit˨ˀ˩ʔ
triền	ʈiəŋ˦˨
triển	ʈiəŋ˧˩˨
triết	ʈiək˦˥
triệt	ʈiək˨ˀ˩ʔ
triêu	ʈiəw˧˥
triều	ʈiəw˦˨
triệu	ʈiəw˨ˀ˩ʔ
trinh	ʈin˧˥
trình	ʈin˦˨
trịnh	ʈin˨ˀ˩ʔ
tri	ʈi˧˥
trí	ʈi˩˧
trí,	ʈi˩˧
trì	ʈi˦˨
trĩ	ʈi˧˩˨
trị	ʈi˨ˀ˩ʔ
trìu	ʈiw˦˨
trĩu	ʈiw˧˩˨
trốc	ʈokp˦˥
trộc	ʈokp˨ˀ˩ʔ
tróc	ʈɔkp˦˥
trọc	ʈɔkp˨ˀ˩ʔ
trời	ʈɤj˦˨
trời,	ʈɤj˦˨
trôi	ʈoj˧˥
trối	ʈoj˩˧
trỗi	ʈoj˧˩˨
trổi	ʈoj˧˩˨
trội	ʈoj˨ˀ˩ʔ
trói	ʈɔj˩˧
tròi	ʈɔj˦˨
trọi	ʈɔj˨ˀ˩ʔ
trộm	ʈom˨ˀ˩ʔ
trộm,	ʈom˨ˀ˩ʔ
tróm	ʈɔm˩˧
tròm	ʈɔm˦˨
trông	ʈoŋm˧˥
trông,	ʈoŋm˧˥
trống	ʈoŋm˩˧
trống,	ʈoŋm˩˧
trồng	ʈoŋm˦˨
trong	ʈɔŋm˧˥
tróng	ʈɔŋm˩˧
tròng	ʈɔŋm˦˨
trọng	ʈɔŋm˨ˀ˩ʔ
trọng,	ʈɔŋm˨ˀ˩ʔ
trơn	ʈɤŋ˧˥
trớn	ʈɤŋ˩˧
trờn	ʈɤŋ˦˨
trợn	ʈɤŋ˨ˀ˩ʔ
trôn	ʈoŋm˧˥
trốn	ʈoŋm˩˧
trộn	ʈoŋm˨ˀ˩ʔ
tròn	ʈɔŋm˦˨
tròn,	ʈɔŋm˦˨
trọn	ʈɔŋm˨ˀ˩ʔ
trớt	ʈɤk˦˥
trợt	ʈɤk˨ˀ˩ʔ
trót	ʈɔkp˦˥
trơ	ʈɤ˧˥
trớ	ʈɤ˩˧
trờ	ʈɤ˦˨
trở	ʈɤ˧˩˨
trợ	ʈɤ˨ˀ˩ʔ
trô	ʈo˧˥
trỗ	ʈo˧˩˨
trổ	ʈo˧˩˨
tro	ʈɔ˧˥
trò	ʈɔ˦˨
trỏ	ʈɔ˧˩˨
trọ	ʈɔ˨ˀ˩ʔ
truân	ʈwɤ̆ŋ˧˥
truất	ʈwɤ̆k˦˥
trưa	ʈɯə˧˥
trưa,	ʈɯə˧˥
trúc	ʈukp˦˥
trục	ʈukp˨ˀ˩ʔ
trực	ʈɯk˨ˀ˩ʔ
trui	ʈuj˧˥
trùi	ʈuj˦˨
trụi	ʈuj˨ˀ˩ʔ
trùm	ʈum˦˨
trung	ʈuŋm˧˥
trúng	ʈuŋm˩˧
trùng	ʈuŋm˦˨
trủng	ʈuŋm˧˩˨
trưng	ʈɯŋ˧˥
trứng	ʈɯŋ˩˧
trứng,	ʈɯŋ˩˧
trừng	ʈɯŋ˦˨
trước	ʈɯək˦˥
trước,	ʈɯək˦˥
truông	ʈuəŋ˧˥
truồng	ʈuəŋ˦˨
trương	ʈɯəŋ˧˥
trướng	ʈɯəŋ˩˧
trường	ʈɯəŋ˦˨
trường,	ʈɯəŋ˦˨
trưởng	ʈɯəŋ˧˩˨
trượng	ʈɯəŋ˨ˀ˩ʔ
trượt	ʈɯək˨ˀ˩ʔ
trút	ʈukp˦˥
tru	ʈu˧˥
trú	ʈu˩˧
trù	ʈu˦˨
trụ	ʈu˨ˀ˩ʔ
trứ	ʈɯ˩˧
trừ	ʈɯ˦˨
trữ	ʈɯ˧˩˨
trừu	ʈɯw˦˨
truyền	ʈwiəŋ˦˨
truyện	ʈwiəŋ˨ˀ˩ʔ
trụy	ʈuj˨ˀ˩ʔ
truy	ʈwi˧˥
truỵ	ʈwi˨ˀ˩ʔ
tuân	twɤ̆ŋ˧˥
tuấn	twɤ̆ŋ˩˧
tuần	twɤ̆ŋ˦˨
tuẫn	twɤ̆ŋ˧˩˨
tua	tuə˧˥
tủa	tuə˧˩˨
từa	tɯə˦˨
tựa	tɯə˨ˀ˩ʔ
túc	tukp˦˥
tục	tukp˨ˀ˩ʔ
tức	tɯk˦˥
tuếch	twet˦˥
tuệch	twet˨ˀ˩ʔ
tuềnh	twen˦˨
tuế	twe˩˧
tuệ	twe˨ˀ˩ʔ
túi	tuj˩˧
tủi	tuj˧˩˨
tụi	tuj˨ˀ˩ʔ
tum	tum˧˥
túm	tum˩˧
tùm	tum˦˨
tủm	tum˧˩˨
tụm	tum˨ˀ˩ʔ
tung	tuŋm˧˥
túng	tuŋm˩˧
tùng	tuŋm˦˨
tủng	tuŋm˧˩˨
tụng	tuŋm˨ˀ˩ʔ
tưng	tɯŋ˧˥
từng	tɯŋ˦˨
tun	tuŋm˧˥
tủn	tuŋm˧˩˨
tước	tɯək˦˥
tuổi	tuəj˧˩˨
tươi	tɯəj˧˥
tưới	tɯəj˩˧
tươm	tɯəm˧˥
tườm	tɯəm˦˨
tuồng	tuəŋ˦˨
tương	tɯəŋ˧˥
tướng	tɯəŋ˩˧
tường	tɯəŋ˦˨
tưởng	tɯəŋ˧˩˨
tượng	tɯəŋ˨ˀ˩ʔ
tuôn	tuəŋ˧˥
tuồn	tuəŋ˦˨
tuốt	tuək˦˥
tuột	tuək˨ˀ˩ʔ
tướt	tɯək˦˥
tườu	tɯəw˦˨
túp	tup˦˥
tụt	tukp˨ˀ˩ʔ
tu	tu˧˥
tú	tu˩˧
tù	tu˦˨
tủ	tu˧˩˨
tụ	tu˨ˀ˩ʔ
tư	tɯ˧˥
tứ	tɯ˩˧
từ	tɯ˦˨
tử	tɯ˧˩˨
tự	tɯ˨ˀ˩ʔ
tửu	tɯw˧˩˨
tựu	tɯw˨ˀ˩ʔ
tuyên	twiəŋ˧˥
tuyến	twiəŋ˩˧
tuyền	twiəŋ˦˨
tuyển	twiəŋ˧˩˨
tuyết	twiək˦˥
tuyệt	twiək˨ˀ˩ʔ
tuýt	twit˦˥
túy	tuj˩˧
tùy	tuj˦˨
tủy	tuj˧˩˨
tụy	tuj˨ˀ˩ʔ
tuy	twi˧˥
tuý	twi˩˧
tuỳ	twi˦˨
tuỷ	twi˧˩˨
ty	ti˧˥
tỳ	ti˦˨
tỷ	ti˧˩˨
tỵ	ti˨ˀ˩ʔ
uẩn	wɤ̆ŋ˧˩˨
uất	wɤ̆k˦˥
úa	uə˩˧
ùa	uə˦˨
ụa	uə˨ˀ˩ʔ
ưa	ɯə˧˥
ưa,	ɯə˧˥
ứa	ɯə˩˧
úc	ukp˦˥
ục	ukp˨ˀ˩ʔ
ức	ɯk˦˥
uế	we˩˧
uể	we˧˩˨
ui	uj˧˥
úi	uj˩˧
ủi	uj˧˩˨
um	um˧˥
úm	um˩˧
ùm	um˦˨
ung	uŋm˧˥
úng	uŋm˩˧
ùng	uŋm˦˨
ủng	uŋm˧˩˨
ưng	ɯŋ˧˥
ứng	ɯŋ˩˧
ừng	ɯŋ˦˨
ửng	ɯŋ˧˩˨
un	uŋm˧˥
ùn	uŋm˦˨
ủn	uŋm˧˩˨
ước	ɯək˦˥
ươi	ɯəj˧˥
uôm	uəm˧˥
ươm	ɯəm˧˥
ướm	ɯəm˩˧
uông	uəŋ˧˥
uống	uəŋ˩˧
uổng	uəŋ˧˩˨
ương	ɯəŋ˧˥
uốn	uəŋ˩˧
ươn	ɯəŋ˧˥
ưỡn	ɯəŋ˧˩˨
ướp	ɯəp˦˥
ướt	ɯək˦˥
úp	up˦˥
út	ukp˦˥
ụt	ukp˨ˀ˩ʔ
u	u˧˥
ú	u˩˧
ù	u˦˨
ủ	u˧˩˨
ưu	ɯw˧˥
ụ	u˨ˀ˩ʔ
ư	ɯ˧˥
ư,	ɯ˧˥
ứ	ɯ˩˧
ừ	ɯ˦˨
ừ,	ɯ˦˨
uyên	wiəŋ˧˥
uyển	wiəŋ˧˩˨
uỳnh	win˦˨
ủy	uj˧˩˨
uy	wi˧˥
uý	wi˩˧
uỷ	wi˧˩˨
vách	jak˦˥
vạch	jak˨ˀ˩ʔ
vác	jak˦˥
vạc	jak˨ˀ˩ʔ
vặc	jăk˨ˀ˩ʔ
vai	jaj˧˥
vái	jaj˩˧
vài	jaj˦˨
vãi	jaj˧˩˨
vải	jaj˧˩˨
va	ja˧˥
vá	ja˩˧
và	ja˦˨
vã	ja˧˩˨
vả	ja˧˩˨
vạ	ja˨ˀ˩ʔ
vạ,	ja˨ˀ˩ʔ
vàm	jam˦˨
vằm	jăm˦˨
vạm	jam˨ˀ˩ʔ
vậm	jɤ̆m˨ˀ˩ʔ
vang	jaŋ˧˥
vang,	jaŋ˧˥
váng	jaŋ˩˧
vàng	jaŋ˦˨
văng	jăŋ˧˥
vắng	jăŋ˩˧
vằng	jăŋ˦˨
vãng	jaŋ˧˩˨
vâng	jɤ̆ŋ˧˥
vầng	jɤ̆ŋ˦˨
vanh	jan˧˥
vành	jan˦˨
van	jaŋ˧˥
ván	jaŋ˩˧
vàn	jaŋ˦˨
văn	jăŋ˧˥
vắn	jăŋ˩˧
vằn	jăŋ˦˨
vãn	jaŋ˧˩˨
vạn	jaŋ˨ˀ˩ʔ
vặn	jăŋ˨ˀ˩ʔ
vân	jɤ̆ŋ˧˥
vấn	jɤ̆ŋ˩˧
vần	jɤ̆ŋ˦˨
vẫn	jɤ̆ŋ˧˩˨
vẩn	jɤ̆ŋ˧˩˨
vận	jɤ̆ŋ˨ˀ˩ʔ
vào	jaw˦˨
vấp	jɤ̆p˦˥
vập	jɤ̆p˨ˀ˩ʔ
vắt	jăk˦˥
vạt	jak˨ˀ˩ʔ
vặt	jăk˨ˀ˩ʔ
vất	jɤ̆k˦˥
vật	jɤ̆k˨ˀ˩ʔ
vay	jăj˧˥
váy	jăj˩˧
vày	jăj˦˨
vảy	jăj˧˩˨
vạy	jăj˨ˀ˩ʔ
vây	jɤ̆j˧˥
vấy	jɤ̆j˩˧
vầy	jɤ̆j˦˨
vẫy	jɤ̆j˧˩˨
vậy	jɤ̆j˨ˀ˩ʔ
véc	jɛk˦˥
vẹc	jɛk˨ˀ˩ʔ
vê	je˧˥
về	je˦˨
vệ	je˨ˀ˩ʔ
ve	jɛ˧˥
vé	jɛ˩˧
vè	jɛ˦˨
vẽ	jɛ˧˩˨
vẻ	jɛ˧˩˨
vênh	jen˧˥
vểnh	jen˧˩˨
vên	jen˧˥
vền	jen˦˨
ven	jɛŋ˧˥
vén	jɛŋ˩˧
vẻn	jɛŋ˧˩˨
vẹn	jɛŋ˨ˀ˩ʔ
veo	jeo˧˥
véo	jeo˩˧
vèo	jeo˦˨
vẹo	jeo˨ˀ˩ʔ
vết	jet˦˥
vét	jɛk˦˥
vẹt	jɛk˨ˀ˩ʔ
vêu	jɛu˧˥
vía	jiə˩˧
vỉa	jiə˧˩˨
vi-đê-ô	ji˧˥-de˧˥-o˧˥
việc	jiək˨ˀ˩ʔ
viêm	jiəm˧˥
viêng	jiəŋ˧˥
viếng	jiəŋ˩˧
viên	jiəŋ˧˥
viên;	jiəŋ˧˥
viễn	jiəŋ˧˩˨
viển	jiəŋ˧˩˨
viện	jiəŋ˨ˀ˩ʔ
viết	jiək˦˥
việt	jiək˨ˀ˩ʔ
việt-nam	jiək˨ˀ˩ʔ-nam˧˥
vi	ji˧˥
ví	ji˩˧
vì	ji˦˨
vĩ	ji˧˩˨
vỉ	ji˧˩˨
vị	ji˨ˀ˩ʔ
vinh	jin˧˥
vĩnh	jin˧˩˨
vin,	jin˧˥
vi-rút	ji˧˥-ʐukp˦˥
vịt	jit˨ˀ˩ʔ
vóc	jɔkp˦˥
vọc	jɔkp˨ˀ˩ʔ
vơi	jɤj˧˥
với	jɤj˩˧
vời	jɤj˦˨
vôi	joj˧˥
vôi,	joj˧˥
vồi	joj˦˨
vội	joj˨ˀ˩ʔ
voi	jɔj˧˥
vòi	jɔj˦˨
vơ	jɤ˧˥
vớ	jɤ˩˧
vờ	jɤ˦˨
vỡ	jɤ˧˩˨
vở	jɤ˧˩˨
vợ	jɤ˨ˀ˩ʔ
vô	jo˧˥
vồ	jo˦˨
vỗ	jo˧˩˨
vo	jɔ˧˥
vó	jɔ˩˧
vó,	jɔ˩˧
vò	jɔ˦˨
võ	jɔ˧˩˨
vỏ	jɔ˧˩˨
vọ	jɔ˨ˀ˩ʔ
vòm	jɔm˦˨
vông	joŋm˧˥
vông,	joŋm˧˥
vong	jɔŋm˧˥
vòng	jɔŋm˦˨
võng	jɔŋm˧˩˨
vọng	jɔŋm˨ˀ˩ʔ
vọng,	jɔŋm˨ˀ˩ʔ
vôn	joŋm˧˥
vốn	joŋm˩˧
vồn	joŋm˦˨
von	jɔŋm˧˥
vòn	jɔŋm˦˨
vỏn	jɔŋm˧˩˨
voọc	jɔkp˨ˀ˩ʔ
vọp	jɔp˨ˀ˩ʔ
vớt	jɤk˦˥
vót	jɔkp˦˥
vọt,	jɔkp˨ˀ˩ʔ
vua	juə˧˥
vùa	juə˦˨
vừa	jɯə˦˨
vữa	jɯə˧˩˨
vựa	jɯə˨ˀ˩ʔ
vúc	jukp˦˥
vực	jɯk˨ˀ˩ʔ
vui	juj˧˥
vùi	juj˦˨
vu	ju˧˥
vú	ju˩˧
vù	ju˦˨
vũ	ju˧˩˨
vụ	ju˨ˀ˩ʔ
vung	juŋm˧˥
vùng	juŋm˦˨
vũng	juŋm˧˩˨
vụng	juŋm˨ˀ˩ʔ
vụng,	juŋm˨ˀ˩ʔ
vừng	jɯŋ˦˨
vững	jɯŋ˧˩˨
vựng	jɯŋ˨ˀ˩ʔ
vun	juŋm˧˥
vùn	juŋm˦˨
vụn	juŋm˨ˀ˩ʔ
vuông	juəŋ˧˥
vương	jɯəŋ˧˥
vướng	jɯəŋ˩˧
vượng	jɯəŋ˨ˀ˩ʔ
vươn	jɯəŋ˧˥
vườn	jɯəŋ˦˨
vượn	jɯəŋ˨ˀ˩ʔ
vuốt	juək˦˥
vuột	juək˨ˀ˩ʔ
vượt	jɯək˨ˀ˩ʔ
vút	jukp˦˥
vụt	jukp˨ˀ˩ʔ
vứt	jɯk˦˥
vưu	jɯw˧˥
vy	ji˧˥
xách	sak˦˥
xạch	sak˨ˀ˩ʔ
xác	sak˦˥
xắc	săk˦˥
xạc	sak˨ˀ˩ʔ
xấc	sɤ̆k˦˥
xái	saj˩˧
xài	saj˦˨
xam	sam˧˥
xám	sam˩˧
xàm	sam˦˨
xăm	săm˧˥
xắm	săm˩˧
xâm	sɤ̆m˧˥
xầm	sɤ̆m˦˨
xẩm	sɤ̆m˧˩˨
xậm	sɤ̆m˨ˀ˩ʔ
xàng	saŋ˦˨
xăng	săŋ˧˥
xằng	săŋ˦˨
xẵng	săŋ˧˩˨
xanh	san˧˥
xành	san˦˨
xán	saŋ˩˧
xăn	săŋ˧˥
xắn	săŋ˩˧
xẩn	sɤ̆ŋ˧˩˨
xao	saw˧˥
xáo	saw˩˧
xào	saw˦˨
xảo	saw˧˩˨
xáp	sap˦˥
xấp	sɤ̆p˦˥
xập	sɤ̆p˨ˀ˩ʔ
xa	sa˧˥
xa,	sa˧˥
xá	sa˩˧
xà	sa˦˨
xã	sa˧˩˨
xả	sa˧˩˨
xạ	sa˨ˀ˩ʔ
xát	sak˦˥
xạu	săw˨ˀ˩ʔ
xâu	sɤ̆w˧˥
xấu	sɤ̆w˩˧
xầu	sɤ̆w˦˨
xay	săj˧˥
xảy	săj˧˩˨
xây	sɤ̆j˧˥
xẩy	sɤ̆j˧˩˨
xếch	set˦˥
xệch	set˨ˀ˩ʔ
xềm	sem˦˨
xem	sɛm˧˥
xẻng	sɛŋ˧˩˨
xênh	sen˧˥
xềnh	sen˦˨
xen	sɛŋ˧˥
xén	sɛŋ˩˧
xèn	sɛŋ˦˨
xẻn	sɛŋ˧˩˨
xeo	seo˧˥
xéo	seo˩˧
xèo	seo˦˨
xẹo	seo˨ˀ˩ʔ
xếp	sep˦˥
xép	sɛp˦˥
xẹp	sɛp˨ˀ˩ʔ
xê	se˧˥
xế	se˩˧
xề	se˦˨
xe	sɛ˧˥
xé	sɛ˩˧
xè	sɛ˦˨
xẻ	sɛ˧˩˨
xét	sɛk˦˥
xều	sɛu˦˨
xệu	sɛu˨ˀ˩ʔ
xỉa	siə˧˩˨
xích	sit˦˥
xiêm	siəm˧˥
xiểm	siəm˧˩˨
xiềng	siəŋ˦˨
xiểng	siəŋ˧˩˨
xiên	siəŋ˧˥
xiển	siəŋ˧˩˨
xiết	siək˦˥
xiêu	siəw˧˥
xiếu	siəw˩˧
xinh	sin˧˥
xính	sin˩˧
xình	sin˦˨
xin	sin˧˥
xín	sin˩˧
xi	si˧˥
xí	si˩˧
xì	si˦˨
xỉ	si˧˩˨
xị	si˨ˀ˩ʔ
xít	sit˦˥
xíu	siw˩˧
xìu	siw˦˨
xỉu	siw˧˩˨
xịu	siw˨ˀ˩ʔ
xoạc	swak˨ˀ˩ʔ
xoai	swaj˧˥
xoài	swaj˦˨
xoang	swaŋ˧˥
xoàng	swaŋ˦˨
xoành	swan˦˨
xoan	swaŋ˧˥
xoàn	swaŋ˦˨
xoăn	swăŋ˧˥
xoắn	swăŋ˩˧
xoẳn	swăŋ˧˩˨
xoa	swa˧˥
xoá	swa˩˧
xoay	swăj˧˥
xoáy	swăj˩˧
xốc	sokp˦˥
xộc	sokp˨ˀ˩ʔ
xóc	sɔkp˦˥
xọc	sɔkp˨ˀ˩ʔ
xoen	swen˧˥
xoèn	swen˦˨
xơi	sɤj˧˥
xới	sɤj˩˧
xởi	sɤj˧˩˨
xôi	soj˧˥
xôi,	soj˧˥
xối	soj˩˧
xổi	soj˧˩˨
xoi	sɔj˧˥
xói	sɔj˩˧
xờm	sɤm˦˨
xôm	som˧˥
xồm	som˦˨
xom	sɔm˧˥
xóm	sɔm˩˧
xòm	sɔm˦˨
xông	soŋm˧˥
xống	soŋm˩˧
xồng	soŋm˦˨
xổng	soŋm˧˩˨
xong	sɔŋm˧˥
xòng	sɔŋm˦˨
xõng	sɔŋm˧˩˨
xỏng	sɔŋm˧˩˨
xơn	sɤŋ˧˥
xớn	sɤŋ˩˧
xôn	soŋm˧˥
xốn	soŋm˩˧
xồn	soŋm˦˨
xổn	soŋm˧˩˨
xộn	soŋm˨ˀ˩ʔ
xon	sɔŋm˧˥
xoong	sɔŋm˧˥
xợp	sɤp˨ˀ˩ʔ
xốp	sop˦˥
xóp	sɔp˦˥
xơ	sɤ˧˥
xớ	sɤ˩˧
xờ	sɤ˦˨
xô	so˧˥
xổ	so˧˩˨
xo	sɔ˧˥
xó	sɔ˩˧
xỏ	sɔ˧˩˨
xọ	sɔ˨ˀ˩ʔ
xớt	sɤk˦˥
xốt	sokp˦˥
xót	sɔkp˦˥
xô-viết	so˧˥-jiək˦˥
xuân	swɤ̆ŋ˧˥
xuẩn	swɤ̆ŋ˧˩˨
xua	suə˧˥
xưa	sɯə˧˥
xưa,	sɯə˧˥
xửa	sɯə˧˩˨
xuất	swɤ̆k˦˥
xuất,	swɤ̆k˦˥
xúc	sukp˦˥
xục	sukp˨ˀ˩ʔ
xức	sɯk˦˥
xuệch	swet˨ˀ˩ʔ
xuềnh	swen˦˨
xuê	swe˧˥
xuề	swe˦˨
xui	suj˧˥
xúi	suj˩˧
xụi	suj˨ˀ˩ʔ
xum	sum˧˥
xúm	sum˩˧
xùm	sum˦˨
xung	suŋm˧˥
xúng	suŋm˩˧
xùng	suŋm˦˨
xủng	suŋm˧˩˨
xưng	sɯŋ˧˥
xứng	sɯŋ˩˧
xửng	sɯŋ˧˩˨
xun	suŋm˧˥
xước	sɯək˦˥
xuôi	suəj˧˥
xuôi,	suəj˧˥
xười	sɯəj˦˨
xuống	suəŋ˩˧
xuống,	suəŋ˩˧
xuồng	suəŋ˦˨
xương	sɯəŋ˧˥
xướng	sɯəŋ˩˧
xường	sɯəŋ˦˨
xưởng	sɯəŋ˧˩˨
xúp	sup˦˥
xu	su˧˥
xú	su˩˧
xù	su˦˨
xủ	su˧˩˨
xụ	su˨ˀ˩ʔ
xứ	sɯ˩˧
xử	sɯ˧˩˨
xuyên	swiəŋ˧˥
xuy	swi˧˥
xuý	swi˩˧
xuýt	swit˦˥
yêm	iɛm˧˥
yếm	iɛm˩˧
yểm	iɛm˧˩˨
yêng	iɛŋ˧˥
yểng	iɛŋ˧˩˨
yên	iɛŋ˧˥
yến	iɛŋ˩˧
yết	iɛk˦˥
yêu	iəw˧˥
yếu	iəw˩˧
yểu	iəw˧˩˨
y	i˧˥
y,	i˧˥
ý	i˩˧
ý,	i˩˧
ỷ	i˧˩˨
