aberaeron	abɛreɨ̯rɔn
aberafan	abɛravan
aberdaugleddau	abɛrdaɨ̯ɡlɛða
aberdaugleddau	abɛrdaɨ̯ɡlɛðaɨ̯
aberdaugleddau	abɛrdaɨ̯ɡlɛðɛ
aberdâr	abɛrdaːr
abergele	abɛrɡɛlɛ
abergwaun	abɛrɡwaɨ̯n
aberhonddu	abɛrhɔnðɨ
abermaw	abɛrmau̯
abermaw	abɛrmɔ
abermaw	bɛrmɔ
abertawe	abɛrtau̯ɛ
aberteifi	abɛrtei̯vi
aberystwyth	abɛrəsdwɨ̞θ
adda	aða
addien	aðiɛn
adfent	advɛnt
adwen	adwɛn
aeddan	ei̯ðan
aeddon	ei̯ðɔn
aelan	ei̯lan
aelwen	ei̯lwɛn
aelwyn	ei̯lwɪn
aeres	eɨ̯rɛs
aerfen	ei̯rvɛn
aeron	ei̯rɔn
aerona	ei̯roːna
aeronwen	ei̯rɔn
aeronwy	ei̯rɔnʊi̯
aethwy	ei̯θʊi̯
afallon	avaɬɔn
afan	avan
affganistan	afɡanɪsdan
affrica	afrɪka
affrig	afrɪɡ
afonwy	avɔnʊi̯
agnes	aɡnɪs
agnest	aɡnɛst
aidan	ei̯dən
aiden	ei̯dən
aifft	ai̯fd
aifft	ərai̯fd
alan	alan
alana	alana
alaw	alau̯
alawn	alau̯n
alban	alban
alban	əralban
albaneg	albanɛɡ
albania	albanja
alcwyn	alkʊi̯n
aldith	aldɪθ
aldrydd	aldrəð
aldwyn	aldʊi̯n
aldwyth	aldʊi̯θ
aldyth	aldɪθ
alec	alɪk
aled	alɛd
algeria	ald͡ʒiːrja
algeria	ald͡ʒɛrja
alis	alɨ̞s
alltwen	aɬtwɛn
allwyd	aɬʊi̯d
almaen	almaɨ̯n
almaen	əralmaɨ̯n
almaeneg	almeɨ̯nɛɡ
almaenwr	almeɨ̯nʊr
alon	alɔn
alpaidd	alpai̯ð
alpaidd	alpɛð
alpau	alpa
alpau	alpaɨ̯
alpau	alpɛ
alun	alɪn
aluna	alɪna
alwen	alwɛn
alwena	alwɛna
alwina	alwɪna
alwyn	alʊi̯n
alys	alɨ̞s
aman	aman
amanwy	amanʊi̯
america	amɛrɪka
amerig	amɛrɪɡ
amerig	əramɛrɪɡ
amig	amɪɡ
amlawdd	amlau̯ð
amlodd	amloːð
amlyn	amlɪn
amos	amɔs
amranwen	amranwɛn
amwythig	amʊɨ̯θɪɡ
anarawd	anarau̯d
andras	andras
andreas	andrɛas
andro	androː
androw	androu̯
aneira	anei̯ra
aneirin	aneɨ̯rɪn
aneirwen	anei̯rwɛn
anes	anɛs
anest	anɛst
aneurin	aneɨ̯rɪn
angell	anɡɛɬ
angharad	aŋharad
angola	aŋɡɔla
anhun	anhɨ̞n
ania	anja
anian	anjan
anita	anɨta
anlawdd	anlau̯ð
ann	an
anna	ana
annalyn	analɨ̞n
annell	anɛɬ
annes	anɛs
annest	anɛst
anni	anɨː
annun	anɨn
annwyl	anʊɨ̯l
anona	anɔna
antigwa	antɪɡwa
antur	antɨ̞r
anwen	anwɛn
anwn	anʊn
anwyl	anʊɨ̯l
anwylyn	anʊɨ̯lɨn
arad	arad
aran	aran
aranli	aranli
arglwydd	arɡlʊɨ̯ð
arglwyddes	arɡlʊɨ̯ðɛs
arglwyddesau	arɡlʊɨ̯ðɛsa
arglwyddesau	arɡlʊɨ̯ðɛsaɨ̯
arglwyddesau	arɡlʊɨ̯ðɛsɛ
ariannin	arjanɪn
ariannin	ərarjanɪn
arianrhod	arjanr̥ɔd
armenia	armɛnja
arthwys	arθʊɨ̯s
arwel	arwɛl
aserbaijan	asɛrbai̯d͡ʒan
athen	aθɛn
awen	au̯ɛn
awst	au̯sd
awstralia	au̯sdralja
awstria	au̯sdrja
bahamas	bahamas
bangor	baŋɡɔr
baragwâi	baraɡwaːi̯
barbados	barbeːdɔs
barbiwda	barbɪu̯da
baris	barɪs
barri	bari
barti	bartɪ
bedr	bɛdr
beibl	bei̯bl
beibl	bei̯bl̩
beiblau	bei̯bla
beiblau	bei̯blaɨ̯
beiblau	bei̯blɛ
belarws	bɛlarʊs
belffast	bɛlfasd
benin	bɛnɪn
beriw	bɛrɪu̯
berlin	bɛrlɪn
bermo	bɛrmɔ
berwig	bɛrwɪɡ
bhwtan	bʊtaːn
birmingham	bərmɪŋham
bolifia	bɔlɪvja
bordo	bɔrdoː
bortiwgal	bɔrtjʊɡal
bortiwgal	bɔrtɪu̯ɡal
bortiwgaleg	bɔrtɪu̯ɡalɛɡ
botswana	bɔtswana
brag	braːɡ
brasil	brasɪl
brecsit	brɛksɪt
brexit	brɛksɪt
bronwen	brɔnwɛn
brwsel	brʊsɛl
brydain	brədai̯n
brydain	brədɛn
brynbuga	brɨ̞nbɨ̞ɡa
bryste	brɨ̞stɛ
brython	brəθɔn
brythoneg	brəθɔnɛɡ
bwlgaria	bʊlɡarja
bwllheli	bʊɬhɛli
bwrwndi	bʊrʊndɪ
cadfael	kadvaːɨ̯l
caer	kaːɨ̯r
caerdydd	kaɨ̯rdɨːð
caerdydd	kərdɨːð
caeredin	kaɨ̯rɛdɨ̞n
caerfaddon	kaɨ̯rvaðɔn
caerffili	kaɨ̯rfɪli
caerfyrddin	kaɨ̯rvərðɪn
caergaint	kaɨ̯rɡai̯nt
caergrawnt	kaɨ̯rɡrau̯nt
caergwrle	kaɨ̯rɡʊrlɛ
caergybi	kaɨ̯rɡəbɪ
caerhirfryn	kaɨ̯rhɪrvrɨ̞n
caerliwelydd	kaɨ̯rlɪu̯ɛlɨ̞ð
caerloyw	kaɨ̯rlɔɨ̯ʊ
caerlŷr	kaɨ̯rlɨːr
caernarfon	kaɨ̞rnarvɔn
caersallog	kaɨ̯rsaɬɔɡ
caerwrangon	kaɨ̯rwraŋɔn
caerwynt	kaɨ̯rwɨ̞nt
caerwysg	kaɨ̯ruːɨ̯sɡ
caerwysg	kaɨ̯rwɨ̯ːsɡ
caint	kai̯nt
cambodia	kambɔdja
cambodiad	kambɔdjad
cambodiaid	kambɔdjai̯d
cambodiaid	kambɔdjɛd
cambodiaidd	kambɔdjai̯ð
cambodiaidd	kambɔdjɛð
camerŵn	kamɛruːn
canada	kanada
canadaidd	kanadai̯ð
canadaidd	kanadɛð
canadiad	kanadjad
canadiaid	kanadjai̯d
canadiaid	kanadjɛd
caradog	karadɔɡ
catrin	katrɪn
celyn	kɛlɨ̞n
ceredigion	kɛrɛdɪɡjɔn
cerys	kɛrɨ̞s
chaeredin	χaɨ̯rɛdɨ̞n
chaerfyrddin	χeɨ̯rfərðɪn
chaint	χai̯nt
chambodia	χambɔdja
chambodiad	χambɔdjad
chambodiaid	χambɔdjai̯d
chambodiaid	χambɔdjɛd
chambodiaidd	χambɔdjai̯ð
chambodiaidd	χambɔdjɛð
chamerŵn	χamɛruːn
chanada	χanada
chanadaidd	χanadai̯ð
chanadaidd	χanadɛð
cholombia	χɔlɔmbja
chorea	χɔreːa
chymru	χəmrɨ̞
ciribati	kɪrɪbatɪ
clydach	klədax
conwy	kɔnʊɨ̯
cristnogaeth	krɪsdnɔɡaɨ̯θ
cristnogaeth	krɪsdnɔɡɛθ
cristnoges	krɪstnɔɡas
cristnoges	krɪstnɔɡɛs
cristnogion	krɪsdnɔɡjɔn
crynwr	krənʊr
crynwyr	krənwɨ̞r
cymraeg	kəmraːi̯ɡ
cymraes	kəmraːɨ̯s
cymraesau	kəmreɨ̯sa
cymraesau	kəmreɨ̯saɨ̯
cymraesau	kəmreɨ̯sɛ
cymreig	kəmrei̯ɡ
cymreigio	kəmrei̯ɡjɔ
cymro	kəmrɔ
cymru	kəmrɨ̞
dafydd	davɨ̞ð
ddenmarc	ðɛnmark
dewi	dɛu̯ɪ
dolwyddelan	dɔlwɨ̞ðɛlan
dudno	dɨ̞dnɔ
duw	dɨ̞u̯
dyfrdwy	dəvrdʊɨ̯
dyfrig	dəvrɪɡ
e	eː
ebrill	ɛbrɪɬ
ecwador	ɛkwadɔr
efrog	ɛvrɔɡ
eidal	ei̯dal
eidal	ərei̯dal
enid	ɛnɪd
eurwen	eɨ̯rwɛn
fawrth	vau̯rθ
fecsico	vɛksɪkɔ
fedi	vɛdi
fegan	vɛɡan
fehefin	vɛhɛvɪn
feneswela	vɛnɛsweːla
ffrancwr	fraŋkʊr
foldofa	vɔldɔva
folifia	vɔlɪvja
foroco	vɔrɔkɔ
gaeredin	ɡaɨ̯rɛdɨ̞n
gaerfyrddin	ɡeɨ̯rfərðɪn
gambodia	ɡambɔdja
ganada	ɡanada
ganadaidd	ɡanadai̯ð
ganadaidd	ɡanadɛð
gatholig	ɡaθɔlɪɡ
giwba	ɡɪu̯ba
gog	ɡɔɡ
gogs	ɡɔɡs
golombia	ɡɔlɔmbja
gorea	ɡɔreːa
gorffennaf	ɡɔrfɛnav
grist	ɡriːst
groatia	ɡrɔatja
groatia	ɡrɔaʃa
groeg	ɡroːɨ̯ɡ
gruffudd	ɡrɨ̞fɨ̞ð
gwener	ɡwɛnɛr
gwenhwyfar	ɡwɛnhʊɨ̯var
gwenllian	ɡwɛnɬiːan
gweplyfr	ɡwɛplɨ̞vr
gwersyllt	ɡwɛrsɨ̞ɬd
gwilym	ɡwɪlɨ̞m
gwyddel	ɡwɨ̞ðɛl
gwyddeleg	ɡwɨ̞ðɛlɛɡ
gwyddelig	ɡwɨ̞ðɛlɪɡ
gwyddelod	ɡwɨ̞ðɛlɔd
gwyddyl	ɡwɨ̞ðɨ̞l
gwydion	ɡwɨ̞djɔn
gymro	ɡəmrɔ
gymru	ɡəmrɨ̞
gymry	ɡəmrɨ̞
gâl	ɡaːl
h	ai̯tʃ
h	aːɨ̯tʃ
h	haːɨ̯tʃ
h	hə
haberaeron	habɛreɨ̯rɔn
haberdâr	habɛrdaːr
hafren	havrɛn
halbania	halbanja
hangharad	haŋharad
harri	harɪ
haserbaijan	hasɛrbai̯d͡ʒan
hawstralia	hau̯sdralja
henffordd	hɛnfɔrð
hiddewiaeth	hɪðeu̯jaɨθ
hiddewiaeth	hɪðeu̯jɛθ
holocost	hɔlɔkɔsd
hwngareg	hʊŋɡarɛɡ
hwngari	hʊŋɡari
hydref	hədra
hydref	hədrɛ
hydref	hədrɛv
i	iː
ianto	jantɔ
iau	jaɨ̯
iddew	ɪðɛu̯
india	ɪndja
ioan	jɔan
iran	ɪran
iseldiraidd	ɪsɛldɪrai̯ð
iseldiraidd	ɪsɛldɪrɛð
israel	ɪsraɨ̯l
iwan	ɪu̯an
iwerddon	ɪu̯ɛrðɔn
iwerddoneg	ɪu̯ɛrðɔnɛɡ
iâl	jaːl
iôr	joːr
j	dʒeː
kantiaeth	kantjaɨ̯θ
kantiaeth	kantjɛθ
latfia	latvja
lerpwl	lɛrpʊl
llandecwyn	ɬandɛkwɨ̞n
llandudno	ɬandɨ̞dnɔ
lloegr	ɬɔɨ̯ɡar
lloegr	ɬɔɨ̯ɡr
lloegr	ɬɔɨ̯ɡər
llwchwr	ɬʊχʊr
llywelyn	ɬəu̯ɛlɨ̞n
loegr	lɔɨ̯ɡr
loegr	lɔɨ̯ɡər
lundain	lɨ̞ndai̯n
lundain	lɨ̞ndan
lundain	lɨ̞ndɛn
lwcsembwrg	lʊksɛmbʊrɡ
lychlyn	ləχlɨ̞n
lychlynnwr	ləχlənʊr
lydaw	lədau̯
mab	maːb
madagasgar	madaɡasɡar
mai	mai̯
manceinion	maŋkei̯njɔn
mari	marɪ
melffast	mɛlfasd
mercher	mɛrχar
mercher	mɛrχɛr
mharagwâi	m̥araɡwaːi̯
mharis	m̥arɪs
mheriw	m̥ɛrɪu̯
mhortiwgal	m̥ɔrtjʊɡal
mhortiwgal	m̥ɔrtɪu̯ɡal
mhortiwgaleg	m̥ɔrtɪu̯ɡalɛɡ
mhrag	m̥raːɡ
mhrydain	m̥rədai̯n
mhrydain	m̥rədɛn
mhwllheli	m̥ʊɬhɛli
mhwtan	mʊtaːn
moldofa	mɔldɔva
molifia	mɔlɪvja
morgan	mɔrɡan
morgannwg	mɔrɡanʊɡ
moroco	mɔrɔkɔ
mosambic	mɔsambiːk
moscfa	mɔsɡva
mosgo	mɔsɡɔ
myfanwy	məvanʊɨ̯
nadolig	dɔlɪɡ
nadolig	nadɔlɪɡ
nedd	neːð
neirin	neɨ̯rɪn
nenmarc	nɛnmark
nghaeredin	ŋ̊aɨ̯rɛdɨ̞n
nghaint	ŋ̊ai̯nt
nghanada	ŋ̊anada
nghorea	ŋ̊ɔreːa
nghymro	ŋ̊əmrɔ
nghymru	ŋ̊əmrɨ
nghymry	ŋ̊əmrɨ̞
ngorffennaf	ŋɔrfɛnav
ngroeg	ŋroːɨ̯ɡ
nhwrci	n̥ʊrki
nicaragwa	nɪkaraɡwa
norwy	nɔrʊɨ̯
nulyn	nɨ̞lɨ̞n
nêr	neːr
o	oː
ogwr	ɔɡʊr
olympaidd	ɔlɨ̞mpai̯ð
olympaidd	ɔlɨ̞mpɛð
oman	ɔman
orffennaf	ɔrfɛnav
osian	ɔʃan
owain	ou̯ai̯n
padarn	padəɹn
padrig	padrɪɡ
paragwâi	paraɡwaːi̯
parchedig	parχɛdɪɡ
paris	parɪs
pasg	paːsɡ
pawl	pau̯l
pedr	pɛdr
penarth	pɛnarθ
penbedw	pɛmbɛdʊ
peris	pɛrɪs
periw	pɛrɪu̯
periwiad	pɛrɪu̯jad
pharagwâi	faraɡwaːi̯
pharis	farɪs
pheriw	fɛrɪu̯
phortiwgal	fɔrtjʊɡal
phortiwgal	fɔrtɪu̯ɡal
phortiwgaleg	fɔrtɪu̯ɡalɛɡ
phrag	fraːɡ
phrydain	frədai̯n
phrydain	frədɛn
phwllheli	fʊɬhɛli
pontypridd	pɔntəpriːð
portiwgal	pɔrtɪu̯ɡal
portiwgaleg	pɔrtɪu̯ɡalɛɡ
powys	pou̯ɨ̞s
powys	pou̯ɪs
prag	praːɡ
prestatyn	prɛstatɨ̞n
protestaniaeth	prɔtɛsdanjaɨ̯θ
protestaniaeth	prɔtɛsdanjɛθ
protestaniaid	prɔtɛsdanjai̯d
protestaniaid	prɔtɛsdanjɛd
protestannaidd	prɔtɛsdanai̯ð
protestannaidd	prɔtɛsdanɛð
protestant	prɔtɛsdant
prydael	prədaɨ̯l
prydain	prədai̯n
prydain	prədɛn
prydwen	prədwɛn
pwllheli	pʊɬhɛli
ragfyr	raɡvɨ̞r
rhian	r̥ian
rhiannon	r̥ianɔn
rhianwen	r̥ianwɛn
rhufain	r̥ɨ̞vai̯n
rhufain	r̥ɨ̞vɛn
rhufeiniwr	r̥ɨ̞vei̯njʊr
rhydychen	r̥ɨːdəχɛn
rhydychen	r̥ɨ̞dəχɛn
rhyl	r̥ɨ̞l
rhyl	ər̥ɨ̞l
roeg	roːɨ̯ɡ
rufain	rɨ̞vai̯n
rufeinig	rɨ̞vei̯nɪɡ
rwanda	rʊanda
rwmania	rʊmanja
rwsia	rʊʃa
sacson	saksɔn
sadwrn	sadʊn
sadwrn	sadʊrn
saesneg	seɨ̯snaɡ
saesneg	seɨ̯snɛɡ
saesneg	sɨ̞snaɡ
saesneg	sɨ̞snɛɡ
saesnes	seɨ̯snas
saesnes	seɨ̯snɛs
saeson	seɨ̯sɔn
sais	saːi̯s
sbaen	sbaːɨ̯n
sbaeneg	sbeɨ̯nɛɡ
sbaenes	sbeɨ̯nas
sbaenes	sbeɨ̯nɛs
sbaenwr	sbeɨ̯nʊr
serbia	sɛrbja
sgythia	sɡəθja
siani	ʃanɪ
siapan	ʃapan
sioned	ʃɔnɛd
siwan	sɪu̯an
siwan	ʃʊan
siân	ʃaːn
siôn	ʃoːn
siôr	ʃoːr
slofacia	slɔvakja
slofenia	slɔvɛnja
sosban	sɔsban
swdan	sʊdan
sweden	swɛdɛn
swistir	swɪsdɪr
swistir	əswɪsdɪr
swrinam	sʊrɪnam
tgau	tɡaɨ̯
tachwedd	taχwɛð
tad	taːd
taf	taːv
tafwys	tavʊɨ̯s
talmwd	talmʊd
tasmania	tasmanja
tawe	tau̯ɛ
tecwyn	tɛkwɨ̞n
teifi	tei̯vi
thachwedd	θaχwɛð
thasmania	θasmanja
thawe	θau̯ɛ
thwrci	θʊrki
tibet	tɪbɛt
tibeteg	tɪbɛtɛɡ
tirana	tɪrana
tiwnisia	tɪu̯nɪsja
tomos	tɔmɔs
tonypandy	tɔnəpandɨ̞
tonyrefail	tɔnərɛvai̯l
trawsfynydd	trau̯svənɨ̞ð
trefor	trɛvɔr
trefynwy	trɛvənʊɨ̯
trindod	trɪndɔd
troedfawr	troːɨ̯dvau̯r
trydar	trədar
tsiad	t͡ʃad
tsieina	t͡ʃei̯na
tsieineeg	t͡ʃei̯neːɛɡ
tudno	tɨ̞dnɔ
twfalw	tʊvalʊ
twitter	twɪtər
twrci	tʊrkɪ
tyddewi	tɨ̞ðɛu̯ɪ
u	ɨː
w	uː
wcráin	ʊkrai̯n
wellington	wɛlɪŋtən
wganda	ʊɡanda
wiciadur	wɪkjadɨ̞r
wicipedia	wɪkɪpɛdja
wiclo	wɪklɔ
wranws	ʊranʊs
wrecsam	wrɛksam
wrwgwái	ʊrʊɡwai̯
wy	uːɨ̯
wyddel	ʊɨ̯ðɛl
wyddeleg	ʊɨ̯ðɛlɛɡ
wysg	uːɨ̯sɡ
ystradwel	əsdradwɛl
zwinglïad	swɪŋɡliːad
zwinglïaeth	swɪŋɡliːaɨ̯θ
zwinglïaeth	swɪŋɡliːɛθ
ab	ab
abad	abad
abadaeth	abadaɨ̯θ
abadaeth	abadɛθ
abadaethau	abadeɨ̯θa
abadaethau	abadeɨ̯θaɨ̯
abadaethau	abadeɨ̯θɛ
abadau	abada
abadau	abadaɨ̯
abadau	abadɛ
abades	abadɛs
abadesau	abadɛsa
abadesau	abadɛsaɨ̯
abadesau	abadɛsɛ
aball	abaɬ
aballu	abaɬɨ̞
abatai	abataɨ̯
abathocroalaidd	abaθɔkrɔalai̯ð
abatir	abatɪr
abatiroedd	abatɪrɔɨ̯ð
abaty	abatɨ̞
aber	abɛr
abergofiant	abɛrɡɔvjant
aberth	abɛrθ
aberthau	abɛrθa
aberthau	abɛrθaɨ̯
aberthau	abɛrθɛ
aberthged	abɛrθɡɛd
aberthgedau	abɛrθɡɛda
aberthgedau	abɛrθɡɛdaɨ̯
aberthgedau	abɛrθɡɛdɛ
aberthu	abɛrθɨ̞
aberthwr	abɛrθʊr
abl	abl
abladol	abladɔl
abostol	abɔsdɔl
absen	absɛn
absennau	absɛna
absennau	absɛnaɨ̯
absennau	absɛnɛ
absennol	absɛnɔl
absennu	absɛnɨ
absenoldeb	absɛnɔldab
absenoldeb	absɛnɔldɛb
abwyd	abʊɨ̯d
abwydyn	abʊɨ̯dɨ̞n
academaidd	akadɛmai̯ð
academaidd	akadɛmɛð
academi	akadɛmi
academydd	akadɛmɨ̞ð
academyddion	akadɛməðjɔn
academïau	akadɛmiːa
academïau	akadɛmiːaɨ̯
academïau	akadɛmiːɛ
acen	akɛn
aceniad	akɛnjad
aceniadau	akɛnjada
aceniadau	akɛnjadaɨ̯
aceniadau	akɛnjadɛ
acenion	akɛnjɔn
acennu	akɛnɨ
acer	akar
acer	akɛr
ach	aχ
ach	aːχ
acha	aχa
achan	aχan
achles	aχlɛs
achlesau	aχlɛsa
achlesau	aχlɛsaɨ̯
achlesau	aχlɛsɛ
achlesu	aχlɛsɨ̞
achlod	aχlɔd
achlust	aχlɨ̞sd
achlysur	aχləsɨ̞r
achlysurol	aχləsɨ̞rɔl
achlysuron	aχləsɨ̞rɔn
achoedd	aːχɔi̯ð
achos	aχɔs
achos	χɔs
achosi	aχɔsi
achosion	aχɔʃɔn
achres	aχrɛs
achub	aχɨ̞b
achubiaeth	aχɨ̞bjaɨ̯θ
achubiaeth	aχɨ̞bjɛθ
achubol	aχɨ̞bɔl
achubwr	aχɨ̞bʊr
achubwyr	aχɨ̞bwɨ̞r
achwyn	aχwɨ̞n
achwyn	aχʊɨ̯n
achwyniad	aχʊɨ̯njad
achwyniadau	aχʊɨ̯njada
achwyniadau	aχʊɨ̯njadaɨ̯
achwyniadau	aχʊɨ̯njadɛ
achwynwr	aχʊɨ̯njʊr
achwynwyr	aχʊɨ̯nwɨ̞r
achwynydd	aχʊɨ̯njɨ̞ð
achydd	aχɨ̞ð
achyddiaeth	aχəðjaɨ̯θ
achyddiaeth	aχəðjɛθ
achyddion	aχəðjɔn
achyddol	aχəðɔl
aciwbigo	akɪu̯bɪɡɔ
act	akt
actau	akta
actau	aktaɨ̯
actau	aktɛ
acti	akti
actiniwm	aktɪnjʊm
actio	aktjɔ
actor	aktɔr
actores	aktɔrɛs
actoresau	aktɔrɛsa
actoresau	aktɔrɛsaɨ̯
actoresau	aktɔrɛsɛ
actorion	aktɔrjɔn
acw	akʊ
ad	aːd
adael	adal
adael	adaɨ̯l
adael	adɛl
adain	adai̯n
adain	adɛn
adainredyn	adai̯nrɛdɨ̞n
adanedd	adanɛð
adar	adar
adara	adara
adardai	adardai̯
adardy	adardɨ̞
adareg	adarɛɡ
adaregol	adarɛɡɔl
adaregwyr	adarɛɡwɨ̞r
adaregydd	adarɛɡɨ̞ð
adargi	adarɡɪ
adargraffiad	adarɡrafjad
adargraffiadau	adarɡrafjada
adargraffiadau	adarɡrafjadaɨ̯
adargraffiadau	adarɡrafjadɛ
adargraffu	adarɡrafɨ̞
adargwn	adarɡʊn
adarwr	adarʊr
adarwyr	adarwɨ̞r
adarydd	adarɨ̞ð
adarydda	adarəða
adaryddiaeth	adarəðjaɨ̯θ
adaryddiaeth	adarəðjɛθ
adaryddion	adarəðjɔn
adawed	adau̯ɛd
adborth	adbɔrθ
adborthion	adbɔrθjɔn
addas	aðas
addasiad	aðasjad
addasiad	aðaʃad
addasrwydd	aðasrʊɨ̯ð
addasu	aðasɨ̞
addawa	aðau̯a
addaweb	aðau̯ɛb
addawebau	aðau̯ɛba
addawebau	aðau̯ɛbaɨ̯
addawebau	aðau̯ɛbɛ
addef	aðɛv
addefiad	aðɛvjad
addewid	aðɛu̯ɪd
addfwyn	aðvʊɨ̯n
addfwynder	aðvʊɨ̯ndɛr
addo	aðɔ
addoldy	aðɔldɨ̞
addolgar	aðɔlɡar
addoliad	aðɔljad
addolwr	aðɔlʊr
addolwyr	aðɔlwɨ̞r
adduned	aðɨ̞nɛd
addunedu	aðɨ̞nɛdɨ̞
addurn	aðɨ̞rn
addurnau	aðɨ̞rna
addurnau	aðɨ̞rnaɨ̯
addurnau	aðɨ̞rnɛ
addurnedig	aðɨ̞rnɛdɪɡ
addurniad	aðɨ̞rnjad
addurno	aðɨ̞rnɔ
addurnol	aðɨ̞rnɔl
addurnwr	aðɨ̞rnjʊr
addysg	aðɨ̞sɡ
addysga	aðəsɡa
addysgau	aðəsɡa
addysgau	aðəsɡaɨ̯
addysgau	aðəsɡɛ
addysgiadol	aðəsɡjadɔl
addysgoch	aðəsɡɔχ
addysgodd	aðəsɡɔð
addysgol	aðəsɡɔl
addysgon	aðəsɡɔn
addysgu	aðəsɡɨ̞
addysgwch	aðəsɡʊχ
addysgwr	aðəsɡʊr
adeg	adaɡ
adeg	adɛɡ
adegau	adɛɡa
adegau	adɛɡaɨ̯
adegau	adɛɡɛ
adeilad	adei̯lad
adeiladaeth	adei̯ladaɨ̯θ
adeiladaeth	adei̯ladɛθ
adeiladaethau	adei̯ladeɨ̯θa
adeiladaethau	adei̯ladeɨ̯θaɨ̯
adeiladaethau	adei̯ladeɨ̯θɛ
adeiladau	adei̯lada
adeiladau	adei̯ladaɨ̯
adeiladau	adei̯ladɛ
adeiladol	adei̯ladɔl
adeiladu	adei̯ladɨ̞
adeiladwaith	adei̯ladwai̯θ
adeiladwaith	adei̯ladwɛθ
adeiladweithiau	adei̯ladwei̯θja
adeiladweithiau	adei̯ladwei̯θjaɨ̯
adeiladweithiau	adei̯ladwei̯θjɛ
adeiladwr	adei̯ladʊr
adeiladwyr	adei̯ladwɨ̞r
adeiledd	adei̯lɛð
adeileddiaeth	adei̯lɛðjai̯θ
adeileddiaeth	adei̯lɛðjɛθ
adeileddol	adei̯lɛðɔl
adeileddwr	adei̯lɛðʊr
adeiniog	adei̯njɔɡ
aden	adɛn
adenedigaeth	adɛnɛdɪɡaɨ̯θ
adenedigaeth	adɛnɛdɪɡɛθ
adenedigaethau	adɛnɛdɪɡeɨ̯θa
adenedigaethau	adɛnɛdɪɡeɨ̯θaɨ̯
adenedigaethau	adɛnɛdɪɡeɨ̯θɛ
adennill	adɛnɪɬ
adenydd	adɛnɨ̞ð
aderyn	adɛrɨ̞n
aderyn	dɛrɨ̞n
adfail	advai̯l
adfeddiannu	advɛðjanɨ
adfeiliad	advei̯ljad
adfeiliadau	advei̯ljada
adfeiliadau	advei̯ljadaɨ̯
adfeiliadau	advei̯ljadɛ
adfeiliedig	advei̯ljɛdɪɡ
adfeilio	advei̯ljɔ
adfeilion	advei̯ljɔn
adfer	advar
adfer	advɛr
adferadwy	advɛradʊɨ̯
adferaf	advɛra
adferaf	advɛrav
adferant	advɛrant
adferent	advɛrɛnt
adferf	advɛrv
adferfol	advɛrvɔl
adferiad	advɛrjad
adferiadau	advɛrjada
adferiadau	advɛrjadaɨ̯
adferiadau	advɛrjadɛ
adferiadwyr	advɛrjadəðwɨ̞r
adferiadydd	advɛrjadɨ̞ð
adferiadyddion	advɛrjadəðjɔn
adferiedydd	advɛrjɛdɨ̞ð
adfero	advɛrɔ
adferol	advɛrɔl
adferwr	advɛrʊr
adferwyr	advɛrwɨ̞r
adfilwr	advɪlʊr
adfilwyr	advɪlwɨ̞r
adflas	advlas
adflasau	advlasa
adflasau	advlasaɨ̯
adflasau	advlasɛ
adfyd	advɨ̞d
adfydau	advəda
adfydau	advədaɨ̯
adfydau	advədɛ
adfydus	advədɨ̞s
adfyw	advɨ̞u̯
adfywiad	advɨ̞u̯jad
adfywiadau	advɨ̞u̯jada
adfywiadau	advɨ̞u̯jadaɨ̯
adfywiadau	advɨ̞u̯jadɛ
adfywio	advɨ̞u̯jɔ
adfywiol	advɨ̞u̯jɔl
adio	adjɔ
adladd	adlað
adlais	adlai̯s
adlam	adlam
adlamau	adlama
adlamau	adlamaɨ̯
adlamau	adlamɛ
adlamu	adlamɨ̞
adlaw	adlau̯
adlef	adlɛv
adlefau	adlɛva
adlefau	adlɛvaɨ̯
adlefau	adlɛvɛ
adleisiau	adlei̯ʃa
adleisiau	adlei̯ʃaɨ̯
adleisiau	adlei̯ʃɛ
adleisio	adlei̯ʃɔ
adlen	adlɛn
adleoli	adlɛɔlɪ
adlewyrch	adlɛu̯ɨ̞rχ
adlewyrchiad	adlɛu̯ərχjad
adlewyrchu	adlɛu̯ərχɨ̞
adlewyrchydd	adlɛu̯ərχɨ̞ð
adloniad	adlɔnjad
adloniadol	adlɔnjadɔl
adloniant	adlɔnjant
adlonni	adlɔnɪ
adlunio	adlɨ̞njɔ
adlyn	adlɨ̞n
adlynol	adlənɔl
adlynu	adlənɨ̞
adlŷn	adlɨːn
adnabod	adnabɔd
adnabyddant	adnabəðant
adnabyddi	adnabəðɪ
adnabyddiaeth	adnabəðjaɨ̯θ
adnabyddiaeth	adnabəðjɛθ
adnabyddus	adnabəðɨ̞s
adnabyddwch	adnabəðʊχ
adnabyddwn	adnabəðʊn
adnau	adna
adnau	adnaɨ̯
adnau	adnɛ
adnebydd	adnɛbɨ̞ð
adneuo	adneɨ̯ɔ
adnewyddiad	adneu̯əðjad
adnewyddu	adneu̯əðɨ̞
adnod	adnɔd
adnodd	adnɔð
adnoddau	adnɔða
adnoddau	adnɔðaɨ̯
adolygiad	adɔləɡjad
adolygiadau	adɔləɡjada
adolygiadau	adɔləɡjadaɨ̯
adolygiadau	adɔləɡjadɛ
adolygiaeth	adɔləɡjaɨ̯θ
adolygiaeth	adɔləɡjɛθ
adolygol	adɔləɡɔl
adolygu	adɔləɡɨ̞
adolygwyr	adɔləɡwɨ̞r
adolygydd	adɔləɡɨ̞ð
adra	adra
adran	adran
adre	adra
adre	adrɛ
adref	adra
adref	adrɛ
adref	adrɛv
adrodd	adrɔð
adroddaf	adrɔða
adroddaf	adrɔðav
adroddiad	adrɔðjad
adroddwr	adrɔðʊr
aduniad	adɨ̞njad
aduno	adɨ̞nɔ
adwaen	adwaɨ̯n
adwaenai	adweɨ̯nai̯
adwaenant	adweɨ̯nant
adwaenech	adweɨ̯nɛχ
adwaenem	adweɨ̯nɛm
adwaenent	adweɨ̯nɛnt
adwaenid	adweɨ̯nɪd
adwaenir	adweɨ̯nɪr
adwaenit	adweɨ̯nɪt
adwaenoch	adweɨ̯nɔχ
adwaenom	adweɨ̯nɔm
adwaenost	adweɨ̯nɔsd
adwaenwch	adweɨ̯nʊχ
adwaenwn	adweɨ̯nʊn
adwaenynt	adweɨ̯nɨ̞nt
adwaith	adwai̯θ
adweinaf	adwei̯nav
adweini	adwei̯ni
adweinid	adwei̯nɪd
adweinir	adwei̯nɪr
adweitheg	adwei̯θɛɡ
adweithegwyr	adwei̯θɛɡwɨ̞r
adweithegydd	adwei̯θɛɡɨ̞ð
adweithio	adwei̯θjɔ
adweithiol	adwei̯θjɔl
adweithiwr	adwei̯θjʊr
adweithydd	adwei̯θɨ̞ð
adwen	adwɛn
adwthio	adʊθjɔ
adwy	adʊɨ̯
adwyth	adʊɨ̯θ
adwythig	adʊɨ̯θɪɡ
adyn	adɨ̞n
aeaf	eɨ̯a
aeaf	eɨ̯av
aech	aːɨ̯χ
aed	aːɨ̯d
aeddfed	eɨ̯ðvɛd
aeddfedrwydd	eɨ̯ðvɛdrʊɨ̯ð
aeddfedu	eɨ̯ðvɛdɨ̞
ael	aːɨ̯l
aeled	eɨ̯lɛd
aeledau	eɨ̯lɛda
aeledau	eɨ̯lɛdaɨ̯
aeledau	eɨ̯lɛdɛ
aeliau	eɨ̯lja
aeliau	eɨ̯ljaɨ̯
aeliau	eɨ̯ljɛ
aelod	eɨ̯lɔd
aelodaeth	eɨ̯lɔdaɨ̯θ
aelodaeth	eɨ̯lɔdɛθ
aelodaethau	eɨ̯lɔdeɨ̯θa
aelodaethau	eɨ̯lɔdeɨ̯θaɨ̯
aelodaethau	eɨ̯lɔdeɨ̯θɛ
aelodau	eɨ̯lɔda
aelodau	eɨ̯lɔdaɨ̯
aelodau	eɨ̯lɔdɛ
aelwyd	eɨ̯lʊɨ̯d
aelwydydd	eɨ̯lʊɨ̯dɨ̞ð
aem	aːɨ̯m
aen	aːɨ̯n
aent	aːɨ̯nt
aer	aːɨ̯r
aeres	eɨ̯rɛs
aerobeg	eɨ̯rɔbɛɡ
aerobig	eɨ̯rɔbɪɡ
aeron	eɨ̯rɔn
aeronen	eɨ̯rɔnan
aeronen	eɨ̯rɔnɛn
aeronog	eɨ̯rɔnɔɡ
aerwy	eɨ̯rʊɨ̯
aet	aːɨ̯t
aeth	aːɨ̯θ
aeth	aːθ
aethai	eɨ̯θai̯
aethant	eɨ̯θant
aethech	eɨ̯θɛχ
aethem	eɨ̯θɛm
aethent	eɨ̯θɛnt
aethid	eɨ̯θɪd
aethit	eɨ̯θɪt
aethnen	eɨ̯θnɛn
aethnenni	eɨ̯θnɛnɪ
aethoch	eɨ̯θɔχ
aethom	eɨ̯θɔm
aethon	eɨ̯θɔn
aethont	eɨ̯θɔnt
aethost	eɨ̯θɔsd
aethpwyd	eɨ̯θpʊɨ̯d
aethus	eɨ̯θɨ̞s
aethwn	eɨ̯θʊn
aetsh	aːɨ̯tʃ
aetshys	eɨ̯tʃɨ̞s
af	aː
af	aːv
afal	aval
afalau	avala
afalau	avalaɨ̯
afalau	avalɛ
afalau	vala
afalau	valɛ
afallen	avaɬɛn
afallennau	avaɬɛna
afallennau	avaɬɛnaɨ̯
afallennau	avaɬɛnɛ
afan	avan
afanc	avaŋk
afancod	avaŋkɔd
afanen	avanɛn
affeithiad	afei̯θjad
affeithio	afei̯θjɔ
affelion	afɛljɔn
affliw	aflɪu̯
affwys	afʊɨ̯s
affwysau	afʊɨ̯sa
affwysau	afʊɨ̯saɨ̯
affwysau	afʊɨ̯sɛ
affwysedd	afʊɨ̯sɛð
affwysol	afʊɨ̯sɔl
afiach	avjaχ
afiaith	avjai̯θ
afiechyd	avjɛχɨ̞d
afiechydon	avjɛχədɔn
aflafar	avlavar
aflan	avlan
aflendid	avlɛndɪd
afleoli	avlɛɔlɪ
afles	avlɛs
aflesol	avlɛsɔl
aflonydd	avlɔnɨ̞ð
aflonyddu	avlɔnəðɨ̞
aflonyddwch	avlɔnəðʊχ
aflonyddwr	avlɔnəðʊr
afloyw	avlɔɨ̯u
afloywder	avlɔɨ̯wdɛr
aflun	avlɨn
afluniaidd	avlɨ̞njai̯ð
aflwydd	avlʊɨ̯ð
aflwyddiannus	avlʊɨ̯ðjanɨ̞s
aflwyddiant	avlʊɨ̯ðjant
aflwyddo	avlʊɨ̯ðɔ
aflym	avlɨ̞m
aflêr	avleːr
afocado	avɔkadɔ
afocados	avɔkadɔs
afon	avɔn
afondaith	avɔndai̯θ
afondeithiau	avɔndei̯θja
afondeithiau	avɔndei̯θjaɨ̯
afondeithiau	avɔndei̯θjɛ
afonfarch	avɔnvarχ
afonfeirch	avɔnvei̯rχ
afonig	avɔnɪɡ
afonol	avɔnɔl
afonydd	avɔnɨ̞ð
afr	avr
afradlon	avradlɔn
afradlonedd	avradlɔnɛð
afradloni	avradlɔnɪ
afradu	avradɨ̞
afraid	avrai̯d
afreidiau	avrei̯dja
afreidiau	avrei̯djaɨ̯
afreidiau	avrei̯djɛ
afreolaeth	avrɛɔlaɨ̯θ
afreolaeth	avrɛɔlɛθ
afreolaidd	avrɛɔlai̯ð
afreolaidd	avrɛɔlɛð
afreolus	avrɛoːlɪs
afreolus	avrɛɔlɨ̞s
afreolus	avrɛɔlɪs
afresymol	avrɛsəmɔl
afresymoldeb	avrɛsəmɔldɛb
afrifed	avrɪvɛd
afrosgo	avrɔsɡo
afrwydd	avrʊɨ̯ð
afu	avɨ̞
afuad	avɨːad
afuau	avɨːa
afuau	avɨːaɨ̯
afuau	avɨːɛ
afwyn	avʊɨ̯n
ag	aɡ
agen	aɡɛn
agendor	aɡɛndɔr
ager	aɡɛr
agerau	aɡɛra
agerau	aɡɛraɨ̯
agerau	aɡɛrɛ
agerdd	aɡɛrð
agerddlong	aɡɛrðlɔŋ
agerfad	aɡɛrvad
agerlong	aɡɛrlɔŋ
agerlongau	aɡɛrlɔŋa
agerlongau	aɡɛrlɔŋaɨ̯
agerlongau	aɡɛrlɔŋɛ
ageru	aɡɛrɨ̞
agor	aɡɔr
agora	aɡɔra
agoraf	aɡɔra
agoraf	aɡɔrav
agorai	aɡɔrai̯
agorawd	aɡɔrau̯d
agored	aɡɔrad
agored	aɡɔrɛd
agoret	aɡɔrɛt
agorfa	aɡɔrva
agori	aɡɔri
agoriad	aɡɔrjad
agoriadol	aɡɔrjadɔl
agorwr	aɡɔrʊr
agorwyr	aɡɔrwɨ̞r
agorydd	aɡɔrɨ̞ð
agos	aɡɔs
agosatrwydd	aɡɔsatrʊɨ̯ð
agosrwydd	aɡɔsrʊɨ̯ð
agosáu	aɡɔsaɨ̯
agwedd	aɡwɛð
agweddi	aɡwɛðɪ
agweddïau	aɡwɛðiːa
agweddïau	aɡwɛðiːaɨ̯
agweddïau	aɡwɛðiːɛ
ai	ai̯
aidd	ai̯ð
aiff	ai̯f
ail	ai̯l
ailbeintio	ai̯lbei̯ntjɔ
aildrefnu	ai̯ldrevnɨ̞
ailenedigaeth	ai̯lɛnɛdɪɡaɨ̯θ
ailenedigaeth	ai̯lɛnɛdɪɡɛθ
ailfeddiannu	ai̯lvɛðjanɨ̞
ailgyflwyno	ai̯lɡəvlʊɨ̯nɔ
ailgyfuniad	ai̯lɡəvɨ̞njad
ailgyfuno	ai̯lɡəvɨ̞nɔ
ailgylchu	ai̯lɡəlχɨ
aillt	ai̯ɬd
ailosod	ai̯lɔsɔd
ailwampio	ai̯lwampjɔ
ailymgnawdoliad	aɪləmɡnaʊdɔljad
air	ai̯r
ais	ai̯s
ait	ai̯t
alan	alan
alannon	alanɔn
alar	alar
alar	aːlar
alarch	alarχ
alaw	alau̯
alban	alban
albanau	albana
albanau	albanaɨ̯
albanau	albanɛ
albwm	albʊm
alcali	alkali
alcohol	alkɔhɔl
aleff	alɛf
alfarch	alvarχ
all	aɬ
alla	aɬa
allai	aɬai̯
allai	aɬɛ
allan	aɬan
allanadlu	aɬanadlɨ̞
allanfa	aɬanva
allanol	aɬanɔl
allant	aɬant
allblyg	aɬblɨ̞ɡ
allen	aɬɛn
aller	aɬɛr
allforiadwy	aɬvɔrjadʊɨ̯
allforio	aɬvɔrjɔ
allforion	aɬvɔrjɔn
allforiwr	aɬvɔrjʊr
allforwyr	aɬvɔrwɨ̞r
allforyn	aɬvɔrɨ̞n
allfudo	aɬvɨ̞dɔ
allglofan	aɬɡlɔvan
allgofnodi	aɬɡɔvnɔdi
alli	aɬi
allo	aɬɔ
allor	aɬɔr
allt	aːɬd
alltraw	aɬtrau̯
alltrawes	aɬtrau̯as
alltro	aɬdrɔ
alltroëdig	aɬtrɔɛdɪɡ
alltud	aɬdɨ̞d
allwedd	aɬwɛð
allweddell	aɬwɛðɛɬ
allweddellau	aɬwɛðɛɬa
allweddellau	aɬwɛðɛɬaɨ̯
allweddellau	aɬwɛðɛɬɛ
allwthio	aɬʊθjɔ
almanac	almanak
almanaciau	almanakja
almanaciau	almanakjaɨ̯
almanaciau	almanakjɛ
almon	almɔn
almonau	almɔna
almonau	almɔnaɨ̯
almonau	almɔnɛ
aloi	aloi̯
alon	alɔn
alwminiwm	alʊmɪnjʊm
am	am
amaethyddiaeth	ameɨ̯θəðjaɨ̯θ
amaethyddiaeth	ameɨ̯θəðjɛθ
amanita	amanɪta
amau	ama
amau	amɛ
ambell	ambaɬ
ambell	ambɛɬ
ambeutu	ambeɨ̯tɨ̞
ambiti	ambɪtɪ
ambiwlans	ambɪu̯lans
ambiwlansys	ambɪu̯lansɨ̞s
amcan	amkan
amcangyfrif	amkaŋɡəvrɪ
amcangyfrifon	amkaŋɡəvrɪvɔn
amcanion	amkanjɔn
amcanu	amkanɨ̞
amdan	amdan
amdana	amdana
amdanaf	amdanav
amdanat	amdanat
amdani	amdanɪ
amdano	amdanɔ
amdanoch	amdanɔχ
amdanom	amdanɔm
amdanon	amdanɔn
amdanot	amdanɔt
amdanyn	amdanɨ̞n
amdanynt	amdanɨ̞nt
amddiffyn	amðɪfɨ̞n
amddiffynnaf	amðɪfənav
ameba	amɛba
americiwm	amɛrɪkjʊm
amethyst	amɛθɨ̞sd
amffibiad	amfɪbjad
amguedd	amɡɨːɛð
amgueddfa	amɡɨ̞ɛðva
amgyffred	amɡəfrɛd
amgylch	amɡɨ̞lχ
amgylchedd	amɡəlχɛð
amgylcheddol	amɡəlχɛðɔl
amgáu	amɡaɨ̯
amharchus	amharχɨ̞s
amharu	amharɨ̞
amhenderfynol	amhɛndɛrvənɔl
amhenodol	amhɛnɔdɔl
amherffaith	am̥hɛrfai̯θ
amheuaeth	amheɨ̯aɨ̯θ
amheuaeth	amheɨ̯ɛθ
amheuaf	amheɨ̯a
amheuaf	amheɨ̯av
amheus	amheɨ̯s
amhosib	amhɔsɪb
amlach	amlaχ
amlddewis	amlɡɛɬɔɡ
amlen	amlɛn
amlgellog	amlɡɛɬɔɡ
amlhau	amlhaɨ̯
amlochrog	amlɔχrɔɡ
amlwg	amlʊɡ
amlygu	amləɡɨ
amnaid	amnad
amnaid	amnai̯d
amnaid	amnɛd
amnewid	annɛu̯ɪd
amobr	amɔbr
amod	amɔd
amodau	amɔda
amodau	amɔdaɨ̯
amodau	amɔdɛ
amodi	amɔdi
amodiad	amɔdjad
amranflew	amranvlɛu̯
amrannau	amrana
amrannau	amranaɨ̯
amrannau	amranɛ
amrant	amrant
amrantiad	amrantjad
amrwd	amrʊd
amrwymo	amrʊɨ̯mɔ
amryw	amrɨu̯
amryw	amrɪu̯
amrywedd	amrɨu̯jɛð
amrywedd	amrɪu̯jɛð
amrywiad	amrɨ̞u̯jad
amrywiad	amrɪu̯jad
amrywiadau	amrɨ̞u̯jada
amrywiadau	amrɨ̞u̯jadaɨ̯
amrywiadau	amrɨ̞u̯jadɛ
amrywiadau	amrɪu̯jada
amrywiadau	amrɪu̯jadaɨ̯
amrywiadau	amrɪu̯jadɛ
amrywiaeth	amrɨu̯jaɨ̯ð
amrywiaeth	amrɨu̯jɛθ
amrywiaeth	amrɪu̯jaɨ̯ð
amrywiaeth	amrɪu̯jɛθ
amrywiaethau	amrɨ̞u̯jeɨ̯θa
amrywiaethau	amrɨ̞u̯jeɨ̯θaɨ̯
amrywiaethau	amrɨ̞u̯jeɨ̯θɛ
amrywiaethau	amrɪu̯jeɨ̯θa
amrywiaethau	amrɪu̯jeɨ̯θaɨ̯
amrywiaethau	amrɪu̯jeɨ̯θɛ
amrywio	amrɨu̯jɔ
amrywio	amrɪu̯jɔ
amrywiol	amrɨu̯jɔl
amrywiol	amrɪu̯jɔl
amser	amsar
amser	amsɛr
amserau	amsɛra
amserau	amsɛraɨ̯
amserau	amsɛrɛ
amseriadur	amsɛrjadɨ̞r
amseriaduron	amsɛrjadɨ̞rɔn
amserlen	amsɛrlɛn
amserlenni	amsɛrlɛni
amseroedd	amsɛrɔɨ̯ð
amwys	amʊɨs
amwysedd	amwɨsɛð
amynedd	amənɛð
amyneddgar	amənɛðɡar
anabl	anabl
anabledd	anablað
anabledd	anablɛð
anableddau	anablɛða
anableddau	anablɛðaɨ̯
anableddau	anablɛðɛ
anaddas	anaðas
anadlu	anadlɨ̞
anadnabyddus	anadnabəðɨ̞s
anaeddfed	aneɨ̯ðvɛd
anaeddfedrwydd	aneɨ̯ðvɛdrʊɨ̯ð
anaerobig	aneɨ̯rɔbɪɡ
anaf	anav
anafa	anava
anafai	anavai̯
anafais	anavai̯s
anafais	anavɛs
anafais	anavɪʃ
anafes	anavɛs
anafes	anavɪʃ
anafiadau	anavjada
anafiadau	anavjadaɨ̯
anafiadau	anavjadɛ
anafu	anavɨ̞
anaml	anaml
anawsterau	anau̯sdɛra
anawsterau	anau̯sdɛraɨ̯
anawsterau	anau̯sdɛrɛ
andwyol	andʊɨ̯ɔl
aneiri	anei̯ri
aneiriol	anei̯rjɔl
aneirod	anei̯rɔd
anelu	anɛlɨ̞
anesboniadwy	anɛsbɔnjadʊɨ̯
anesgusodol	anɛsɡɨ̞sɔdɔl
anfantais	anvantai̯s
anfantais	anvantɛs
anfanteision	anvantei̯ʃɔn
anferth	anvarθ
anferth	anvɛrθ
anffawd	anfau̯d
anffodus	anfɔdɨ̞s
anffurfiol	anfɨ̞rvjɔl
anffydd	anfɨð
anffyddiwr	anfəðjʊr
anfodlon	anvɔdlɔn
anfoesol	anvoːɨ̯sɔl
anfon	anvɔn
anfonaf	anvɔnav
anfwriadol	anvʊrjadɔl
anfynych	anvənɨ̞χ
angall	aŋaɬ
angau	aŋa
angau	aŋaɨ̯
angau	aŋɛ
angel	aŋal
angel	aŋɛl
angen	aŋan
angen	aŋɛn
angenrheidiol	aŋɛnr̥ei̯djɔl
angenrheidrwydd	aŋɛnr̥ei̯drʊɨ̯ð
anghanfyddadwy	aŋhanvəðadʊɨ̯
anghenion	aŋhɛnjɔn
anghenraid	aŋhɛnrai̯d
anghenus	aŋhɛnɨ̞s
angheuoedd	aŋheɨ̯ɔɨ̯ð
angheuol	aŋheɨ̯ɔl
anghlod	aŋhlɔd
anghlodau	aŋhlɔda
anghlodau	aŋhlɔdaɨ̯
anghlodau	aŋhlɔdɛ
anghlodwiw	aŋhlɔdwɪu̯
anghofio	aŋhɔvjɔ
anghofrwydd	aŋhɔvrʊɨ̯ð
anghofus	aŋhɔvɨ̞s
anghofuster	aŋhɔvɨ̞sdɛr
anghredadwy	aŋhrɛdadu
anghredadwy	aŋhrɛdadʊɨ̯
anghydfod	aŋhədvɔd
anghydfodau	aŋhədvɔda
anghydfodau	aŋhədvɔdaɨ̯
anghydfodau	aŋhədvɔdɛ
anghydradd	aŋhədrað
anghydraddoldeb	aŋhədraðɔldɛb
anghydsynio	aŋhɨ̞dsənjɔ
anghydweld	aŋhɨ̞dwɛld
anghydwelediad	aŋhɨ̞dwɛlɛdjad
anghydwelediadau	aŋhɨ̞dwɛlɛdjada
anghydwelediadau	aŋhɨ̞dwɛlɛdjadaɨ̯
anghydwelediadau	aŋhɨ̞dwɛlɛdjadɛ
anghyfaddas	aŋhəvaðas
anghyfartal	aŋhəvartal
anghyfforddus	aŋhəfɔrðɨ̞s
anghyfiawn	aŋ̊həvjau̯n
anghyfiawnder	aŋhəvjau̯ndɛr
anghyflawn	aŋhəvlau̯n
anghyflogaeth	aŋhəvlɔɡaɨ̯θ
anghyflogaeth	aŋhəvlɔɡɛθ
anghyfreithlon	aŋhəvrei̯θlɔn
anghymdeithasol	aŋhəmdei̯θasɔl
anghymeradwyaeth	aŋhəmɛradʊɨ̯aɨ̯θ
anghymeradwyaeth	aŋhəmɛradʊɨ̯ɛθ
anghymhwyso	aŋhəmhʊɨ̯sɔ
anghymhwyster	aŋhəmhʊɨ̯stɛr
anghymreig	aŋhəmrei̯ɡ
anghymreigio	aŋhəmrei̯ɡjɔ
anghymwys	aŋhəmʊɨ̯s
anghyseinedd	aŋhəsei̯nɛð
anghytgord	aŋhətɡɔrd
anghytgordiau	aŋhətɡɔrdja
anghytgordiau	aŋhətɡɔrdjaɨ̯
anghytgordiau	aŋhətɡɔrdjɛ
anghytundeb	aŋhətɨ̞ndɛb
anghytundebau	aŋhətɨ̞ndɛba
anghytundebau	aŋhətɨ̞ndɛbaɨ̯
anghytundebau	aŋhətɨ̞ndɛbɛ
anghytuno	aŋhətɨnɔ
anghytuno	aŋətɨnɔ
anghytûn	aŋhətɨːn
anghywir	aŋ̊həwɪr
angladd	aŋlað
angladdau	aŋlaða
angladdau	aŋlaðaɨ̯
angladdau	aŋlaðɛ
angof	aŋɔv
angor	aŋɔr
angorau	aŋɔraa
angorau	aŋɔraɛ
angorau	aŋɔraɨ̯
angorion	aŋɔrjɔn
angylaidd	aŋəlai̯ð
angylaidd	aŋəlɛð
angyles	aŋəlɛs
angylesau	aŋəlɛsa
angylesau	aŋəlɛsaɨ̯
angylesau	aŋəlɛsɛ
angylion	aŋəljɔn
anhap	anhap
anhapus	anhapɨ̞s
anhawster	anhau̯sdar
anhawster	anhau̯sdɛr
anheddau	anhɛða
anheddau	anhɛðaɨ̯
anheddau	anhɛðɛ
anhryloyw	anhrəlɔɨ̯u
anhryloywder	anr̥əlɔɨ̯wdɛr
anhwylder	anhʊɨ̯ldɛr
anhwylderau	anhʊɨ̯ldɛra
anhwylderau	anhʊɨ̯ldɛraɨ̯
anhwylderau	anhʊɨ̯ldɛrɛ
anhyblyg	anhəblɨ̞ɡ
anhygoel	anhəɡɔɨ̯l
anhysbys	anhəsbɨ̞s
anial	anjal
anialwch	anjalʊχ
anian	anjan
anianau	anjana
anianau	anjanaɨ̯
anianau	anjanɛ
anifail	anɪvai̯l
anifail	anɪvɛl
animeiddiad	anɪmei̯ðjad
animeiddiadau	anɪmei̯ðjjada
animeiddiadau	anɪmei̯ðjjadaɨ̯
animeiddiadau	anɪmei̯ðjjadɛ
animeiddio	anɪmei̯ðjɔ
animeiddiwr	anɪmei̯ðjʊr
animeiddwyr	anɪmei̯ðwɨ̞r
anlwc	anlʊk
anlwcus	anlʊkɨ̞s
annedd	anað
annedd	anɛð
anner	anɛr
annerbyniol	anɛrbənjol
annerch	anɛrχ
annhebyg	anhɛbɨ̞ɡ
annhebyg	anhɛbɪɡ
annhebygol	anhɛbəɡɔl
annhebygrwydd	anhɛbəɡrʊɨ̯ð
annheg	anheːɡ
annherfynol	anhɛrvənɔl
annibynadwy	anɪbənadu
annibynadwy	anɪbənadʊɨ̯
anniddorol	anɪðɔrɔl
annoeth	anɔɨ̯θ
annog	anɔɡ
annwyd	anʊɨ̯d
annwyl	anʊɨ̯l
anobaith	anɔbaiθ
anobaith	anɔbɛθ
anobeithiau	anɔbei̯θja
anobeithiau	anɔbei̯θjaɨ̯
anobeithiau	anɔbei̯θjɛ
anobeithio	anɔbei̯θjɔ
anobeithiol	anɔbei̯θjɔl
anodd	anɔð
anoddach	anɔðaχ
anoddaf	anɔða
anoddaf	anɔðav
anodded	anɔðɛd
anogaf	anɔɡa
anogaf	anɔɡav
anrheg	anr̥ɛɡ
anrhydedd	anr̥ədɛð
anrhydeddu	anr̥ədɛðɨ̞
anrhydeddus	anr̥ədɛðɨ̞s
ansawdd	ansau̯ð
ansoddair	ansɔðai̯r
ansoddeiriau	ansɔðei̯rja
ansoddeiriau	ansɔðei̯rjaɨ̯
ansoddeiriau	ansɔðei̯rjɛ
ansoddeiriol	ansɔðeːrjɔl
anthem	anθɛm
anthemau	anθɛma
anthemau	anθɛmaɨ̯
anthemau	anθɛmɛ
anther	anθɛr
anti	antɪ
antimoni	antɪmɔnɪ
antur	antɨ̞r
anturiaeth	antɨ̞rjaiθ
anturiaeth	antɨ̞rjɛθ
anturiaethau	antɪrjaiθaɨ
anturion	antɪrjɔn
anuniongyrchol	anɨ̞njɔŋɡərχɔl
anwaraidd	anwarai̯ð
anwedd	anwɛð
anweddiad	anwɛðjad
anweddu	anwɛðɨ̞
anweddus	anwɛðɨ̞s
anweladwy	anwɛladʊɨ̯
anweledig	anwɛlɛdɪɡ
anwes	anwas
anwes	anwɛs
anwir	anwɪr
anwybod	anwɨ̞bɔd
anwybodus	anwɨ̞bɔdɨ̞s
anwybyddu	anwɨ̞bəðɨ̞
anwythiad	anʊɨ̯θjad
anwythiant	anʊɨ̯θjant
anwytho	anʊɨ̯θɔ
anwythol	anʊɨ̯θɔl
anwythydd	anʊɨ̯θɨ̞ð
ap	ap
apeliadau	apɛljadaɨ̯
apeliadau	apɛljadɛ
apeliadau	jada
apostol	apɔsdɔl
apostolion	apɔsdɔljɔn
apwyntiad	apʊɨ̯ntjad
apwyntio	apʊɨ̯ntjo
apêl	apeːl
ar	ar
aradr	arad
aradr	aradr
araf	ara
araf	arav
arafodd	aravɔð
arafu	aravɨ̞
arafwch	aravʊχ
arall	araɬ
arallfyd	araɬvɨ̞d
aran	aran
aranianoliaeth	aranjanɔljaɨ̯θ
aranianoliaeth	aranjanɔljɛθ
arbed	arbɛd
arbedaf	arbɛda
arbedaf	arbɛdav
arbenigo	arbɛnɪɡɔ
arbennig	arbɛnɪɡ
arbrawf	arbrau̯v
arbrofi	arbrɔvɪ
arch	arχ
archangel	arχaŋal
archangel	arχaŋɛl
archangylion	arχaŋəljɔn
archdderwydd	arχðɛrwɨ̞ð
archdeyrniaeth	arχdeɨ̯rnjaɨ̯θ
archdeyrniaeth	arχdeɨ̯rnjɛθ
archdeyrniaethau	arχdeɨ̯rnjeɨ̯θa
archdeyrniaethau	arχdeɨ̯rnjeɨ̯θaɨ̯
archdeyrniaethau	arχdeɨ̯rnjeɨ̯θɛ
archeb	arχɛb
archebion	arχɛbjɔn
archebu	arχɛbɨ̞
archesgob	arχɛsɡɔb
archesgobion	arχɛsɡɔbjɔn
archfarchnad	arχvarχnad
archfarchnadoedd	arχvarχnadɔɨ̯ð
archoll	arχɔɬ
archolli	arχɔɬi
archser	arχsɛr
archseren	arχsɛrɛn
archwilio	arχwɪljɔ
ardal	ardal
ardaloedd	ardalɔɨ̯ð
ardd	arð
ardd	aːrð
arddaf	arðav
arddangos	arðaŋɔs
arddangosfa	arðaŋɡɔsva
arddangosfeydd	arðaŋɡɔsveɨ̯ð
arddansoddiad	arðansɔðjad
arddansoddiaeth	arðansɔðjɛθ
arddel	arðal
arddel	arðɛl
arddelw	arðɛl
arddelw	arðɛlu
arddelwon	arðɛlwɔn
ardderchog	arðɛrχɔɡ
arddio	arðjɔ
arddodi	arðɔdɪ
arddodiad	arðɔdjad
arddodiaid	arðɔdjai̯d
arddodiaid	arðɔdjɛd
arddwrn	arðʊrn
arddyrnau	arðərna
arddyrnau	arðərnaɨ̯
arddyrnau	arðərnɛ
ardir	ardɪr
aredaf	arɛda
aredaf	arɛdav
aredig	arɛdɪɡ
aren	arɛn
arennau	arɛna
arennau	arɛnaɨ̯
arennau	arɛnɛ
arestiad	arɛsdjad
arestiadau	arɛsdjada
arestiadau	arɛsdjadaɨ̯
arestiadau	arɛsdjadɛ
arestio	arɛsdjɔ
arf	arv
arfau	arva
arfau	arvaɨ̯
arfau	arvɛ
arfbais	arvbai̯s
arfbeisiau	arvbei̯ʃa
arfbeisiau	arvbei̯ʃaɨ̯
arfbeisiau	arvbei̯ʃɛ
arfedd	arvað
arfedd	arvɛð
arfeddion	arvɛðjɔn
arfeddog	arvɛðɔɡ
arfer	arvar
arfer	arvɛr
arferol	arvɛrɔl
arfod	arvɔd
arfodau	arvɔd
arfodau	arvɔda
arfodau	arvɔdaɨ̯
arfodau	arvɔdɛ
arfodion	arvɔdjɔn
arg	arɡ
argaen	arɡaɨ̯n
argaenau	arɡeɨ̯na
argaenau	arɡeɨ̯naɨ̯
argaenau	arɡeɨ̯nɛ
arglawdd	arɡlau̯ð
arglwydd	arɡlʊɨ̯ð
arglwyddes	arɡlʊɨ̯ðɛs
arglwyddesau	arɡlʊɨ̯ðɛsa
arglwyddesau	arɡlʊɨ̯ðɛsaɨ̯
arglwyddesau	arɡlʊɨ̯ðɛsɛ
arglwyddi	arɡlʊɨ̯ðɪ
argoel	arɡɔɨ̯l
argoelion	arɡɔi̯ljɔn
argoelion	arɡɔɨ̯ljɔn
argon	arɡɔn
argraff	arɡraf
argraffiad	arɡrafjad
argraffiadaeth	arɡrafjadaɨ̯θ
argraffiadaeth	arɡrafjadɛθ
argraffiadau	arɡrafjada
argraffiadau	arɡrafjadaɨ̯
argraffiadau	arɡrafjadɛ
argraffiadol	arɡrafjadɔl
argraffiadwyr	arɡrafjadwɨ̞r
argraffiadydd	arɡrafjadɨ̞ð
argraffu	arɡrafɨ̞
argraffwr	arɡrafʊr
argraffwyr	arɡrafwɨ̞r
argraffydd	arɡrafɨ̞ð
argraffyddion	arɡrafəðjɔn
argrafiadau	arɡrafjada
argrafiadau	arɡrafjadaɨ̯
argrafiadau	arɡrafjadɛ
argyfwng	arɡəvʊŋ
argyfyngau	arɡəvəŋa
argyfyngau	arɡəvəŋaɨ̯
argyfyngau	arɡəvəŋɛ
argyfyngus	arɡəvəŋɨ̞s
arholi	arhɔlɪ
arholiad	arhɔljad
arholiadau	arhɔljada
arholiadau	arhɔljadaɨ̯
arholiadau	arhɔljadɛ
arholiadau	arɔljada
arholiadau	arɔljadɛ
arhosa	arhɔsa
arhosaf	arhɔsav
arhosan	arhɔsan
arhosfa	arhɔsva
arhosiad	arhɔʃad
arhosle	arhɔslɛ
arhosoch	arhɔsɔχ
arhosodd	arhɔsɔð
arhosol	arhɔsɔl
arhoson	arhɔsɔn
arhoswch	arhɔsʊχ
arial	arjal
arian	arjan
ariannog	arjanɔɡ
ariannwr	arjanʊr
arianrhod	arjanr̥ɔd
arlais	arlai̯s
arlludd	arɬɨ̞ð
arllwys	arɬʊɨ̯s
arllwysaf	arɬʊɨ̯sa
arllwysaf	arɬʊɨ̯sav
arloesi	arlɔɨ̯sɪ
arlwy	arluɨ̯
arlwyau	arlʊɨ̯a
arlwyau	arlʊɨ̯aɨ̯
arlwyau	arlʊɨ̯ɛ
arlywydd	arɬəu̯ɨ̞ð
armerth	armɛrθ
arna	arna
arnaf	arnav
arnat	arnat
arni	arnɪ
arno	arnɔ
arnoch	arnɔχ
arnodd	arnɔð
arnofio	arnɔvjɔ
arnom	arnɔm
arnon	arnɔn
arnot	arnɔt
arnyn	arnɨ̞n
arnynt	arnɨ̞nt
arogl	arɔɡl
arogl	aːrɔɡl
arogldarth	arɔɡldarθ
arogli	arɔɡli
arolwg	arɔlʊɡ
arolygiad	arɔləɡjad
arolygiadau	arɔləɡjada
arolygiadau	arɔləɡjadaɨ̯
arolygiadau	arɔləɡjadɛ
arolygiaeth	arɔləɡjaɨ̯θ
arolygiaeth	arɔləɡjɛθ
arolygiaethau	arɔləɡjeɨ̯θa
arolygiaethau	arɔləɡjeɨ̯θaɨ̯
arolygiaethau	arɔləɡjeɨ̯θɛ
arolygol	arɔləɡɔl
arolygon	arɔləɡɔn
arolygu	arɔləɡɨ̞
arolygwr	arɔləɡʊr
arolygwyr	arɔləɡwɨ̞r
arolygydd	arɔləɡɨ̞ð
aromatherapi	arɔmaθɛrapi
aromatherapydd	arɔmaθɛrapɨ̞ð
aromatherapyddion	arɔmaθɛrapəðjɔn
aros	arɔs
arosfa	arɔsva
arosfeydd	arɔsveɨ̯ð
arsenig	arsɛnɪɡ
arswyd	arsʊɨ̯d
arswydau	arsʊɨ̯da
arswydau	arsʊɨ̯daɨ̯
arswydau	arsʊɨ̯dɛ
arswydo	arsʊɨ̯dɔ
arswydus	arsʊɨ̯dɨ̞s
artaith	artai̯θ
arth	arθ
arthan	arθan
arthes	arθɛs
arwain	arwai̯n
arwain	arwɛn
arweiniad	arwei̯njad
arweiniadau	arwei̯njada
arweiniadau	arwei̯njadaɨ̯
arweiniadau	arwei̯njadɛ
arweinwyr	arwei̯nwɨ̞r
arweinydd	arwei̯nɨ̞ð
arweinyddion	arwei̯nəðjɔn
arwerthiannau	arwɛrθjana
arwerthiannau	arwɛrθjanaɨ̯
arwerthiannau	arwɛrθjanɛ
arwerthiant	arwɛrθjant
arwerthu	arwɛrθɨ̞
arwerthwr	arwɛrθʊr
arwerthwyr	arwɛrθwɨ̞r
arwr	arʊr
arwydd	arwɨ̞ð
arwyddbost	arwɨ̞ðbɔsd
arwyddion	arwɨ̯ðjɔn
arwyddlun	arwɨ̞ðlɨ̞n
arwynebedd	arwɨ̞nɛbɛð
arwynebeddau	arwɨ̞nɛbɛða
arwynebeddau	arwɨ̞nɛbɛðaɨ̯
arwynebeddau	arwɨ̞nɛbɛðɛ
arwynt	arwɨ̞nt
arwyr	arwɨ̞r
asbri	asbri
asen	asɛn
asesiad	asɛʃad
asesiadau	asɛʃada
asesiadau	asɛʃadaɨ̯
asesiadau	asɛʃadɛ
asesu	asɛsɨ̞
aseswr	asɛsʊr
aseswyr	asɛswɨ̞r
aseth	asɛθ
asgell	asɡaɬ
asgell	asɡɛɬ
asgellog	asɡɛɬɔɡ
asgetig	asɡɛtɪɡ
asgetigiaeth	asɡɛtɪɡjaɨ̯θ
asgetigiaeth	asɡɛtɪɡjɛθ
asgwrn	asɡʊrn
asiad	aʃad
asid	asɪd
asidaidd	asɪdai̯ð
asidaidd	asɪdɛð
asideiddio	asɪdei̞ðjɔ
asiedydd	aʃɛdɨ̞ð
asio	aʃɔ
astatin	asdatɪn
astell	asdaɬ
astell	asdɛɬ
astrus	asdrɨ̞s
astrusi	asdrɨ̞si
astud	asdɨ̞d
astudiaeth	asdɨ̞djaɨ̯θ
astudiaeth	asdɨ̞djaθ
astudiaeth	asdɨ̞djɛθ
astudiaethau	asdɨ̞djeɨ̯θa
astudiaethau	asdɨ̞djeɨ̯θaɨ̯
astudiaethau	asdɨ̞djeɨ̯θɛ
astudio	asdɨ̞djɔ
asur	asɨ̞r
asurfaen	asɨ̞rvaɨ̞n
asyn	asɨ̞n
asynnod	asənɔd
at	at
ata	ata
atab	atab
ataf	atav
atal	atal
atalfa	atalva
atalfeydd	atalveɨ̯ð
atalion	ataljɔn
atalnod	atalnɔd
atalnodau	atalnɔda
atalnodau	atalnɔdaɨ̯
atalnodau	atalnɔdɛ
atat	atat
atborth	atbɔrθ
atborthion	atbɔrθjɔn
atddodol	atðɔdɔl
ateb	atab
ateb	atɛb
atebaf	atɛba
atebaf	atɛbav
ateli	atɛli
atelid	atɛlɪd
atgenhedlu	atɡɛnhɛdlɨ̞
atgoffa	atɡɔfa
atgoffâd	atɡofaːd
atgofus	atɡɔvɨ̞s
athematig	aθɛmatɪɡ
athletau	aθlɛta
athletau	aθlɛtaɨ̯
athletau	aθlɛtɛ
athrawes	aθrau̯as
athrawes	aθrau̯ɛs
athrawesau	aθrau̯ɛsa
athrawesau	aθrau̯ɛsaɨ̯
athrawesau	aθrau̯ɛsɛ
athrawon	aθrau̯ɔn
athref	aθrɛv
athrefi	aθrɛvɪ
athrefig	aθrɛvɪɡ
athro	aθrɔ
athrod	aθrɔd
athrodi	aθrɔdɪ
athrodion	aθrɔdjɔn
athrodus	aθrɔdɨ̞s
athrodwr	aθrɔdʊr
athrodwyr	aθrɔdwɨ̞r
ati	atɪ
ato	atɔ
atoch	atɔχ
atodiad	atɔdjad
atodiadau	atɔdjada
atodiadau	atɔdjadaɨ̯
atodiadau	atɔdjadɛ
atodlen	atɔdlɛn
atodol	atɔdɔl
atom	atɔm
atomig	atɔmɪɡ
aton	atɔn
atot	atɔt
atsain	atsai̯n
atseiniau	atsei̯nja
atseiniau	atsei̯njaɨ̯
atseiniau	atsei̯njɛ
atseinio	atsei̯njɔ
atyn	atɨ̞n
atynt	atɨ̞nt
aur	aɨ̯r
awch	au̯χ
awchau	au̯χa
awchau	au̯χaɨ̯
awchau	au̯χɛ
awchus	au̯χɨ̞s
awd	au̯d
awdl	au̯dl
awdur	au̯dɨ̞r
awdurdod	au̯dɨ̞rdɔd
awdurdodau	au̯dɨ̞rdɔda
awdurdodau	au̯dɨ̞rdɔdaɨ̯
awdurdodau	au̯dɨ̞rdɔdɛ
awdurol	au̯dɨ̞rɔl
awduron	au̯dɨ̞rɔn
aweddwr	au̯ɛðʊr
aweddyfroedd	au̯ɛðəvrɔɨ̯ð
awel	au̯ɛl
awelog	au̯eːlɔɡ
awelog	au̯ɛlɔɡ
awelon	au̯eːlɔn
awelon	au̯ɛlɔn
awen	au̯ɛn
awgrym	au̯ɡrɨ̞m
awgrymiad	au̯ɡrɨ̞mjad
awgrymiadau	au̯ɡrəmjada
awgrymiadau	au̯ɡrəmjadaɨ̯
awgrymiadau	au̯ɡrəmjadɛ
awgrymiadol	au̯ɡrəmjadɔl
awgrymog	au̯ɡrəmɔɡ
awgrymu	au̯ɡrəmɨ̞
awn	au̯n
awr	au̯r
awra	au̯ra
awtistiaeth	au̯tɪsdjaɨ̯θ
awtistiaeth	au̯tɪsdjɛθ
awtistig	au̯tɪsdɪɡ
awydd	au̯ɨ̞ð
awyddau	au̯əða
awyddau	au̯əðaɨ̯
awyddau	au̯əðɛ
awyddus	au̯əðɨ̞s
awyr	au̯ɨ̞r
awyren	au̯ərɛn
awyrennau	au̯ərɛna
awyrennau	au̯ərɛnaɨ̯
awyrennau	au̯ərɛnɛ
awyrgylch	au̯ərɡɨ̞lχ
awyrgylchoedd	au̯ərɡəlχɔɨ̯ð
bab	baːb
baban	baban
babanod	babanɔd
babell	babaɬ
babell	babɛɬ
babi	babɪ
babis	babɪs
babwnod	babʊnɔd
babŵn	babuːn
bac	bak
bach	baːχ
bachan	baχan
bachau	baχa
bachau	baχaɨ̯
bachgen	baχɡɛn
bachgennes	baχɡɛnɛs
bachgennyn	baχɡɛnɨ̞n
bachu	baχɨ̞
bachwr	baχʊr
bachwyr	baχwɨ̞r
bacio	bakjɔ
baciodd	bakjɔð
bacteria	baktɛrja
bacwn	bakʊn
bad	baːd
bae	baːɨ̯
baeau	beɨ̯a
baeau	beɨ̯aɨ̯
baeau	beɨ̯ɛ
baedd	baːɨ̯ð
baeddod	beɨ̯ðɔd
baeddu	baːɨ̯ðɨ̞
baen	baːɨ̯n
baent	baːɨ̯nt
baet	baːɨ̯t
bag	baɡ
bagiau	baɡja
bagiau	baɡjaɨ̯
bagiau	baɡjɛ
baglu	baɡlɨ
bagét	baɡɛt
bagéts	baɡɛts
bai	bai̯
baich	bai̯χ
baidd	bai̯ð
baith	bai̯θ
balaclafa	balaklava
balch	balχ
balchder	balχdar
balchder	balχdɛr
baled	balɛd
baledi	balɛdɪ
baledwr	balɛdʊr
baledwyr	balɛdwɨ̞r
balm	balm
bambŵ	bambuː
ban	ban
banadl	banadl
banadl	banal
banana	banana
bananas	bananas
banc	baŋk
banciau	baŋkja
banciau	baŋkjaɨ̯
banciau	baŋkjɛ
bancio	baŋkjɔ
bancio	baŋkɔ
band	band
bandiau	bandja
bandiau	bandjaɨ̯
bandiau	bandjɛ
baned	banad
baned	banɛd
baner	banɛr
baneri	banɛrɪ
bangeibr	baŋɡei̯br
bangeibrau	baŋɡei̯bra
bangeibrau	baŋɡei̯braɨ̯
bangeibrau	baŋɡei̯brɛ
banjo	band͡ʒɔ
banjos	band͡ʒɔs
banllawr	banɬau̯r
banlloriau	banɬɔrja
banlloriau	banɬɔrjaɨ̯
banlloriau	banɬɔrjɛ
bannau	bana
bannau	banaɨ̯
bannau	banɛ
bannod	banɔd
bant	bant
banw	banʊ
bapur	bapɨ̞r
bara	bara
baratoi	baratɔi̯
baratôdd	baratoːð
barbeciw	barbɛkɪu̯
barbeciwiau	barbɛkɪu̯ja
barbeciwiau	barbɛkɪu̯jaɨ̯
barbeciwiau	barbɛkɪu̯jɛ
barbeciwio	barbɛkɪu̯jɔ
barbeciws	barbɛkɪu̯s
barc	bark
barch	barχ
barcio	barkjɔ
barcio	barkɔ
barcud	barkɨ̞d
barcutiaid	barkɨ̞tjai̯d
barcutiaid	barkɨ̞tjɛd
bardd	barð
barddas	barðas
barddoniaeth	barðɔnjaɨ̯θ
barf	barv
barfau	barva
barfau	barvaɨ̯
barfau	barvɛ
barfog	barvɔɡ
bargeinio	barɡei̯njɔ
bargeinion	barɡei̯njɔn
bargen	barɡɛn
barhau	barhaɨ̯
bariwm	barjʊm
barlys	barlɨ̞s
barn	barn
barnau	barna
barnau	barnaɨ̯
barnau	barnɛ
barnu	barnɨ̞
barnwr	barnʊr
barnwyr	barnwɨ̞r
barod	barɔd
barotach	barɔtaχ
baroted	barɔtɛd
barrug	barɨ̞ɡ
barti	bartɪ
bartner	bartnar
bartner	bartnɛr
bartïon	bartiːɔn
barus	barɨ̞s
bas	baːs
basau	basa
basau	basaɨ̯
basau	basɛ
basbort	basbɔrt
basech	basɛχ
basen	basan
basen	basɛn
basen	bəsan
basen	bəsɛn
basen	san
basen	sɛn
baset	basɛt
basgad	basɡad
basged	basɡad
basged	basɡɛd
basgedi	basɡɛdɪ
basgrwth	baskrʊθ
basgrwth	basɡrʊθ
basgrythau	basɡrəθa
basgrythau	basɡrəθaɨ̯
basgrythau	basɡrəθɛ
basio	baʃɔ
basta	basda
bastai	basdai̯
baswn	basʊn
baswnau	basʊna
baswnau	basʊnaɨ̯
baswnau	basʊnɛ
basynnau	basəna
basynnau	basənaɨ̯
basynnau	basənɛ
basŵn	basuːn
bath	baːθ
bathau	baθa
bathau	baθaɨ̯
bathau	baθɛ
bathawd	baθau̯d
bathdai	baθdai̯
bathdy	baθdɨ̞
bathodyn	baθɔdɨ̞n
baths	baθs
bathu	baːθɨ̞
baw	baːu̯
bawb	bau̯b
bawd	bau̯d
bawdd	bau̯ð
bawn	bau̯n
be'	beː
be'	bɛ
bechan	bɛχan
bechgyn	bɛχɡɨ̞n
becso	bɛksɔ
becws	bɛkʊs
becyn	bɛkɨ̞n
bedair	bɛdai̯r
bedair	bɛdɛr
bedd	beːð
bedol	bɛdɔl
bedrannu	bɛdranɨ̞
bedw	bɛdʊ
bedwar	bɛdwar
bedwen	bɛdwan
bedwen	bɛdwɛn
bedwos	bɛdwɔs
bedydd	bɛdɨ̞ð
bei	bei
beiau	bei̯a
beiau	bei̯aɨ̯
beiau	bei̯ɛ
beic	bei̯k
beichiau	bei̯χja
beichiau	bei̯χjaɨ̯
beichiau	bei̯χjɛ
beichiog	bei̯χjɔɡ
beichiogi	bei̯χjɔɡɪ
beichiogrwydd	bei̯χjɔɡrʊɨ̯ð
beiciau	bei̯kja
beiciau	bei̯kjaɨ̯
beiciau	bei̯kjɛ
beicio	bei̯kjɔ
beicio	bei̯kɔ
beiddgar	bei̯ðɡar
beiddio	beiðjɔ
beidio	beidjɔ
beidr	bei̯dr
beidri	bei̯dri
beint	bei̯nt
beirdd	bei̯rð
beiriannwr	bei̯rjanʊr
beiriannwyr	beɨ̯rjanwɨ̞r
beiriannydd	beɨ̯rjanɨ̞ð
beirniad	bei̯rnjad
beirniadaeth	bei̯rnjadaɨ̯θ
beirniadaeth	bei̯rnjadɛθ
beirniadaethau	bei̯rnjadeɨ̯θa
beirniadaethau	bei̯rnjadeɨ̯θaɨ̯
beirniadaethau	bei̯rnjadeɨ̯θɛ
beirniadol	bei̯rnjadɔl
beirniadu	bei̯rnjadɨ̞
beirniaid	bei̯rnjai̯d
beirniaid	bei̯rnjɛd
beis	beis
bell	bɛɬ
bellach	bɛɬaχ
bellter	bɛɬdɛr
ben	bɛn
bencampwr	bɛŋkampʊr
bencampwriaeth	bɛŋkampʊrjaɨ̯θ
bencampwriaeth	bɛŋkampʊrjɛθ
bencampwriaethau	bɛŋkampʊrjeɨ̯θa
bencampwriaethau	bɛŋkampʊrjeɨ̯θaɨ̯
bencampwriaethau	bɛŋkampʊrjeɨ̯θɛ
bencampwyr	bɛŋkampwɨ̞r
bendant	bɛndant
benderfynu	bɛndɛrvənɨ̞
bendigaid	bɛndɪɡai̯d
bendigaid	bɛndɪɡɛd
bendigedig	bɛndɪɡɛdɪɡ
bendigo	bɛndɪɡɔ
bendith	bɛndɪθ
bendithio	bɛndɪθjɔ
benglog	bɛŋɡlɔɡ
bengwin	bɛŋɡwɪn
bengwiniaid	bɛŋɡwɪnjai̯d
bengwiniaid	bɛŋɡwɪnjɛd
benthyciad	bɛnθəkjad
benthycion	bɛnθəkjɔn
benthyg	bɛnθɨ̞ɡ
benyw	bɛnɨ̞u̯
benywaidd	bɛnəu̯ai̯ð
benywaidd	bɛnəu̯ɛð
benywod	bɛnəu̯ɔd
ber	bɛr
berceliwm	bɛrkɛljʊm
berchennog	bɛrχɛnɔɡ
berem	bɛrɛm
berf	bɛrv
berfau	bɛrva
berfau	bɛrvaɨ̯
berfau	bɛrvɛ
berfenw	bɛrvɛnʊ
berfenwau	bɛrvɛnwa
berfenwau	bɛrvɛnwaɨ̯
berfenwau	bɛrvɛnwɛ
berl	bɛrl
berlau	bɛrla
berlau	bɛrlaɨ̯
berlau	bɛrlɛ
berllan	bɛrɬan
berth	bɛrθ
berthnasau	bɛrθnasa
berthnasau	bɛrθnasaɨ̯
berthnasau	bɛrθnasɛ
berthynas	bɛrθənas
berw	bɛrʊ
berwbwynt	bɛrwbʊɨ̯nt
berwi	bɛrwi
beryglus	bɛrəɡlɨ̞s
beryliwm	bɛrɨ̞ljʊm
beswch	bɛsʊχ
beth	beːθ
bethau	bɛθa
bethau	bɛθaɨ̯
bethau	bɛθɛ
betroliwm	bɛtrɔljʊm
betws	bɛtʊs
betysau	bɛtəsa
betysau	bɛtəsaɨ̯
betysau	bɛtəsɛ
beudai	beɨ̯daɨ̯
beudy	beɨ̯dɨ̞
beunydd	beɨ̯nɨ̞ð
beunyddiol	beɨ̯nəðjɔl
bi	biː
biau	biːa
biau	biːaɨ̯
biau	biːɛ
bib	biːb
bibau	bɪba
bibau	bɪbaɨ̯
bibau	bɪbɛ
bibgorn	bɪbɡɔrn
bid	biːd
big	biːɡ
bigan	bɪɡan
bigau	bɪɡa
bigau	bɪɡaɨ̯
bigau	bɪɡɛ
bigddu	bɨ̞ɡðɨ̞
bigfelyn	bɨ̞ɡvɛlɨ̞n
bigwrn	bɪɡʊrn
bigyn	bɪɡɨ̞n
bigynnau	bɪɡəna
bigynnau	bɪɡənaɨ̯
bigynnau	bɪɡənɛ
bil	bɪl
bila	bɪla
bilaon	bɪlaːɔn
bildar	bɪldar
bildars	bɪldars
biliau	bɪlja
biliau	bɪljaɨ̯
biliau	bɪljɛ
biliwn	bɪljʊn
bin	biːn
bin	bɪn
binc	bɪŋk
bincod	bɪŋkɔd
biniau	bɪnja
biniau	bɪnjaɨ̯
biniau	bɪnjɛ
bioddiraddadwy	bioðɪraðadʊɨ̯
bioddiraddiadwy	biɔðɪraðjadʊɨ̯
bioddiraddiadwy	bjɔðɪraðjadʊɨ̯
bioddiraddio	bɪɔðɪraðjɔ
bioleg	bɪɔlɛɡ
biolegol	bɪɔlɛɡɔl
biolegwyr	bɪɔlɛɡwɨ̞r
biolegydd	bɪɔlɛɡɨ̞ð
bipa	bɪpa
bipes	bɪpɛs
bipi	bɪpi
bipo	bɪpɔ
bisged	bɪsɡad
bisged	bɪsɡɛd
bisgedi	bɪskedi
bismwth	bɪsmʊθ
biti	bɪtɪ
biwi	bɪu̯ɪ
biws	bɪu̯s
biwïaid	bɪu̯iːai̯d
biwïaid	bɪu̯iːɛd
bla	blaː
blacmêl	blakmeːl
bladur	bladɨ̞r
blaen	blaːɨ̯n
blaenau	bleɨ̯na
blaenau	bleɨ̯naɨ̯
blaenau	bleɨ̯nɛ
blaenor	bleɨ̯nɔr
blaenori	bleɨ̯nɔrɪ
blaenoriaeth	bleɨ̯nɔrjaɨ̯θ
blaenoriaeth	bleɨ̯nɔrjɛθ
blaenoriaethau	bleɨ̯nɔrjeɨ̯θa
blaenoriaethau	bleɨ̯nɔrjeɨ̯θaɨ̯
blaenoriaethau	bleɨ̯nɔrjeɨ̯θɛ
blaenoriaid	bleɨ̯nɔrjai̯d
blaenoriaid	bleɨ̯nɔrjɛd
blaenorol	bleɨ̯nɔrɔl
blaenyrru	bleɨ̯nərɨ̞
blagur	blaɡɨ̞r
blaguriad	blaɡɨ̞rjad
blaguro	blaɡɨ̞rɔ
blaid	blai̯d
blaidd	blai̯ð
blanced	blaŋkad
blanced	blaŋkɛd
blancedi	blaŋkɛdɪ
blaned	blanɛd
blas	blaːs
blasau	blasa
blasau	blasaɨ̯
blasau	blasɛ
blasu	blasɨ
blasus	blasɨ̞s
blawd	blau̯d
blawr	blau̯r
ble	bleː
bleiddiaid	blei̯ðjai̯d
bleiddiaid	blei̯ðjɛd
bleiddiau	blei̯ðja
bleiddiau	blei̯ðjaɨ̯
bleiddiau	blei̯ðjɛ
bleidiol	blei̯djɔl
bleidleisio	blei̯dlei̯ʃɔ
blentynnaidd	blɛntənai̯ð
blew	bleːu̯
blewog	blɛu̯ɔɡ
blewyn	blɛu̯ɨ̞n
blin	bliːn
blinder	blɪndar
blinder	blɪndɛr
blinderog	blɪndɛrɔɡ
blinedig	blɪnɛdɪɡ
blingo	blɪŋɔ
blino	blɪnɔ
blith	bliːθ
blodau	blɔda
blodau	blɔdaɨ̯
blodau	blɔdɛ
blodeuad	blɔdeɨ̯ad
blodeuo	blɔdeɨ̯ɔ
blodeuyn	blɔdeɨ̯ɨ̞n
blodfresych	blɔdvrɛsɨ̞χ
blodfresychen	blɔdvrɛsəχan
blodfresychen	blɔdvrɛsəχɛn
blodyn	blɔdɨ̞n
blog	blɔɡ
blogiau	blɔɡja
blogiau	blɔɡjaɨ̯
blogiau	blɔɡjɛ
blogio	blɔɡjɔ
blogiwr	blɔɡjʊr
blogwyr	blɔɡwɨ̞r
bloneg	blɔnɛɡ
blorai	blɔrai̯
bloreion	blɔrei̯ɔn
blows	blou̯s
blowsys	blou̯sɨ̞s
blu	blɨː
blwch	bluːχ
blwydd	bluːɨ̯ð
blwyddi	blʊɨ̯ðɪ
blwyddyn	blʊɨ̯ðɨ̞n
blychau	bləχaɨ̯
blymio	bləmjɔ
blynedd	blənað
blynedd	blənɛð
blynyddoedd	blənəðɔɨ̯ð
blêr	bleːr
bob	boːb
bobl	bɔbl
bobl	bɔbɔl
bobloedd	bɔblɔɨ̯ð
boch	boːχ
bochdew	bɔχdɛu̯
bochgoch	bɔχɡɔχ
bochlwyd	bɔχlʊɨ̯d
bocs	bɔks
bocsio	bɔkʃɔ
bocsiwr	bɔkʃʊr
bocswyr	bɔkswɨ̞r
bod	boːd
bodd	boːð
boddi	bɔði
bodiau	bɔdja
bodiau	bɔdjaɨ̯
bodiau	bɔdjɛ
bodlon	bɔdlɔn
bodoli	bɔdɔlɪ
boed	boːɨ̯d
boenen	bɔɨ̯nɛn
boeni	bɔɨ̯nɨ
boeth	boːɨ̯θ
boethach	bɔi̯θaχ
bogail	bɔɡai̯l
bohriwm	bɔrjʊm
boi	bɔi̯
bol	bɔl
bola	bɔla
bonclust	bɔŋklɨ̞sd
bonclustiad	bɔŋklɨ̞sdjad
bonclustio	bɔŋklɨ̞sdjɔ
boncyff	bɔŋkɨ̞f
bondigrybwyll	bɔndɪɡrəbʊɨ̯ɬ
boneddiges	bɔnɛðɪɡɛs
boneddigesau	bɔnɛðɪɡɛsa
boneddigesau	bɔnɛðɪɡɛsaɨ̯
boneddigesau	bɔnɛðɪɡɛsɛ
boneddigion	bɔnɛðɪɡjɔn
bongorff	bɔŋɡɔrf
bonheddig	bɔnhɛðɪɡ
bontinog	bɔntɪnɔɡ
bop	bɔp
boptai	bɔptai̯
bopty	bɔptɨ
bord	bɔrd
bordydd	bɔrdɨ̞ð
bore	bɔra
bore	bɔrɛ
boron	bɔrɔn
bosib	bɔsɪb
botel	bɔtal
botel	bɔtɛl
both	boːθ
bothau	bɔθa
bothau	bɔθaɨ̯
bothau	bɔθɛ
bowlio	bɔu̯ljɔ
brad	braːd
bradu	bradɨ̞
braen	braːɨ̯n
braenu	brei̯ni
braenu	breɨ̯nɨ̞
braf	braːv
brag	braːɡ
bragur	braɡɨ̞r
braich	brai̯χ
brain	brai̯n
braint	brai̯nt
braith	brai̯θ
bras	braːs
braster	brasdɛr
brasterog	brasdɛrɔɡ
brat	brat
brath	braːθ
brathu	braθɨ̞
brau	braɨ̯
braw	braːu̯
brawd	brau̯d
brawddeg	brau̯ðɛɡ
brawiau	brau̯ja
brawiau	brau̯jaɨ̯
brawiau	brau̯jɛ
brawychdod	brau̯əχdɔd
brawychiad	brau̯əχjad
brawychiadau	brau̯əχjada
brawychiadau	brau̯əχjadaɨ̯
brawychiadau	brau̯əχjadɛ
brawychiaeth	brau̯əχjaɨ̯θ
brawychiaeth	brau̯əχjɛθ
brawychus	brau̯əχɨ̞s
brawychwr	brau̯əχʊr
brawychwyr	brau̯əχwɨ̞r
brech	breːχ
brechdan	brɛχdan
brechlyn	brɛχɬɨ̞n
brecwast	brɛkwast
bref	breːv
brefu	brɛvɨ̞
breichiau	brei̯χja
breichiau	brei̯χjaɨ̯
breichiau	brei̯χjɛ
breifat	brei̯vat
breinlen	brei̯nlɛn
brenhines	brɛnhɪnas
brenhines	brɛnhɪnɛs
brenhinoedd	brɛnhɪnɔɨ̯ð
brenhinol	brɛnhɪnɔl
brenin	brɛnɪn
breninesau	brɛnɪnɛsa
breninesau	brɛnɪnɛsaɨ̯
breninesau	brɛnɪnɛsɛ
brest	brɛsd
breswyl	brɛsʊɨ̯l
bresych	brɛsɨ̞χ
bresychen	brɛsəχan
bresychen	brɛsəχɛn
brethyn	brɛθɨ̞n
breuan	breɨ̯an
breuddwyd	breɨ̯ðʊɨ̯d
breuddwydio	breɨ̯ðʊɨ̯djɔ
breuddwydion	breɨ̯ðʊɨ̯djɔn
breuwydd	brɛɨ̯wɨ̞ð
bri	briː
briallen	brjaɬɛn
briallen	brɪaɬɛn
briallu	brjaɬɨ̞
briallu	brɪaɬɨ̞
bric	brɪk
briciau	brikja
briciau	brikjaɨ̯
briciau	brikjɛ
brics	brɪks
bricsen	brɪksan
bricsen	brɪksɛn
bricyll	brɪkɨ̞ɬ
bricyllen	brɪkəɬɛn
brid	briːd
bridge	brɪd͡ʒ
brif	briːv
brifddinas	briːvðɪnas
brifddinas	brɪvðɪnas
brifo	brɪvɔ
brig	briːɡ
briger	brɪɡar
briger	brɪɡɛr
brigerog	brɪɡɛrɔɡ
brigâd	briɡaːd
briod	briɔd
briodas	brjɔdas
briodas	brɪɔdas
briodi	briɔdi
bris	briːs
bris	briːʃ
brith	briːθ
brithddu	brɪθðɨ̞
brithion	brɪθjɔn
briw	brɪu̯
briweg	brɪu̯aɡ
bro	broː
broblem	brɔblam
broblem	brɔblɛm
broblemau	brɔblɛma
broblemau	brɔblɛmaɨ̯
broblemau	brɔblɛmɛ
broc	brɔk
broch	broːχ
brochell	brɔχɛɬ
brochion	brɔχjɔn
brochod	brɔχɔd
brodyr	brɔdɨ̞r
broga	brɔɡa
bromid	brɔmɪd
bromin	brɔmɪn
bron	brɔn
brongoch	brɔŋɡɔχ
bronlas	brɔnlas
bronleision	brɔnlei̯ʃɔn
bronnau	brɔna
bronnau	brɔnaɨ̯
bronrhuddyn	brɔnr̥ɨ̞ðɨ̞n
bronwen	brɔnwɛn
bronwyn	brɔnwɨ̞n
brotest	brɔtɛst
brown	brou̯n
brwd	bruːd
brwdfrydedd	brʊdvrədað
brwdfrydedd	brʊdvrədɛð
brwmstan	brʊmsdan
brwnt	brʊnt
brws	brʊʃ
brwsh	brʊʃ
brwshys	brʊʃɨ̞s
brwsiau	brʊʃa
brwsiau	brʊʃaɨ̯
brwsiau	brʊʃɛ
brwsio	brʊʃɔ
brwsioch	brʊʃɔχ
brwsiodd	brʊʃɔð
brwsion	brʊʃɔn
brwsys	brʊʃɨ̞s
brwydr	brʊɨ̯dr
brwydrau	brʊɨ̯dra
brwydrau	brʊɨ̯draɨ̯
brwydrau	brʊɨ̯drɛ
brwydro	brʊɨ̯drɔ
brwydrwr	brʊɨ̯drʊr
brwydrwyr	brʊɨ̯drwɨ̞r
brwyn	bruːɨ̯n
brwyna	brʊɨ̯na
brwynen	brʊɨ̯nan
brwynen	brʊɨ̯nɛn
brwysg	bruːɨ̯sɡ
brych	brɨːχ
bryd	brɨːd
brydferth	brədvɛθ
bryf	brɨːv
bryfed	brəvad
bryfed	brəvɛd
bryn	brɨ̞n
bryna	brəna
bryngaer	brəŋɡaɨ̯r
bryngaer	brɨ̞ŋɡaɨ̯r
bryniau	brənja
bryniau	brənjaɨ̯
bryniau	brənjɛ
brynoch	brənɔχ
brynodd	brənɔð
brynon	brənɔð
brynu	brənɨ
bryoffyt	brɨːɔfɨ̞t
brys	brɨːs
brysio	brəʃɔ
brysur	brəsɨ̞r
brân	braːn
brëyr	breːɨ̞r
bu	bɨː
buail	bɨai̯l
bual	bɨ̞al
buan	bɨːan
buarth	bɨːarθ
budd	bɨːð
buddai	bɨ̞ðai̯
buddion	bɨ̞ðjɔn
buddsoddi	bɨ̞ðsɔðɪ
buddug	bɨ̞ðɨ̞ɡ
buddugol	bɨ̞ðɨ̞ɡɔl
buddugoliaeth	bɨ̞ðɨ̞ɡɔljaɨ̯θ
buddugoliaeth	bɨ̞ðɨ̞ɡɔljɛθ
buddugwr	bɨ̞ðɨ̞ɡʊr
buddugwyr	bɨ̞ðɨ̞ɡwɨ̞r
budr	bɨ̞dɨ̞r
bues	bɨɛs
buest	bɨːɛst
bugail	bɪɡai̯l
bugail	bɪɡɛl
bum	bɨ̞m
bumdegau	bɨ̞mdɛɡa
bunnau	bɨ̞na
bunnau	bɨ̞naɨ̯
bunnau	bɨ̞nɛ
bunt	bɨ̞nt
buoch	bɨɔχ
buodd	bɨɔð
buon	bɨɔn
bur	bɨːr
busnes	bɨ̞snas
busnes	bɨ̞snɛs
buwch	bɨ̞u̯χ
bwa	buːa
bwced	bʊkad
bwced	bʊkɛd
bwch	buːχ
bwci	bʊkɪ
bwffe	bʊfɛ
bwgan	bʊɡan
bwl	bʊl
bwlch	bʊlχ
bwletin	bʊlɛtɪn
bwletinau	bʊlɛtɪna
bwletinau	bʊlɛtɪnaɨ̯
bwletinau	bʊlɛtɪnɛ
bwmpen	bʊmpan
bwmpen	bʊmpɛn
bwn	bʊn
bwrdd	bʊrð
bwriadol	bʊrjadɔl
bwriadu	bʊrjadɨ̞
bwrlwm	bʊrlʊm
bwrw	bʊrʊ
bws	bʊs
bwth	buːθ
bwthyn	bʊθɨ̞n
bwyd	buːɨ̯d
bwydlen	bʊɨ̯dlɛn
bwydo	bʊɨ̯dɔ
bwydwch	bʊɨ̯dʊχ
bwydydd	bʊɨ̯dɨ̞ð
bwyeill	bʊɨ̯ei̯ɬ
bwyell	bʊɨ̯aɬ
bwyell	bʊɨ̯ɛɬ
bwyelli	bʊɨ̯ɛɬɪ
bwyll	buːɨ̯ɬ
bwys	buːɨ̯s
bwysig	bʊɨ̯sɪɡ
bwyst	bʊɨ̯sd
bwyta	bəta
bwyta	bʊɨ̯ta
bwytadwy	bʊɨ̯tadʊɨ̯
bwytais	buɨ̯tai̯s
bwytais	bətɛs
bwytaist	buɨ̯tai̯sd
bwytaist	bətɛsd
bwytoch	bətɔχ
bwytoch	bʊɨ̯tɔχ
bwytodd	bətɔð
bwytodd	bʊɨ̯tɔð
bwyton	bətɔn
bwyton	bʊɨ̯tɔn
bwytwch	bʊɨ̯tʊχ
bwyty	bʊɨ̯tɨ̞
bychain	bəχai̯n
bychain	bəχɛn
bychan	bəχan
bychod	bəχɔd
byd	bɨːd
bydd	bɨːð
bydda	bəða
byddai	bəða
byddai	bəðai̯
byddai	bəðɛ
byddan	bəðan
byddar	bəðar
byddarol	bəðarɔl
byddaru	bəðarɨ̞
bydded	bəðdɛd
byddi	bəðɪ
byddin	bəðɪn
byddwch	bəðʊχ
byddwn	bəðʊn
bydysawd	bədəsau̯d
bylchog	bəlχɔɡ
byliau	bəlja
byliau	bəljaɨ̯
byliau	bəljɛ
byngalo	bəŋɡalɔ
bynnag	bənaɡ
bynnen	bənɛn
byns	bəns
bynsen	bənsan
bynsen	bənsɛn
byr	bɨ̞r
byrddau	bərða
byrddau	bərðaɨ̯
byrddau	bərðɛ
byrddydd	bərðɨ̞ð
byrdra	bərdra
byrhoedlog	bɨ̞rhoːɨ̯dlɔɡ
byrlymau	bərləmaɨ̯
byrlymu	bərləmɨ̞
byrraf	bərav
bys	bɨːs
bysbrint	bəsbrɪnt
bysedd	bəsað
bysedd	bəsɛð
bysell	bəsɛɬ
bysellfwrdd	bəsɛɬvʊrð
bysgod	bəsɡɔd
bysgodyn	bəsɡɔdɨ̯n
bysgota	bəsɡɔta
bysys	bəsɨ̞s
byth	bɨːθ
byth	bɨ̞θ
bythynnod	bəθənɔd
byw	bɨ̞u̯
byw	bɪu̯
bywgraffiadur	bɨu̯ɡrafjadɨ̞r
bywgraffiadur	bɪu̯ɡrafjadɨ̞r
bywiocáu	bɨ̞u̯jɔkaɨ̯
bywiog	bɨ̞u̯jɔɡ
bywiogrwydd	bɨ̞u̯jɔɡrʊɨ̯ð
bywyd	bəu̯ɨ̞d
bywydeg	bəu̯ədɛɡ
bàth	baθ
bêl	beːl
bêr	beːr
bòs	bɔs
bôm	boːm
bôn	boːn
bônt	boːnt
bûm	bɨːm
bŵt	buːt
ca	kaː
cacen	kakan
cacen	kakɛn
cacennau	kakɛna
cacennau	kakɛnaɨ̯
cacennau	kakɛnɛ
cach	kaːχ
cacha	kaχa
cachai	kaχai̯
cachai	kaχɛ
cachais	kaχai̯s
cachais	kaχɛs
cachan	kaχan
cachen	kaχɛn
caches	kaχɛs
cachet	kaχɛt
cachgi	kaχɡɪ
cachgwn	kaχɡʊn
cachi	kaχɪ
cachlwyth	kaχlʊɨ̯θ
cachu	kaχɨ̞
cacs	kaks
cactws	kaktʊs
cacwn	kakʊn
cacynen	kakənan
cacynen	kakənɛn
cad	kaːd
cadach	kadaχ
cadair	kadai̯r
cadair	kadar
cadair	kadɛr
cadarn	kadarn
cadarnhaol	kadarnhau̯ɔl
cadarnhaol	kadarnhaːɔl
cadarnhau	kadarnhaɨ̯
cadarnwedd	kadarnwɛð
cadd	kaːð
cadeiriau	kadei̯rja
cadeiriau	kadei̯rjaɨ̯
cadeiriau	kadei̯rjɛ
cadeirio	kadeɪ̯rjɔ
cadeiriol	kadei̯rjɔl
cadeirlan	kadei̯rlan
cader	kadɛr
cader	kaːdɛr
cadernid	kadɛrnɪd
cadlas	kadlas
cadmiwm	kadmjʊm
cadnawes	kadnau̯ɛs
cadno	kadnɔ
cadnöes	kadnoːɛs
cadw	kadʊ
cadwch	kadʊχ
cadwyn	kadʊɨ̯n
cae	kaːɨ̯
caeaf	keɨ̯a
caeaf	keɨ̯av
caeau	keɨ̯a
caeau	keɨ̯aɨ̯
caeau	keɨ̯ɛ
caed	kaːɨ̯d
caeir	keɨ̯ɪr
cael	kaːl
cael	kaːɨ̯l
caem	kaːɨ̯m
caen	kaːɨ̯n
caer	kaːɨ̯r
caerau	keɨ̯ra
caerau	keɨ̯raɨ̯
caerau	keɨ̯rɛ
caeriwrch	keɨ̯rjʊrχ
caeth	kaːɨ̯θ
caeth	kaːθ
caethiwed	keɨθɪu̯ɛd
caethiwo	keɨθɪu̯ɔ
caethoch	keɨ̯θɔχ
caethon	keɨ̯θɔn
caethwas	keɨ̯θwas
caethwasiaeth	keɨ̯θwaʃaɨ̯θ
caethwasiaeth	keɨ̯θwaʃɛθ
caethweision	keɨ̯θwei̯ʃɔn
caf	kaː
caf	kaːv
cafas	kavas
caffai	kafai̯
caffed	kafɛd
caffel	kafɛl
caffent	kafɛnt
caffer	kafɛr
caffi	kafɪ
caffis	kafɪs
caffîn	kafiːn
cafiar	kavjar
cafiâr	kavjaːr
cafod	kavɔd
cafodd	kavɔð
cafon	kavɔn
cafwyd	kavʊɨ̯d
caifn	kai̯vn
caill	kai̯ɬ
cain	kai̯n
cais	kai̯s
cait	kai̯t
cala	kala
calan	kalan
calch	kalχ
calchfaen	kalχvaɨ̯n
caled	kalad
caled	kalɛd
caledu	kalɛdɨ̞
caledwedd	kalɛdwɛð
calenigion	kalɛnɪɡjɔn
caleted	kalɛtɛd
califforniwm	kalɪfɔrnjʊm
call	kaɬ
callestr	kaɬasd
callestr	kaɬɛsd
callestr	kaɬɛsdr
callio	kaɬjɔ
calon	kalɔn
calonnau	kalɔna
calonnau	kalɔnaɨ̯
calonnau	kalɔnɛ
calsiwm	kalsjʊm
cam	kam
camau	kama
camau	kamaɨ̯
camau	kamɛ
camddealltwriaeth	kamðɛaɬdʊrjaɨ̯θ
camddealltwriaeth	kamðɛaɬdʊrjaθ
camddealltwriaeth	kamðɛaɬdʊrjɛθ
camdreiglad	kamdrei̯ɡlad
camdreiglo	kamdrei̯ɡlɔ
camesgor	kamɛsɡɔr
camesgoriad	kamɛsɡɔrjad
camfa	kamva
camgymeriad	kamɡəmɛrjad
camlas	kamlas
camlesi	kamlɛsɪ
camlwrw	kamlʊrʊ
camp	kamp
campfa	kampva
campus	kampɨ̞s
campwaith	kampwai̯θ
campwr	kampʊr
camsefyll	kamsɛvɨ̞ɬ
camu	kamɨ̞
camwedd	kamwɛð
camweinyddu	kamwei̯nəðɨː
can	kan
cana	kana
canaf	kanav
canai	kanai̯
canai	kanɛ
canais	kanai̯s
canais	kanɛs
canais	kanɛʃ
canais	kanɪʃ
canant	kanant
canem	kanɛm
canen	kanɛn
canent	kanɛnt
caner	kanɛr
canes	kanɛs
canet	kanɛt
caneuon	kaneɨ̯ɔn
canfed	kanvɛd
canfod	kanvɔd
canfodydd	kanvɔdɨ̞ð
canfodyddion	kanvɔdəðjɔn
canfyddadwy	kanvəðadʊɨ̯
canfyddiad	kanvəðjad
cangarŵ	kaŋɡaruː
cangarŵod	kaŋɡaruːɔd
cangen	kaŋan
cangen	kaŋɛn
canghellor	kaŋhɛɬɔr
canghennau	kaŋhɛna
canghennau	kaŋhɛnaɨ̯
canghennau	kaŋhɛnɛ
canghennog	kaŋhɛnɔɡ
canhwyllau	kanhʊi̯ɬa
canhwyllau	kanhʊi̯ɬɛ
canhwyllau	kanhʊɨ̯ɬaɨ̯
canhwyllbren	kanhʊɨ̯ɬbrɛn
cani	kanɪ
caniatáu	kanjataɨ̯
caniatâd	kanjataːd
caniau	kanja
caniau	kanjaɨ̯
caniau	kanjɛ
canit	kanɪt
canlyn	kanlɨ̞n
canlyniad	kanlənjad
canlyniadau	kanlənjada
canlyniadau	kanlənjadaɨ̯
canlyniadau	kanlənjadɛ
canlynol	kanlənɔl
canmol	kanmɔl
canmoladwy	kanmɔladʊɨ̯
canmoliaeth	kanmɔljaɨ̯θ
canmoliaeth	kanmɔljɛθ
canmoliaethau	kanmɔljeɨ̯θa
canmoliaethau	kanmɔljeɨ̯θaɨ̯
canmoliaethau	kanmɔljeɨ̯θɛ
canmolwr	kanmɔlʊr
canmolwyr	kanmɔlwɨ̞r
cannaid	kanai̯d
cannu	kanɨ̞
cannwyll	kanʊɨ̯ɬ
cannydd	kanɨ̞ð
cano	kanɔ
canol	kanɔl
canolaf	kanɔlav
canolbarth	kanɔlbarθ
canolbarthau	kanɔlbarθa
canolbarthau	kanɔlbarθaɨ̯
canolbarthau	kanɔlbarθɛ
canolfan	kanɔlvan
canoli	kanɔli
canolig	kanɔlɪɡ
canolog	kanɔlɔɡ
canolradd	kanɔlrað
canolwr	kanɔlʊr
canolwyr	kanɔlwɨ̞r
canon	kanɔn
canrif	kanrɪv
cansai	kansai̯
cansai	kansɛ
cansen	kansɛn
canslo	kanslɔ
cant	kant
cantor	kantɔr
cantores	kantɔras
cantores	kantɔrɛs
cantorion	kantɔrjɔn
canu	kanɨ̞
canwr	kanʊr
canwraidd	kanwrai̯ð
canwyllbrennau	kanʊɨ̯ɬbrɛna
canwyllbrennau	kanʊɨ̯ɬbrɛnaɨ̯
canwyllbrennau	kanʊɨ̯ɬbrɛnɛ
canwyr	kanʊɨ̯r
canyddion	kanəðjɔn
capel	kapɛl
capten	kaptan
capten	kaptɛn
car	kar
cara	kara
carafannau	karavana
carafannau	karavanaɨ̯
carafannau	karavanɛ
carafán	karavan
carafáns	karavans
carai	karai̯
carai	karɛ
carais	karai̯s
carais	karɛs
carais	karɛʃ
carais	karɪʃ
caran	karan
carant	karant
carbon	karbɔn
carchar	karχar
carcharu	karχarɨ̞
carco	karkɔ
caren	karɛn
carent	karɛnt
cares	karɛs
carest	karɛsd
cari	karɪ
caridým	karɪdɨ̞m
cario	karjɔ
carneddau	karnɛðaɨ̯
caro	karɔ
carsi	karsi
cartre	kartra
cartre	kartrɛ
caru	karɨ̞
cas	kaːs
casach	kasaχ
castell	kasdaɬ
castell	kasdɛɬ
castelli	kasdɛɬɪ
casáu	kasaɨ̯
cath	kaːθ
cathau	kaθa
cathau	kaθaɨ̯
cathau	kaθɛ
cathbysgod	kaθbəsɡɔd
cathod	kaθɔd
cato	katɔ
cau	kaɨ̯
cawell	kawɛɬ
cawl	kau̯l
cawlach	kau̯laχ
cawn	kau̯n
cawna	kau̯na
cawod	kau̯ɔd
cawodi	kawɔdɪ
cawr	kau̯r
caws	kau̯s
cecraeth	kɛkraɨ̯θ
cefnddu	kɛvnðɨ̞
cefnfor	kɛvn̩vɔr
cefnog	kɛvnɔɡ
cefnwyrdd	kɛvnwɨ̞rð
cegid	kɛɡɪd
ceidwadol	kei̯dwadɔl
ceillgwd	keiɬɡʊd
celdy	kɛldɨ
celficyn	kɛlvɪkɨ̞n
cell	kɛɬ
celli	kɛɬɪ
celloedd	kɛɬɔɨ̯ð
cellog	kɛɬɔɡ
celwydd	kɛlwɨ̞ð
celynna	kɛləna
celynnen	kɛlənan
celynnen	kɛlənɛn
cemeg	kɛmɛɡ
cenhinen	kɛnhɪnan
cenhinen	kɛnhɪnɛn
ceni	kɛnɪ
cenna	kɛna
cennad	kɛnad
cennin	kɛnɪn
cennog	kɛnɔɡ
cerais	kɛrai̯s
cerbyd	kɛrbɨ̞d
cerddorfaol	kɛrðɔrvaːɔl
cerddorion	kɛrðɔrjɔn
cerddwr	kɛrðʊr
cerflun	kɛrvlɨ̞n
cerfluniau	kɛrvlɨ̞nja
cerfluniau	kɛrvlɨ̞njaɨ̯
cerwch	kɛrʊχ
cerwyn	kɛruɨ̯n
cesiwm	kɛsjʊm
ch'mod	χmɔd
chacen	χakan
chacen	χakɛn
chacha	χaχa
chachi	χaχɪ
chad	χaːd
chadair	χadai̯r
chadair	χadar
chadair	χadɛr
chadeiriau	χadei̯rja
chadeiriau	χadei̯rjaɨ̯
chadeiriau	χadei̯rjɛ
chae	χaːɨ̯
chael	χaːl
chael	χaːɨ̯l
chaen	χaːɨ̯n
chaeth	χaːɨ̯θ
chaethoch	χeɨ̯θɔχ
chaethon	χeɨ̯θɔn
chaf	χaː
chaf	χaːv
chafas	χavas
chaffi	χafi
chafodd	χavɔð
chain	χai̯n
chais	χai̯s
chalennig	χalɛnɪɡ
chaleted	χalɛtɛd
challio	χaɬjɔ
chalon	χalɔn
chamdreiglo	χamdrei̯ɡlɔ
chamlas	χamlas
chana	χana
chanfyddadwy	χanvəðadʊɨ̯
chanu	χanɨ̞
chanwr	χanʊr
char	χar
chara	χara
charafán	χaravan
charai	χarai̯
charai	χarɛ
charan	χaran
charcharu	χarχarɨ̞
chardinaliaid	χardɪnaljai̯d
chardinaliaid	χardɪnaljɛd
chared	χarɛd
charet	χarɛt
charo	χarɔ
charreg	χaraɡ
charreg	χarɛɡ
charthen	χarθan
charthen	χarθɛn
charu	χarɨ̞
charwr	χarʊr
chath	χaːθ
chato	χatɔ
chawl	χau̯l
chdi	χdiː
cherddoriaeth	χɛrðɔrjaɨ̯θ
cherddoriaeth	χɛrðɔrjɛθ
cheri	χɛrɪ
ches	χeːs
chest	χɛst
chestyll	χɛsdɨ̞ɬ
chewch	χɛu̯χ
chi	χiː
chladdu	χlaðɨ̞
chlwb	χlʊb
chlwyfo	χlʊɨ̯vɔ
chlybiau	χləbja
chlybiau	χləbjaɨ̯
chlybiau	χləbjɛ
chlyw	χlɨu̯
chlyw	χlɪu̯
chlywed	χləu̯ad
chlywed	χləu̯ɛd
chnau	χnaɨ̯
chnwd	χnuːd
chofio	χɔvjɔ
choginio	χɔɡɪnjɔ
chogyddesau	χɔɡəðɛsa
chogyddesau	χɔɡəðɛsaɨ̯
chogyddesau	χɔɡəðɛsɛ
chor	χɔr
chorff	χɔrf
choronafeirws	χɔrɔnavei̯rʊs
chrug	χrɨːɡ
chu	χɨː
chul	χɨːl
chusan	χɨ̞san
chut	χɨ̞t
chwaethus	χweɨ̯θɨ̞s
chwain	χwai̯n
chwalu	χwalɨ̞
chwannen	χwanɛn
chwannog	χwanɔɡ
chwaraeon	χwareɨ̯ɔn
chwaraewr	χwaɾeɨ̯ʊr
chwardd	χwarð
chwarenglwyf	χwarɛŋɡluːɨ̯v
chwarennol	χwarɛnɔl
chwech	χweːχ
chwedl	χwɛdl
chwenychu	χwɛnəχɨ
chwern	χwɛrn
chwerthin	χwɛrθɨ̞n
chwerw	χwɛru
chwery	χwɛrɨ
chwestiwn	kwɛsdjʊn
chwilen	χwɪlan
chwilen	χwɪlɛn
chwilod	χwɪlɔd
chwip	χwɪp
chwith	χwiːθ
chwiw	χwɪu̯
chwiwell	χwɪu̯ɛɬ
chwmni	χʊmni
chwpan	χʊpan
chwpwrdd	χʊpʊrð
chwrw	χʊru
chwyddiannau	χwəðjana
chwyddiannau	χwəðjanaɨ̯
chwyddiannau	χwəðjanɛ
chwyddiant	χwəðjant
chwyldro	χwɨ̞ldrɔ
chwys	χwɨːs
chwythu	χwəθɨ̞
chychwyn	χəχwɨ̞n
chydbreswylwyr	χɨːdbrɛsʊɨ̯lwɨ̞r
chyflym	χəvlɨ̞m
chymedrolwr	χəmɛdrɔlʊr
chymylog	χəməlɔɡ
chynffon	χənfɔn
chynhadledd	χənhadlɛð
chynnes	χənɛs
chynnwrf	χənʊrv
chyrliog	χərljɔɡ
chyrraedd	χərað
chyrraedd	χəraɨ̯ð
chyrraedd	χərɛð
chysgu	χəsɡɨ
chysgwch	χəsɡʊχ
chythraul	χəθral
chythraul	χəθraɨ̯l
chythraul	χəθrɛl
chân	χaːn
ci	kiː
cic	kɪk
cilbost	kɪlbɔst
cilbren	kɪlbrɛn
ciledrych	kɪlɛdrɨ̞χ
cilfach	kɪlvaχ
cilydd	kɪlɨ̞ð
cimwch	kɪmʊχ
cinio	kɪnjɔ
cipio	kɪpjɔ
ciwt	kɪu̯t
claddu	klaðɨ̞
clau	klaɨ̯
clawdd	klaːu̯ð
clawr	klau̯r
cledd	kleːð
cleddyf	klɛðɨ̞v
cledr	klɛdr
clefyd	klɛvɨ̞d
cleren	klɛrɛn
clicio	klɪkjɔ
clicio	klɪkɔ
cliff	kliːf
cliriad	klɪrjad
clirio	klɪrjɔ
clo	kloː
cloan	klɔan
cloc	klɔk
cloch	kloːχ
clod	kloːd
clodfawr	klɔdvau̯r
cloem	kloːɨ̯m
clof	kloːv
cloriau	klɔrja
cloriau	klɔrjaɨ̯
cloriau	klɔrjɛ
clorid	klɔrɪd
clust	klɨːsd
clwt	klʊt
clwyfo	klʊɨ̯vɔ
clwyfus	klʊɨ̯vɨ̞s
cly	klɨː
clybiau	kləbja
clybiau	kləbjaɨ̯
clybiau	kləbjɛ
clyw	klɨu̯
clyw	klɪu̯
clywed	kləwad
clywed	kləwɛd
clywedog	kləu̯ɛdɔɡ
clêr	kleːr
cnau	knaɨ̯
cnoi	knɔi̯
cnud	knɨːd
cnwc	knʊk
cnwd	knuːd
cnwp	knʊp
cobalt	kɔbalt
cobra	kɔbra
coch	koːχ
cochen	kɔχɛn
cochgam	kɔχɡam
cochi	kɔχi
cochion	kɔχjɔn
cochlas	kɔχlas
cochni	kɔχnɪ
cochwydd	kɔχwɨ̞ð
cocsa	kɔksa
codau	kɔda
codau	kɔdaɨ̯
codau	kɔdɛ
coden	kɔdɛn
codi	kɔdɪ
codoch	kɔdɔχ
cododd	kɔdɔð
codon	kɔdɔn
codwch	kɔdʊχ
coed	koːɨ̯d
coeden	kɔɨ̯dan
coeden	kɔɨ̯dɛn
coedredyn	kɔɨ̯drɛdɨ̞n
coeg	koːɨ̯ɡ
coel	koːɨ̯l
coelcerth	kɔɨ̯lkɛrθ
coesyn	kɔɨ̯sɨ̞n
cofair	kɔvai̯r
cofeb	kɔvɛb
cofiant	kɔvjant
cofnodion	kɔvnɔdjɔn
cofrestriad	kɔvrɛsdrjad
cofrestriadau	jada
cofrestriadau	kɔvrɛsdrjadaɨ̯
cofrestriadau	kɔvrɛsdrjadɛ
cofrestru	kɔvrɛsdrɨ̞
cofrestrydd	kɔvrɛsdrɨ̞ð
cofrestryddion	kɔvrɛsdrəðjɔn
cog	koːɡ
cogau	kɔɡa
cogau	kɔɡaɨ̯
cogau	kɔɡɛ
coginio	kɔɡɪnjɔ
coginioch	kɔɡɪnjɔχ
coginiodd	kɔɡɪnjɔð
coginion	kɔɡɪnjɔn
cogyddes	kɔɡəðas
cogyddes	kɔɡəðɛs
cogyddesau	kɔɡəðɛsa
cogyddesau	kɔɡəðɛsaɨ̯
cogyddesau	kɔɡəðɛsɛ
coleg	kɔlɛɡ
coll	kɔɬ
comiwnyddiaeth	kɔmɪu̯nəðjaɨ̯θ
comiwnyddiaeth	kɔmɪu̯nəðjɛθ
comiwnyddol	kɔmjʊnəðɔl
congl	kɔŋɡl
conglfaen	kɔŋlvaɨ̯n
cop	kɔp
copyn	kɔpɨ̞n
copïo	kɔpiːɔ
copïwr	kɔpiːʊr
cor	kɔr
corbennog	kɔrbɛnɔɡ
corbys	kɔrbɨ̞s
corff	kɔrf
corfflu	kɔrflɨ
corffor	kɔrfɔr
corn	kɔrn
cornel	kɔrnal
cornel	kɔrnɛl
corneli	kɔrnɛli
corniog	kɔrnjɔɡ
cornwyd	kɔrnuɨ̯d
coronafeirws	kɔrɔnavei̯rʊs
coronafeirysau	kɔrɔnavei̯rəsa
coronafeirysau	kɔrɔnavei̯rəsaɨ̯
coronafeirysau	kɔrɔnavei̯rəsɛ
coronafirws	kɔrɔnavɪrʊs
corrach	kɔraχ
corryn	kɔrɨ̞n
corun	kɔrɨ̞n
corwg	kɔrʊɡ
cosi	kɔsi
cost	koːsd
cot	kɔt
cotiau	kɔtja
cotiau	kɔtjaɨ̯
cotiau	kɔtjɛ
cowboi	kou̯bɔi̯
cowbois	kou̯bɔi̯s
crac	krak
craf	kraːv
craffter	kraftɛr
cragen	kraɡɛn
cras	kraːs
crasboeth	krasbɔɨ̯θ
crasfeydd	krasveɨ̯ð
cred	kreːd
credant	krɛdant
creder	krɛdɛr
credes	krɛdɛs
credet	krɛdɛt
credi	krɛdɪ
credyd	krɛdɨ̞d
credydau	krɛdəda
credydau	krɛdədaɨ̯
credydau	krɛdədɛ
crefydd	krɛvɨ̞ð
cregen	krɛɡɛn
cregyn	krɛɡɨ̞n
cregynna	krɛɡəna
creision	krei̯ʃɔn
crempog	krɛmpɔɡ
criced	krɪkɛd
crocodeilod	krɔkɔdei̯lɔd
croesair	krɔɨ̯sai̯r
croesfan	krɔɨ̯svan
croesffordd	krɔɨ̯sfɔrð
croesgad	krɔɨ̯sɡad
croeshoeliad	krɔɨ̯shɔɨ̯ljad
croeshoelio	krɔɨ̯shɔɨ̯ljɔ
croesholi	krɔɨ̯shɔlɪ
croesi	krɔɨ̯si
croesiad	krɔɨ̯ʃad
croeso	krɔɨ̯sɔ
croesryw	krɔi̯srɨ̞u̯
croesryw	krɔi̯srɪu̯
croestoriad	krɔɨ̯sdɔrjad
crog	kroːɡ
crogen	krɔɡɛn
croglen	krɔɡlɛn
cromad	krɔmad
cromen	krɔmɛn
cromfach	krɔmvaχ
cronfa	krɔnva
croth	kroːθ
crwys	kruːɨ̯s
cryched	krəχɛd
crychiad	krəχjad
cryddiaeth	krəðjaɨ̯θ
cryddiaeth	krəðjɛθ
cryddion	krəðjɔn
cryf	krɨː
cryf	krɨːv
cryg	krɨːɡ
cryndod	krəndɔd
crynhoad	krənhɔad
crynhoi	krən̥hɔi̯
crynoddisg	krənoðɪsɡ
crynu	krənɨ̞
crypton	krɨ̞ptɔn
crŷn	krɨːn
cu	kɨː
cuddio	kɪðjɔ
cudyn	kɨ̞dɨ̞n
culddail	kɨ̞lðai̯l
culdiroedd	kɨ̞ldɪrɔɨ̯ð
culed	kɨ̞lɛd
culion	kɨ̞ljɔn
cur	kɨ̞r
curiwm	kɪu̯rjʊm
curo	kɨ̞rɔ
cusan	kɨ̞san
cusanau	kɨ̞sana
cusanau	kɨ̞sanaɨ̯
cusanau	kɨ̞sanɛ
cusanu	kɨ̞sanɨ
cut	kɨ̞t
cwar	kwar
cwb	kʊb
cwbl	kʊbl
cwbl	kʊbʊl
cwblhau	kʊblhaɨ̯
cwcabyra	kʊkabəra
cwcer	kʊkɛr
cwch	kʊχ
cwcwll	kʊkʊɬ
cwd	kuːd
cweryl	kwɛrɨ̞l
cweryla	kwɛrəla
cwerylau	kwɛrəla
cwerylau	kwɛrəlaɨ̯
cwerylau	kwɛrəlɛ
cwerylgar	kwɛrəlɡar
cwerylon	kwɛrəlɔn
cwerylwr	kwɛrəlʊr
cwerylwyr	kwɛrəlwɨ̞r
cwestiynau	kwɛsdjəna
cwestiynau	kwɛsdjənaɨ̯
cwestiynau	kwɛsdjənɛ
cwfl	kuːvʊl
cwfl	kʊvl
cwfl	kʊvʊl
cwmwl	kʊmʊl
cwningen	kʊnɪŋan
cwningen	kʊnɪŋɛn
cwpla	kʊpla
cwplws	kʊplʊs
cwpláu	kʊplaɨ̯
cwpwrdd	kʊpʊrð
cwstardiau	kʊsdardja
cwstardiau	kʊsdardjaɨ̯
cwstardiau	kʊsdardjɛ
cwtiar	kʊtjar
cwtsh	kʊtʃ
cwtshys	kʊtʃɨ̞s
cwymp	kwɨ̞mp
cwymplen	kʊɨ̯mplɛn
cwyno	kʊɨ̯nɔ
cwyr	kuːɨ̯r
cychwyn	kəχwɨ̞n
cyd	kɨːd
cydgordiol	kɨ̞dɡɔrdjɔl
cydleoli	kədlɛɔlɪ
cydlifiadau	kədlɪvjada
cydlifiadau	kədlɪvjadaɨ̯
cydlifiadau	kədlɪvjadɛ
cydlifo	kədlɪvɔ
cydseiniol	kɨːdsei̯njɔl
cydseiniol	kɨ̞dsei̯njɔl
cydsynio	kɨ̞dsənjɔ
cydweithiad	kɨːdwei̯θjad
cydweithio	kɨːdwei̯θjɔ
cydweithiwr	kɨːdwei̯θjʊr
cydweithiwr	kɨ̞dwei̯θjʊr
cydweithrediad	kɨːdwei̯θrɛdjad
cydweithrediadau	kɨːdwei̯θrɛdjada
cydweithrediadau	kɨːdwei̯θrɛdjadaɨ̯
cydweithrediadau	kɨːdwei̯θrɛdjadɛ
cydweithredu	kɨːdwei̯θrɛdɨ
cyfaddasiad	kəvaðaʃad
cyfaddasu	kəvaðasɨ̞
cyfaddef	kəvaðɛv
cyfaddefiad	kəvaðɛvjad
cyfalafiaeth	kəvalavjaɨ̯θ
cyfalafiaeth	kəvalavjɛθ
cyfamod	kəvamɔd
cyfamodi	kəvamɔdi
cyfannu	kəvanɨ̞
cyfanwaith	kəvanwai̯θ
cyfarch	kəvarχ
cyfarchiad	kəvarχjad
cyfarchol	kəvarχɔl
cyfarwys	kəvarʊɨ̯s
cyfateb	kəvatab
cyfateb	kəvatɛb
cyfeirnodau	kəvei̯rnɔda
cyfeirnodau	kəvei̯rnɔdaɨ̯
cyfeirnodau	kəvei̯rnɔdɛ
cyfenw	kəvɛnu
cyfer	kəvɛr
cyfernod	kəvɛrnɔd
cyffesgell	kəfɛsɡɛɬ
cyffrous	kəfrɔɨ̯s
cyfiawn	kəvjau̯n
cyflafaredd	kəvlavarɛð
cyflafareddiad	kəvlavarɛðjad
cyflafareddu	kəvlavarɛðɨ
cyflawni	kəvlau̯ni
cyfle	kəvla
cyfle	kəvlɛ
cyflenwi	kəvlɛnwi
cyflogaeth	kəvlɔɡaɨ̯θ
cyflogaeth	kəvlɔɡɛθ
cyflym	kəvlɨ̞m
cyflymach	kəvləmaχ
cyflymaf	kəvləmav
cyflymder	kəvləmdɛr
cyfnewid	kəvnɛu̯ɪd
cyfnewidfa	kəvnɛwɪdva
cyfnither	kəvnɪθar
cyfnither	kəvnɪθɛr
cyfnod	kəvnɔd
cyfnodol	kəvnɔdɔl
cyfnodolion	kəvnɔdɔljɔn
cyfnodolyn	kəvnɔdɔlɨ̞n
cyfnos	kəvnɔs
cyfodi	kəvɔdɪ
cyfoeth	kəvɔɨ̯θ
cyfoethocach	kəvɔɨ̯θɔkaχ
cyfoethocaf	kəvɔi̯θɔka
cyfoethocaf	kəvɔɨ̯θɔka
cyfoethocaf	kəvɔɨ̯θɔkav
cyfoethoced	kəvɔɨ̯θɔkɛd
cyfoethog	kəvɔɨ̯θɔɡ
cyfoethogi	kəvɔɨ̯θɔɡɪ
cyfoethogiad	kəvɔɨ̯θɔɡjad
cyfraddau	kəvraða
cyfraddau	kəvraðaɨ̯
cyfraddau	kəvraðɛ
cyfreithiol	kəvrei̯θjɔl
cyfrifiadur	kəvrɪvjadɨ̞r
cyfrifiannell	kəvrɪvjanɛɬ
cyfrifiant	kəvrɪvjant
cyfrifol	kəvrɪvɔl
cyfrifoldebau	kəvrɪvɔldɛba
cyfrifoldebau	kəvrɪvɔldɛbaɨ̯
cyfrifoldebau	kəvrɪvɔldɛbɛ
cyfrinach	kəvrɪnaχ
cyfrol	kəvrɔl
cyfryngu	kəvrəŋɨ
cyfundrefn	kəvɨ̞ndrɛvn
cyfundrefnol	kəvɨ̞ndrɛvnɔl
cyfundrefnu	kəvɨ̞ndrɛvnɨ
cyfuniad	kəvɨnjad
cyfuno	kəvɨ̞nɔ
cyfuwch	kəvɨ̞u̯χ
cyfweld	kəvwɛld
cyfweliad	kəvwɛljad
cyfwelydd	kəvwɛlɨ̞ð
cyhyr	kəhɨ̞r
cylched	kəlχɛd
cylchgrawn	kəlχɡrau̯n
cylchgrawn	kɨ̞lχɡrau̯n
cylchgrawn	kɪlχɡrau̯n
cylion	kəljɔn
cymaint	kəmai̯nt
cymaint	kəmɛnt
cymal	kəmal
cyman	kəman
cymedrolwr	kəmɛdrɔlʊr
cymedrolwyr	kəmɛdrɔlwɨ̞r
cymell	kəmɛɬ
cymen	kəmɛn
cymer	kəmɛr
cymesuredd	kəmɛsɨrað
cymesuredd	kəmɛsɨrɛð
cymharol	kəmharɔl
cymharu	kəmharɨ̞
cymhleth	kəmhlɛθ
cymhleth	kəmlaθ
cymhleth	kəmlɛθ
cymhlethdod	kəmhlɛθdɔd
cymhlethdodau	kəmhlɛθdɔda
cymhlethdodau	kəmhlɛθdɔdaɨ̯
cymhlethdodau	kəmhlɛθdɔdɛ
cymhlethdodau	kəmlɛθdɔda
cymhlethdodau	kəmlɛθdɔdɛ
cymhlethu	kəmhlɛθɨ
cymhwysiad	kəmhʊɨ̯ʃad
cymhwyso	kəmhʊɨ̯sɔ
cymhwyster	kəmhʊɨ̯sdɛr
cymorth	kəmɔrθ
cymorthion	kəmɔrθjɔn
cymylog	kəməlɔɡ
cymysglyd	kəməsɡlɨ̞d
cyn	kɨ̞n
cynaeafu	kneɨ̯avɨ
cynaeafu	kəneɨ̯avɨ
cynaidd	kənai̯ð
cynaliadau	kənaljada
cynaliadau	kənaljadaɨ̯
cynaliadau	kənaljadɛ
cynaniad	kənanjad
cynefindod	kənɛvɪndɔd
cynefinol	kənɛvɪnɔl
cynefinwr	kənɛvɪnʊr
cynefinwyr	kənɛvɪnwɨ̞r
cynfas	kənvas
cynffonlas	kənfɔnlas
cynffonna	kənfɔna
cynflaidd	kənvlai̯ð
cyngerdd	kəŋɛrð
cynghafan	kəŋhavan
cyngherddau	kəŋhɛrða
cyngherddau	kəŋhɛrðaɨ̯
cyngherddau	kəŋhɛrðɛ
cyngyd	kəŋɡɨ̞d
cyngyd	kəŋɨ̞d
cynhyrfu	kənhərvɨ̞
cynigiad	kənɪɡjad
cynllun	kənɬɨ̞n
cynllunio	kənɬɨ̞njɔ
cynorthwywyr	kənɔrθʊɨ̯wɨ̞r
cynorthwyydd	kənɔrθʊɨ̯ɨ̞ð
cynradd	kənrað
cyntedd	kəntɛð
cyntefin	kəntɛvɪn
cypreswydd	kəprɛswɨ̞ð
cyrhaeddais	kərheɨ̯ðai̯s
cyrhaeddais	kərheɨ̯ðɛs
cyrhaeddwch	kərhaɨ̯ðʊχ
cyrhaeddwn	kərhaɨ̯ðʊn
cyrri	kərɪ
cysgod	kəsɡɔd
cysgodion	kəsɡɔdjɔn
cysgodlun	kəsɡɔdlɨ̞n
cysgodluniau	kəsɡɔdlɨ̞nja
cysgodluniau	kəsɡɔdlɨ̞njaɨ̯
cysgodluniau	kəsɡɔdlɨ̞njɛ
cysgu	kəsɡɨ̞
cyson	kəsɔn
cystadleuydd	kəsdadleɨ̯ɨ̞ð
cysylltnod	kəsəɬdnɔd
cysylltnodau	kəsəɬdnɔda
cysylltnodau	kəsəɬdnɔdaɨ̯
cysylltnodau	kəsəɬdnɔdɛ
cysylltyddion	kəsəɬdəðjɔn
cytgan	kətɡan
cytganau	kətɡana
cytganau	kətɡanaɨ̯
cytgord	kətɡɔrd
cythraul	kəθral
cythraul	kəθraɨ̯l
cythraul	kəθrɛl
cythreuliaid	kəθreɨ̯ljai̯d
cythreuliaid	kəθreɨ̯ljɛd
cytref	kətrɛv
cytrefi	kətrɛvɪ
cytsain	kətsai̯n
cytseiniaid	kətsei̯njai̯d
cytseiniaid	kətsei̯njɛd
cytseiniol	kɨːtsei̯njɔl
cytseiniol	kɨ̞tsei̯njɔl
cytundeb	kətɨ̞ndɛb
cytuno	kətɨ̞nɔ
cytûn	kətɨːn
cyw	kɨ̞u̯
cyw	kɪu̯
cywarch	kəu̯arχ
cywasgu	kəwasɡi
cywasgu	kəwasɡɨ̞
cyweirio	kəu̯ei̯rjɔ
cywes	kəwas
cywes	kəwɛs
cywir	kəwɪr
cywiro	kəu̯ɪrɔ
cywydd	kəu̯ɨ̞ð
cywyddau	kəwəða
cywyddau	kəwəðaɨ̯
cywyddau	kəwəðɛ
cyẅres	kəʊrɛs
câl	kaːl
cân	kaːn
cânt	kaːnt
câr	kaːr
côr	koːr
da	daː
dach	daχ
daclus	daklɨ̞s
dacluso	daklɨ̞sɔ
dacw	daku
dadiol	dadjɔl
dadleuon	dadleɨ̯ɔn
dadlwytho	dadlʊɨ̯θɔ
dadwreiddio	dadwrɛɨ̞̯ðjɔ
daear	deɨ̯ar
daeargryn	deɨ̯arɡrɨ̞n
daearyddol	deɨ̯arəðɔl
daeth	daːɨ̯θ
daethoch	deɨ̯θɔχ
daethon	deɨ̯θɔn
daethpwyd	deɨ̯θpʊɨ̯d
dafad	davad
dafaden	davadan
dafaden	davadɛn
dafarn	davarn
dafarnwr	davarnʊr
dafarnwraig	davarnwrai̯ɡ
daflu	davlɨ
dafod	davɔd
dafodau	davɔda
dafodau	davɔdaɨ̯
dagrau	daɡra
dagrau	daɡraɨ̯
dagrau	daɡrɛ
daid	dai̯d
dail	dai̯l
daioni	dajɔni
dair	dai̯r
daith	dai̯θ
dal	dal
dala	dala
dalach	dalaχ
dalais	dalai̯s
dalais	dalɛs
dalais	dalɛʃ
dalais	dalɪʃ
dalaist	dalai̯sd
dalaist	dalɛsd
dalan	dalan
daldra	daldra
dalia	dalja
dall	daɬ
dalom	dalɔm
damweiniol	damwei̯njɔl
daran	daran
dargludo	darɡlɨ̞dɔ
darllediad	darɬɛdjad
darllenais	darɬɛnai̯s
darllenais	darɬɛnɛs
darllenaist	darɬɛnai̯sd
darllenaist	darɬɛnɛsd
darllenoch	darɬɛnɔχ
darllenodd	darɬɛnɔð
darllenon	darɬɛnɔn
darluniad	darlɨ̞njad
darlunio	darlɨ̞njɔ
darnau	darna
darnau	darnaɨ̯
darnau	darnɛ
darth	darθ
datblygu	datbləɡɨ
datgan	datɡan
datganiad	datɡanjad
datgelu	datɡɛlɨ̞
ddadlwythodd	ðadlʊɨ̯θɔð
ddaear	ðeɨ̯ar
ddaeareg	ðeɨ̯arɛɡ
ddaeth	ðaːɨ̯θ
ddaethoch	ðeɨ̯θɔχ
ddail	ðai̯l
ddal	ðal
ddalen	ðalɛn
ddamwain	ðamwai̯n
ddangos	ðaŋɔs
ddannoedd	ðanɔɨ̯ð
ddant	ðant
ddarllen	ðarɬan
ddarllen	ðarɬɛn
ddarllenais	ðarɬɛnai̯s
ddarllenais	ðarɬɛnɛs
ddarllenaist	ðarɬɛnai̯sd
ddarllenaist	ðarɬɛnɛsd
ddarllenoch	ðarɬɛnɔχ
ddarlunio	ðarlɨ̞njɔ
ddathlu	ðaθlɨ
dde	ðeː
ddeallaist	ðɛaɬai̯sd
ddeallaist	ðɛaɬɛsd
ddeiliaid	ðei̯ljai̯d
ddeiliaid	ðei̯ljɛd
ddel	ðɛl
ddelach	ðɛlaχ
ddemocrataidd	ðɛmɔkratai̯ð
ddemocrataidd	ðɛmɔkratɛð
dderbyn	ðɛrbɨ̞n
dderbynfa	ðɛrbənva
dderw	ðɛru
dderwen	ðɛrwɛn
ddesgiau	ðɛsɡjaɨ̯
ddesgiau	ðɛsɡjɛ
ddest	ðɛsd
ddeud	ðeɨ̯d
ddeuddeg	ðeɨ̯ðaɡ
ddeuddeg	ðeɨ̯ðɛɡ
ddeuddegfed	ðeɨ̯ðɛɡvad
ddeuddegfed	ðeɨ̯ðɛɡvɛd
ddewis	ðɛu̯is
ddewr	ðɛu̯r
ddial	ðiːal
ddianc	ðiːaŋk
ddiffodd	ðɪfɔð
ddigid	ðɪɡɪd
ddigidau	ðɪɡɪda
ddigidau	ðɪɡɪdaɨ̯
ddigidau	ðɪɡɪdɛ
ddigidol	ðɪɡɪdɔl
ddigon	ðɪɡɔn
ddigwydd	ðɪɡwɨ̞ð
ddigynnwrf	ðiːɡənʊrv
ddigynnwrf	ðɪɡənʊrv
ddim	m
ddim	ðɪm
ddim	əm
ddisgynedig	ðɪsɡənɛdɪɡ
ddisgynneb	ðɪsɡənɛb
ddod	ðoːd
ddoi	ðɔi̯
ddolffin	ðɔlfɪn
ddoli	ðɔli
ddolur	ðɔlɨ̞r
ddos	ðoːs
ddosbarth	ðɔsbarθ
ddraig	ðrai̯ɡ
ddrama	ðrama
ddringo	ðrɪŋɔ
ddrutach	ðrɨ̞taχ
ddrwm	ðrʊm
dduw	ðɨu̯
ddweud	ðweɨ̯d
ddwfr	ðʊvr
ddwl	ðʊl
ddwy	ðuːɨ̯
ddwyflwydd	ðəvlʊɨ̯ð
ddwyflwydd	ðʊɨ̯vlʊɨ̯ð
ddwyieithog	ðʊɨ̯jei̯θɔɡ
ddwylo	ðʊɨ̯lɔ
ddwyn	ðuːɨ̯n
ddwyrain	ðʊɨ̯rain
ddwyrain	ðʊɨ̯rɛn
ddwywaith	ðʊɨ̯wai̯θ
ddwywaith	ðʊɨ̯wɛθ
ddydd	ðɨːð
ddyddiau	ðəðja
ddyddiau	ðəðjaɨ̯
ddyflwydd	ðəvlʊɨ̯ð
ddyfnder	ðəvndar
ddyfnder	ðəvndɛr
ddyfrgi	ðəvrɡɪ
ddyled	ðəlɛd
ddyn	ðɨːn
ddynes	ðənɛs
ddynol	ðənɔl
ddâr	ðaːr
ddôn	ðoːn
ddŵad	ðuːad
de	deː
deallais	dɛaɬai̯s
deallais	dɛaɬɛs
deallaist	dɛaɬai̯sd
deallaist	dɛaɬɛsd
dealloch	djaɬɔχ
dealloch	dɛaɬɔχ
dealloch	dɪaɬɔχ
declyn	dɛklɨ̞n
decplyg	dɛkplɨ̞ɡ
defaid	dɛvai̯d
defaid	dɛvɛd
defnyddiwr	dɛvnəðjʊr
defnyddwyr	dɛvnəðwɨ̞r
degell	dɛɡɛɬ
degolion	dɛɡɔljɔn
degolyn	dɛɡɔlɨ̞n
deheubarth	dɛhei̯barθ
deheubarth	dɛheɨ̯barθ
dei	dei̯
deialog	dei̯alɔɡ
deigryn	dei̯ɡrɨ̞n
deil	dei̯l
deildai	dei̯ldai̯
deillio	dei̯ɬjɔ
deimlad	dei̯mlad
deimlo	dei̯mlɔ
deintydd	dei̯ntɨ̞ð
deipio	dei̯pjɔ
deirw	dei̯ru
deiseb	dei̯sɛb
deisen	dei̯san
deisen	dei̯sɛn
deisen	dei̯ʃan
deisen	dei̯ʃɛn
deisen	dɪʃan
deisen	dɪʃɛn
del	dɛl
delen	dɛlɛn
delent	deːlɛnt
delent	dɛlɛnt
deler	dɛlɛr
delir	dɛlɪt
delor	dɛlɔr
delysg	dɛlɨ̞sɡ
deml	dɛmɛl
democrataidd	dɛmɔkratai̯ð
democrataidd	dɛmɔkratɛð
deng	deːŋ
dengar	dɛŋɡar
derwydd	dɛrwɨ̞ð
derwyddiaeth	dɛrwəðjaɨ̯θ
derwyddiaeth	dɛrwəðjɛθ
des	deːs
desen	dɛsɛn
desg	dɛsɡ
deuawd	deɨ̯au̯d
deuddeg	deɨ̯ðaɡ
deuddeg	deɨ̯ðɛɡ
deuddydd	deɨ̯ðɨ̞ð
deugeiniau	dei̯ɡei̯nja
deugeiniau	dei̯ɡei̯njaɨ̯
deugeiniau	dei̯ɡei̯njɛ
deulo	deɨ̯lɔ
deunaw	deɨ̯nau̯
deunawfed	deɨ̯nau̯vɛd
deunydd	deɨ̯nɨ̞ð
deunyddiau	deɨ̯nəðja
deunyddiau	deɨ̯nəðjaɨ̯
deunyddiau	deɨ̯nəðjɛ
dew	deːu̯
dewi	dɛu̯i
dewin	dɛu̯ɪn
dewiniaeth	dɛu̯ɪnjaɨ̯θ
dewiniaeth	dɛu̯ɪnjɛθ
dewis	dɛu̯is
dewis	dɛu̯iʃ
deyrn	deɨ̯rn
dial	diːal
dianc	diːaŋk
diben	dɪbɛn
dibynadwy	dɪbənadu
dibynadwy	dɪbənadʊɨ̯
diddordeb	dɪðɔrdab
diddordeb	dɪðɔrdɛb
diddori	dɪðɔrɪ
didranc	dɪdraŋk
difetha	dɪvɛθa
digartref	dɪɡartrɛv
digid	dɪɡɪd
digidau	dɪɡɪda
digidau	dɪɡɪdaɨ̯
digidau	dɪɡɪdɛ
digon	dɪɡɔn
digoni	dɪɡɔni
digwydd	dɪɡwɨ̞ð
digwyddaf	dɪɡwəðaf
digwyddiad	dɪɡʊi̯ðjad
dillad	dɪɬad
dilledyn	dɪɬɛdɨ̞n
dilyn	dɪlɨ̞n
dilyn	dɪlɪn
dilynwr	dɪlənʊr
dilynwyr	dilənwɨ̞r
dilyw	dɪlɨ̞u̯
dim	dɪm
diniwed	dɪniu̯ɛd
diobaith	diɔbai̯θ
diod	diːɔd
diogel	djɔɡal
diogel	djɔɡɛl
diogel	dɪɔɡɛl
dir	diːr
diraddio	dɪraðjɔ
dirmygu	dɪrməɡɨ̞
diryw	dɪrɨ̞u̯
disgo	dɪsɡɔ
disgotec	dɪsɡɔtɛk
disgwyl	dɪsɡʊɨ̯l
disgybl	dɪsɡɨ̞bl
disgybl	dɪsɡɪbl
disgyn	dɪsɡɨ̞n
disgyn	dɪsɡɪn
distawrwydd	dɪsdau̯rʊɨ̯ð
do	doː
do'ch	doːχ
do'dd	doːð
do'n	doːn
docyn	dɔkɨ̞n
dodi	dɔdɪ
doedden	dɔɨ̯ðan
doedden	dɔɨ̯ðɛn
doen	doːɨ̯n
doer	doːɨ̯r
does	doːɨ̯s
doet	doːɨ̯t
doeth	doːɨ̯θ
doethaf	dɔi̯θav
dof	doːv
dogfen	dɔɡvɛn
doi	dɔi̯
doid	dɔi̯d
doir	dɔi̯r
dois	dɔi̯s
dois	dɔi̯ʃ
dolffin	dɔlfɪn
dolis	dɔlɪs
dolur	dɔlɨ̞r
dolïau	dɔlɪa
dolïau	dɔlɪaɨ̯
dolïau	dɔlɪɛ
doniol	dɔnjɔl
dor	dɔr
dorra	dɔra
dorri	dɔri
dorrid	dɔrɪd
dorsen	dɔrsɛn
dos	doːs
dosbarth	dɔsbarθ
dosbarthau	dɔsbarθa
dosbarthau	dɔsbarθaɨ̯
dosbarthau	dɔsbarθɛ
dosbarthiad	dɔsbarθjad
dosbarthiadau	dɔsbarθjada
dosbarthiadau	dɔsbarθjadaɨ̯
dosbarthiadau	dɔsbarθjadɛ
dosbarthwyr	dɔsbarθwɨ̞r
dost	dɔst
dowd	dou̯d
down	dou̯n
draed	draːɨ̯d
draen	draːɨ̯n
draenen	dreɨ̯nan
draenen	dreɨ̯nɛn
draenog	drɑːɨ̯nɔɡ
draenogrwydd	dreɨ̯nɔɡruɨ̯ð
drama	drama
dramor	dramɔr
drawant	drau̯ant
dreiglo	drei̯ɡlɔ
dreisiol	drei̯ʃɔl
dreisiwr	drei̯ʃʊr
drennydd	drɛnɨ̞ð
drewi	drɛu̯i
dri	driː
drilio	drɪljɔ
dringfa	drɪŋva
dringo	drɪŋɔ
dringwr	drɪŋʊr
driongl	driːɔŋl
dro	droː
droch	droːχ
droed	droːɨ̯d
droednoeth	drɔɨ̯dnɔɨ̯θ
droen	droːɨ̯n
droid	drɔi̯d
dros	drɔs
drost	drɔsd
drutach	drɨ̞taχ
drwch	druːχ
dry	drɨː
drysgoed	drəsɡɔɨ̯d
dryslwyni	drəslʊɨ̯ni
dryslyd	drəslɨ̞d
du	dɨː
ducpwyd	dɨ̞kpʊɨ̯d
dued	dɨɛd
dueg	dɨːɛɡ
duegredyn	dɨ̞ɛɡrɛdɨ̞n
dug	dɨːɡ
dugoch	dɨ̞ɡɔχ
dun	dɨ̞n
duo	dɨːɔ
dur	dɨːr
duw	dɨu̯
duwiau	dɨu̯ja
duwiau	dɨu̯jaɨ̯
duwies	dɨ̞u̯jas
duwies	dɨ̞u̯jɛs
dw	dw
dw	dʊ
dwedodd	dwɛdɔð
dwedon	dwɛdɔn
dweud	dweɨ̯d
dwfn	dʊvn
dwfr	dʊvr
dwg	duːɡ
dwl	dʊl
dwll	dʊɬ
dwlu	dʊlɨ
dwp	dʊp
dwygeiniog	dʊɨ̯ɡei̯njɔɡ
dwylo	dʊɨ̯lɔ
dwymyn	dʊɨ̯mɨ̞n
dwyn	duːɨ̯n
dwyrain	dʊɨ̯rain
dwyrain	dʊɨ̯rɛn
dwys	duːɨ̯s
dwysáu	dʊɨ̯saɨ̯
dwyt	duːt
dwyt	duːɨ̯t
dwythell	dʊɨ̯θaɬ
dwythell	dʊɨ̯θɛɬ
dwywaith	dʊɨ̯wai̯θ
dwywaith	dʊɨ̯wɛθ
dy	d
dy	də
dybaco	dəbakɔ
dybarth	dəbarθ
dyblu	dəblɨ
dych	dɨːχ
dychmygu	dəχməɡɨ
dychryn	dəχrɨ̞n
dychryniadau	dəχrənjada
dychryniadau	dəχrənjadaɨ̯
dychryniadau	dəχrənjadɛ
dychrynllyd	dəχrənɬɨ̞d
dychwelyd	dəχwɛlɨ̞d
dycpwyd	dəkpʊɨ̯d
dyd	dɨːd
dydan	dədan
dydd	dɨːð
dyddiad	dəðjad
dyddiau	dəðja
dyddiau	dəðjaɨ̯
dyddiau	dəðjɛ
dyddodiad	dəðɔdjad
dydw	dədʊ
dydwi	dədwɪ
dydy	dədɪ
dydych	dədɨ̞χ
dydyn	dədɨ̞n
dyfnhau	dəvnhaɨ̯
dyfnion	dəvnjɔn
dyfrgi	dəvrɡɪ
dyfynnod	dəvənɔd
dyhead	dəheːad
dyheu	dəheɨ̯
dylai	dəlai̯
dylech	dəlɛχ
dyled	dəlɛd
dyledion	dəlɛdjɔn
dylu	dəlɨ̞
dymuno	dəmɨ̞nɔ
dyna	dəna
dyna	dənɛ
dyna	dɛnɛ
dynnu	dənɨ
dynol	dənɔl
dynoliaeth	dənɔljaɨ̯θ
dynoliaeth	dənɔljɛθ
dynwared	dənwarad
dynwared	dənwarɛd
dyr	dɨ̞r
dyrchafedig	dərχavɛdɪɡ
dyrchafu	dərχavɨ
dyrchaif	dərχai̯v
dyrrau	dəra
dyrrau	dəraɨ
dyrrau	dərɛ
dyry	dərɨ̞
dyrys	dərɨ̞s
dyrysfa	dərəsva
dyrysfeydd	dərəsveɨ̯ð
dyrysgoed	dərəsɡɔɨ̯d
dyrysle	dərəslɛ
dyrysleoedd	dərəsleːɔɨ̯ð
dyryslwyn	dərəslʊɨ̯n
dyryslwyni	dərəslʊɨ̯ni
dyryslyd	dərəslɨ̞d
dyrysni	dərəsni
dyrysu	dərəsɨ
dysg	dɨːsɡ
dysglaid	dɨ̞sɡlai̯d
dysglaid	dɨ̞sɡlɛd
dysgleidiau	dɨ̞sɡlei̯dja
dysgleidiau	dɨ̞sɡlei̯djaɨ̯
dysgleidiau	dɨ̞sɡlei̯djɛ
dysgu	dəsɡɨ̞
dysgwch	dəsɡʊχ
dysgwr	dəsɡʊr
dysgwyr	dəsɡwɨ̞r
dyslecsia	dɨ̞slɛksja
dyslecsig	dɨ̞slɛksɪɡ
dysprosiwm	dɨ̞sbrɔsjʊm
dywed	dəu̯ɛd
dyweddïad	dəwɛðiːad
dyweddïo	dəwɛðiːɔ
dywedodd	dəu̯ɛdɔð
dywyll	dəu̯ɨ̞ɬ
dâl	daːl
dêl	deːl
dîm	diːm
düwch	dɨːʊχ
dŵad	duːad
dŷ	dɨː
e	eː
e	ɛ
eang	ɛaŋ
eangderau	ɛaŋdɛra
eangderau	ɛaŋdɛraɨ̯
eangderau	ɛaŋdɛrɛ
eangfrydig	ɛaŋvrədɪɡ
eangiadau	ɛaŋjada
eangiadau	ɛaŋjadaɨ̯
eangiadau	ɛaŋjadɛ
ebargofiant	ɛbarɡɔvjant
ecogyfeillgar	ɛkɔɡəvei̯ɬɡar
economeg	ɛkɔnɔmɛɡ
economegwyr	ɛkɔnɔmɛɡwɨ̞r
eddy	ɛðɨ̞
edfryd	ɛdvrɨ̞d
edmygu	edməɡɨ̞
edn	ɛdn
edwyn	ɛdwɨ̞n
efallai	vaɬa
efallai	vaɬɛ
efallai	ɛvaɬa
efallai	ɛvaɬai̯
efallai	ɛvaɬɛ
efallai	ɛɬa
efelychu	ɛvɛləχɨ̞
effeithio	ɛfei̯θjɔ
efwr	ɛvʊr
egino	ɛɡɪnɔ
egwyl	ɛɡʊɨ̯l
egyr	ɛɡɨ̞r
ei	ei̯
eicon	ei̯kɔn
eid	ei̯d
eiddew	ei̯ðɛu̯
eiddgar	ei̯ðɡar
eiddgarwch	ei̯ðɡarʊχ
eidion	ei̯djɔn
eidionyn	ei̯djɔnɨ̞n
eilfed	ei̯lvɛd
eiliad	ei̯ljad
einsteiniwm	ai̯nsdai̯njʊm
einsteiniwm	ei̯nsdei̯njʊm
eira	ei̯ra
eiriadurwr	ei̯rjadɨ̞rʊr
eirlysiau	ei̯rləʃa
eirlysiau	ei̯rləʃaɨ̯
eirlysiau	ei̯rləʃɛ
eirth	ei̯rθ
eithaf	ei̯θav
el	ɛl
elc	ɛlk
electromagneteg	ɛlɛktrɔmaɡnɛtɛɡ
eled	ɛlɛd
elid	ɛlɪd
eliffant	ɛlɪfant
ella	ɛɬa
ellyll	ɛɬɨ̞ɬ
elo	ɛlɔ
elsem	ɛlsɛm
elsent	ɛlsɛnt
elsid	ɛlsɪd
elsit	ɛlsɪt
elswn	ɛlsʊn
elusen	ɛlɨ̞sɛn
elw	ɛlu
elwa	ɛlwa
elwn	ɛlʊn
em	ɛm
eng	ɛŋ
enghraifft	ɛŋ̊rai̯fd
enghraifft	ɛŋ̊rɛfd
engyl	ɛŋɨ̞l
eni	ɛnɪ
enillodd	ɛnɪɬɔð
entrych	ɛntrɨ̞χ
enwebu	ɛnwɛbɨ̞
enwocach	ɛnwɔkaχ
enwocaf	ɛnwɔkav
enwog	ɛnwɔɡ
eog	ɛɔɡ
eos	eːɔs
eosiaid	ɛɔʃaɨ̯d
eosiaid	ɛɔʃɛd
er	ɛr
erbiwm	ɛrbjʊm
erblith	ɛrblɪθ
erbyn	ɛrbɨ̞n
erch	ɛrχ
erddi	ɛrðɪ
erfin	ɛrvɪn
erfyn	ɛrvɨn
ergyd	ɛrɡɨ̞d
erioed	rjoːɨ̯d
erioed	ɛrjoːɨ̯d
erlid	ɛrlɪd
erthygl	ɛrθɨ̞ɡl
erthyliad	ɛrθəljad
eryraidd	ɛrərai̯ð
eryraidd	ɛrərɛð
es	eːs
esgid	ɛsɡɪd
esgidiau	sɡɪdja
esgidiau	sɡɪdjɛ
esgidiau	ɛsɡɪdjaɨ̯
esgob	ɛsɡɔb
esgobaeth	ɛsɡɔbaɨ̯θ
esgobaeth	ɛsɡɔbɛθ
esgusodwch	ɛskɨ̞sɔdʊχ
esgyll	ɛsɡɨ̯ɬ
esgyn	ɛsɡɨ̞n
esmwyth	ɛsmʊɨ̯θ
esmwythydd	ɛsmʊɨ̯θɨ̞n
esmwytháu	ɛsmʊɨ̯θaɨ̯
est	ɛsd
ester	ɛsdɛr
esteriad	ɛsdɛrjad
esteru	ɛsdɛrɨ
estron	ɛsdrɔn
estrys	ɛsdrɨ̞s
ethan	ɛθan
ether	ɛθɛr
etholedig	ɛθɔlɛdɪɡ
etholiad	ɛθɔljad
etholiadau	ɛθɔljada
etholiadau	ɛθɔljadaɨ̯
etholiadol	ɛθɔljadɔl
ethrefig	ɛθrɛvɪɡ
euog	eɨ̯ɔɡ
eurben	eɨ̯rbɛn
eurgylch	eɨ̯rɡɨ̞lχ
fa's	vaːs
fab	vaːb
faeddod	veɨ̯ðɔd
faen	vaːɨ̯n
faet	vaːɨ̯t
fag	vaɡ
fag	vaːɡ
faint	vai̯nt
falwr	valʊr
fan	van
fara	vara
farchnad	varχnad
farchogion	varχɔɡjɔn
fardd	varð
farfog	varvɔɡ
farn	varn
farnau	varna
farnau	varnaɨ̯
farnau	varnɛ
farnwr	varnʊr
farus	varɨ̞s
fas	vaːs
fasen	san
fasen	sɛn
fasen	vasan
fasen	vasɛn
fasen	vəsan
fasen	vəsɛn
fasged	vasɡad
fasged	vasɡɛd
faswn	vasʊn
fasŵn	vasuːn
fath	vaːθ
fatha	vaθa
fathemateg	vaθɛmatɛɡ
fawn	vau̯n
fawr	vau̯r
fe	veː
fechan	vɛχan
fechgyn	vɛχɡɨ̞n
feddal	vɛðal
feddwl	vɛðʊl
feddygol	vɛðəɡɔl
feddylgar	vɛðəlɡar
fedi	vɛdɪ
fedra	vɛdra
feibion	vəi̯bjɔn
fenga	vɛŋɡa
fengach	vɛŋɡaχ
fenig	vɛnɪɡ
fenthyg	vɛnθɨ̞ɡ
fenywaidd	vɛnəu̯ai̯ð
fenywaidd	vɛnəu̯ɛð
fer	vɛr
ferch	vɛrχ
ferdis	vɛrdɪs
ferf	vɛrv
ferfau	vɛrva
ferfau	vɛrvaɨ̯
ferfau	vɛrvɛ
ferfenw	vɛrvɛnu
fersiwn	vɛrʃʊn
ferwi	vɛrwi
fesul	vɛsɨ̞l
fether	vɛθɛr
fewn	vɛu̯n
fewn	vɨ̞u̯n
fewnol	vɛu̯nɔl
ffa	faː
ffacbys	fakbɨ̞s
ffair	fai̯r
ffau	faɨ̯
ffawt	fau̯t
ffenast	fɛnasd
fferm	fɛrm
ffermio	fɛrmjɔ
ffermiwm	fɛrmjʊm
ffesant	fɛsant
ffilm	fɪlm
ffit	fɪt
fflerofiwm	flɛrɔvjʊm
fflipfflops	flɪpflɔps
ffliw	flɪu̯
fflycs	fləks
fflyd	flɨːd
ffodus	fɔdɨ̞s
ffoniff	fɔnɪf
ffonio	fɔnjɔ
ffonoleg	fɔnɔlɛɡ
fforchog	fɔrχɔɡ
ffosffad	fɔsfad
ffotograffiaeth	fɔtɔɡrafjaɨ̯θ
ffotograffiaeth	fɔtɔɡrafjɛθ
ffrwd	fruːd
ffrydio	frədjɔ
ffwcio	fʊkjɔ
ffynidwydd	fənɪdwɨ̞ð
ffyrdd	fɨ̞rð
ffyrling	fərlɪŋ
ffyrnau	fərna
ffyrnau	fərnaɨ̯
ffyrnau	fərnɛ
ffyrrau	fəra
ffyrrau	fəraɨ̯
ffyrrau	fərɛ
ffôn	foːn
ficer	vɪkar
ficer	vɪkɛr
fil	viːl
filoedd	vɪlɔɨ̯ð
finegr	vɪnɛɡr
finnau	vɪna
finnau	vɪnaɨ̯
fioled	viɔlɛd
flas	vlaːs
flasu	vlasɨ
flasus	vlasɨ̞s
fleiddiaid	vlei̯ðjai̯d
fleiddiaid	vlei̯ðjɛd
fleiddiau	vlei̯ðja
fleiddiau	vlei̯ðjaɨ̯
fleiddiau	vlei̯ðjɛ
flew	vleːu̯
flewyn	vlɛu̯ɨ̞n
flin	vliːn
flinedig	vlɪnɛdɪɡ
flodau	vlɔda
flodau	vlɔdaɨ̯
flodau	vlɔdɛ
flodyn	vlɔdɨ̞n
flwydd	vluːɨ̯ð
flwyddi	vlʊɨ̯ði
flwyddyn	vlʊɨ̯ðɨ̞n
flynedd	vlənað
flynedd	vlənɛð
flynyddoedd	vlənəðɔɨ̯ð
fo	voː
foch	voːχ
fochlwyd	vɔχlʊɨ̯d
focsio	vɔkʃɔ
fol	vɔl
foltedd	vɔltɛð
ford	vɔrd
fordydd	vɔrdɨ̞ð
fore	vɔra
fore	vɔrɛ
forgi	vɔrɡi
forio	vɔrjɔ
foth	voːθ
fothau	vɔθa
fothau	vɔθaɨ̯
fothau	vɔθɛ
frag	vraːɡ
frathu	vraθɨ̞
frawd	vrau̯d
freuddwydion	vreɨ̯ðʊɨ̯djɔn
frith	vriːθ
fro	vroː
froc	vrɔk
froch	vroːχ
fronleision	vrɔnlei̯ʃɔn
fronnau	vrɔna
fronnau	vrɔnaɨ̯
frwsio	vrʊʃɔ
frwsioch	vrʊʃɔχ
frwsiodd	vrʊʃɔð
fu	vɨː
fudr	vɨ̞dɨ̞r
fur	vɨːr
fuwch	vɨu̯χ
fwg	vuːɡ
fwnwgl	vʊnʊɡl
fwnwgl	vʊnʊɡʊl
fwytais	vuɨ̯tai̯s
fwytais	vətɛs
fwytaist	vuɨ̯tai̯sd
fwytoch	vətɔχ
fwytoch	vʊɨ̯tɔχ
fwyton	vətɔn
fwyton	vʊɨ̯tɔn
fyddi	vəðɪ
fyddwch	vəðʊχ
fyddwn	vəðʊn
fynyddoedd	vənəðɔɨ̯ð
fyr	vɨ̞r
fyrdd	vɨ̞rð
fys	vɨːs
fysedd	vəsað
fysedd	vəsɛð
fàs	vas
fôn	voːn
fûm	vɨːm
fẁg	vʊɡ
ga	ɡaː
gacha	ɡaχa
gachen	ɡaχɛn
gadael	ɡadal
gadael	ɡadaɨ̯l
gadael	ɡadɛl
gadair	ɡadar
gadawed	ɡadau̯ɛd
gadawodd	ɡadau̯ɔð
gadd	ɡaːð
gadeiriau	ɡadei̯rja
gadeiriau	ɡadei̯rjaɨ̯
gadeiriau	ɡadei̯rjɛ
gadeirio	ɡadeɪ̯rjɔ
gadoliniwm	ɡadɔlɪnjʊm
gae	ɡaːɨ̯
gaeaf	ɡeɨ̯a
gaeaf	ɡeɨ̯av
gaeafgysgu	ɡeɨ̯avɡəsɡɨ
gaed	ɡaːɨ̯d
gael	ɡaːl
gael	ɡaːɨ̯l
gaen	ɡai̯n
gaen	ɡaːɨ̯n
gafael	ɡaval
gafael	ɡavaɨ̯l
gafael	ɡavɛl
gaffer	ɡafɛr
gain	ɡai̯n
gait	ɡai̯t
galan	ɡalan
galiwm	ɡaljʊm
galla	ɡaɬa
galled	ɡaɬɛd
gallen	ɡaɬɛn
galler	ɡaɬɛr
galwes	ɡalwɛs
gampfa	ɡampva
ganer	ɡanɛr
ganes	ɡanɛs
ganfod	ɡanvɔd
ganfyddadwy	ɡanvəðadʊɨ̯
gani	ɡanɪ
ganit	ɡanɪt
ganlyniad	ɡanlənjad
gansai	ɡansai̯
gantorion	ɡantɔrjɔn
ganu	ɡanɨ̞
gar	ɡar
gara	ɡara
garafán	ɡaravan
garant	ɡarant
garddwr	ɡarðʊr
gardinal	ɡardɪnal
gardinaliaid	ɡardɪnaljai̯d
gardinaliaid	ɡardɪnaljɛd
garedig	ɡarɛdɪɡ
garej	ɡarɛdʒ
garejys	ɡarɛd͡ʒɨ̞s
garest	ɡarɛst
garet	ɡarɛt
garlleg	ɡarɬɛɡ
garnau	ɡarna
garnau	ɡarnaɨ̯
garnau	ɡarnɛ
garo	ɡarɔ
garreg	ɡaraɡ
garreg	ɡarɛɡ
garth	bɨarθ
gartre	ɡartra
gartre	ɡartrɛ
gartref	ɡartra
gartref	ɡartrɛ
gartref	ɡartrɛv
garwhau	ɡarwhaɨ̯
garwr	ɡarʊr
gas	ɡaːs
gasglu	ɡasɡlɨ
gastell	ɡasdaɬ
gastell	ɡasdɛɬ
gath	ɡaːθ
gathod	ɡaθɔd
gato	ɡatɔ
gawod	ɡau̯ɔd
gefeilles	ɡɛvei̯ɬɛs
geffyl	ɡɛfɨ̞l
gegin	ɡɛɡɪn
gei	ɡei̯
geilw	ɡei̯lu
geiriadur	ɡei̯rjadɨ̞r
geiriadurwr	ɡei̯rjadɨ̞rʊr
geiriadurwyr	ɡei̯rjadɨ̞rwɨ̞r
gellgwn	ɡɛɬɡuːn
gellyg	ɡɛɬɨ̞ɡ
gellygen	ɡɛɬəɡɛn
gemau	ɡɛma
gemau	ɡɛmaɨ̯
gemau	ɡɛmɛ
gemeg	ɡɛmɛɡ
gemwaith	ɡɛmwai̯θ
gen	ɡɛn
genau	ɡɛna
genau	ɡɛnaɨ̯
genedigaeth	ɡɛnɛdɪɡaɨ̯θ
genedigaeth	ɡɛnɛdɪɡɛθ
genedigaethau	ɡɛnɛdɪɡeɨ̯θa
genedigaethau	ɡɛnɛdɪɡeɨ̯θaɨ̯
genedigaethau	ɡɛnɛdɪɡeɨ̯θɛ
genedlaethol	ɡɛnɛdleɨ̯θɔl
geneth	ɡɛnɛθ
genhinen	ɡɛnhɪnan
genhinen	ɡɛnhɪnɛn
geni	ɡɛnɪ
genidol	ɡɛnɪdɔl
gennod	ɡɛnɔd
gennych	ɡɛnɨ̞χ
gennyf	ɡɛnɨ̞v
gennym	ɡɛnɨ̞m
gennyn	ɡɛnɨ̞n
gennyt	ɡɛnɨ̞t
genwair	ɡɛnwai̯r
genwair	ɡɛnwar
genweiriau	ɡɛnwei̯rja
genweiriau	ɡɛnwei̯rjaɨ̯
genweiriau	ɡɛnwei̯rjɛ
genyn	ɡɛnɨ̞n
genynnol	ɡɛnənɔl
ger	ɡɛr
gerais	ɡɛrai̯s
gerbron	ɡɛrbrɔn
gerdded	ɡɛrðɛd
gerddi	ɡɛrðɪ
gerddoriaeth	ɡɛrðɔrjaɨ̯θ
gerddoriaeth	ɡɛrðɔrjɛθ
gerflun	ɡɛrvlɨ̞n
geri	ɡɛrɪ
gerir	ɡɛrɪr
gerllaw	ɡɛrɬau̯
germaniwm	ɡɛrmanjʊm
gilydd	ɡɪlɨ̞ð
gimbill	ɡɪmbɪɬ
gin	ɡɪn
gini	ɡɪnɪ
ginio	ɡɪnjɔ
gist	ɡiːsd
giw	ɡɪu̯
gladdu	ɡlaðɨ̞
glanach	ɡlanaχ
glas	ɡlaːs
glased	ɡlasɛd
glastwreiddio	ɡlastʊrei̞ðjɔ
glaswst	ɡlasʊsd
glaw	ɡlaːu̯
glawio	ɡlau̯jɔ
glefyd	ɡlɛvɨ̞d
gleisiad	ɡlei̯ʃad
gleision	ɡlei̯ʃɔn
glendid	ɡlɛndɪd
gloes	ɡloːɨ̯s
gloi	ɡlɔi̯
gloywedd	ɡlɔɨ̯wað
gloywedd	ɡlɔɨ̯wɛð
glud	ɡlɨːd
gludio	ɡlɨ̞djɔ
glust	ɡlɨːst
glustdlws	ɡlɨ̞sdlʊs
glwb	ɡlʊb
glwth	ɡluːθ
glwyfo	ɡlʊɨ̯vɔ
glybiau	ɡləbja
glybiau	ɡləbjaɨ̯
glybiau	ɡləbjɛ
glyfar	ɡləvar
glyn	ɡlɨ̞n
glynol	ɡlənɔl
glêr	ɡleːr
glŷn	ɡlɨːn
gnawn	ɡnau̯n
gnwd	ɡnuːd
go	ɡoː
gobaith	ɡɔbaiθ
gobaith	ɡɔbɛθ
goddaith	ɡɔðai̯θ
goddef	ɡɔðɛ
goddef	ɡɔðɛv
goddrych	ɡɔðrɨ̞χ
goddrychol	ɡɔðrəχɔl
godon	ɡɔdɔn
godre	ɡɔdrɛ
gody	ɡɔdɨ̞
goed	ɡoːɨ̯d
goeg	ɡoːɨ̯ɡ
goes	ɡoːɨ̯s
gof	ɡoːv
gofal	ɡɔval
gofalgar	ɡɔvalɡar
gofalus	ɡɔvalɨ̞s
gofid	ɡɔvɪd
gofio	ɡɔvjɔ
goflew	ɡɔvlɛu̯
gofod	ɡɔvɔd
gofodoldeb	ɡɔvɔdɔldɛb
gofyn	ɡɔvɨ̞n
gofynnod	ɡɔvənɔd
gog	ɡoːɡ
goginio	ɡɔɡɪnjɔ
goginioch	ɡɔɡɪnjɔχ
goginiodd	ɡɔɡɪnjɔð
goginion	ɡɔɡɪnjɔn
goglais	ɡɔɡlai̯s
goglais	ɡɔɡlai̯ʃ
goglais	ɡɔɡlɛs
goglais	ɡɔɡlɛʃ
gogledd	ɡɔɡlað
gogledd	ɡɔɡlɛð
gogleddol	ɡɔɡlɛðɔl
gogor	ɡɔɡɔr
gogr	ɡoːɡɔr
gogr	ɡɔɡr
gogr	ɡɔɡɔr
gogru	ɡɔɡrənɨ̞
gogryn	ɡɔɡrɨ̞n
gogrynu	ɡɔɡrənɨ̞
gogwyddo	ɡɔɡwɨ̞ðɔ
gogyddesau	ɡɔɡəðɛsa
gogyddesau	ɡɔɡəðɛsaɨ̯
gogyddesau	ɡɔɡəðɛsɛ
gohirio	ɡɔhɪrjɔ
golau	ɡɔla
golau	ɡɔlaɨ̯
golau	ɡɔlɛ
golchi	ɡɔlχɪ
goleddf	ɡɔlɛðv
goleddfu	ɡɔlɛðvɨ̞
goleuad	ɡɔleɨ̯ad
goleuadau	ɡɔleɨ̯ada
goleuadau	ɡɔleɨ̯adaɨ̯
goleuadau	ɡɔleɨ̯adɛ
goleudai	ɡɔleɨ̯dai̯
goleudy	ɡɔleɨ̯dɨ̞
goleuedig	ɡɔleɨ̯ɛdɪɡ
goleuedigaeth	ɡɔleɨ̯ɛdɪɡaɨ̯θ
goleuni	ɡɔleɨ̯nɨ
goleuo	ɡɔleɨ̯ɔ
golfan	ɡɔlvan
golfanod	ɡɔlvanɔd
golff	ɡɔlf
goll	ɡɔɬ
golli	ɡɔɬi
gollwng	ɡɔɬʊŋ
gollwng	ɡʊɬʊn
gollwng	ɡʊɬʊŋ
golomen	ɡɔlɔmɛn
golosg	ɡɔlɔsɡ
goludog	ɡɔlɨ̞dɔɡ
golwg	ɡɔlʊɡ
golwr	ɡɔlʊr
golygfa	ɡɔləɡva
golygfeydd	ɡɔləɡveɨ̯ð
golygu	ɡɔləɡɨ̞
golygus	ɡɔləɡɨ̞s
gomiwnyddol	ɡɔmjʊnəðɔl
gonest	ɡɔnasd
gonest	ɡɔnɛsd
gor	ɡɔr
gorasgellu	ɡɔrasɡɛɬɨ
gorau	ɡɔra
gorau	ɡɔraɨ̯
gorau	ɡɔrɛ
gorbryder	ɡɔrbrədar
gorchaifn	ɡɔrχai̯vn
gorchaw	ɡɔrχau̯
gorchfygiad	ɡɔrχvəɡjad
gorchfygol	ɡɔrχvəɡɔl
gorchfygu	ɡɔrχvəɡɨ̞
gorchfygwr	ɡɔrχvəɡʊr
gorchmynnol	ɡɔrχmənɔl
gorchudd	ɡɔrχɨ̞ð
gorchudd	ɡɔrχɪð
gorchuddio	ɡɔrχɨ̞ðjɔ
gorchymyn	ɡɔrχəmɨ̞n
gordd	ɡɔrð
gordderch	ɡɔrðɛrχ
gordderchadon	ɡɔrðɛrχadɔn
gordew	ɡɔrdɛu̯
gordewdra	ɡɔrdɛu̯dra
gorfanadl	ɡɔrvanadl
gorfanadl	ɡɔrvanal
gorff	ɡɔrf
gorffen	ɡɔrfan
gorffen	ɡɔrfɛn
gorffennol	ɡɔrfɛnɔl
gorffwyll	ɡɔrfʊɨ̯ɬ
gorflin	ɡɔrlɪn
gorflinder	ɡɔrvlɪndar
gorflinder	ɡɔrvlɪndɛr
gorflino	ɡɔrlɪnɔ
gorfod	ɡɔrvɔd
gorfod	ɡɔrɔ
gorfod	ɡɔrɔd
gorfodog	ɡɔrvɔdɔɡ
gorfodol	ɡɔrvɔdɔl
gorfodtref	ɡɔrvɔtrɛv
gorfotref	ɡɔrvɔtrɛv
gorgyffwrdd	ɡɔrɡəfʊrð
gorgyhyrog	ɡɔrɡəhərɔɡ
goriad	ɡɔrjad
gorlifaf	ɡɔrlɪvav
gorlifo	ɡɔrlɪvɔ
gorllewin	ɡɔrɬɛu̯ɪn
gormes	ɡɔrmɛs
gormod	ɡɔrmɔd
gornest	ɡɔrnɛsd
gornestau	ɡɔrnɛsdaɨ̯
gornestau	ɡɔrnɛsdɛ
gornestu	ɡɔrnɛsdɨ̯
gornestwr	ɡɔrnɛsdʊr
gornestwyr	ɡɔrnɛsdwɨ̞r
goronafeirws	ɡɔrɔnavei̯rʊs
goror	ɡɔrɔr
gorsaf	ɡɔrsav
gorwedd	ɡɔrwɛð
gorweiddiog	ɡɔrwei̯ðjɔɡ
gorwel	ɡɔrwɛl
goryrru	ɡɔrərɨ̞
gosber	ɡɔsbɛr
gosod	ɡɔsɔd
gosodedig	ɡɔsɔdɛdɪɡ
gosodiad	ɡɔsɔdjad
gosodol	ɡɔsɔdɔl
gosodwr	ɡɔsɔdʊr
gosteg	ɡɔsdɛɡ
gostwng	ɡɔsdʊŋ
gostyngaidd	ɡɔsdəŋai̯ð
gosyn	ɡɔsɨ̞n
got	ɡɔt
gowboi	ɡou̯bɔi̯
gowbois	ɡou̯bɔi̯s
grac	ɡrak
gradd	ɡraːð
graddio	ɡraðjɔ
graean	ɡreɨ̯an
graeanu	ɡreɨ̯anɨ̞
graff	ɡraf
graff	ɡraːf
gramadeg	ɡramadɛɡ
grasus	ɡrasɨ̞s
grau	ɡraɨ̯
grawn	ɡrau̯n
grawnwin	ɡrau̯nwɪn
gre	ɡreː
greda	ɡrɛda
gredi	ɡrɛdɪ
gredo	ɡrɛdɔ
gref	ɡreːv
grefi	ɡrɛvi
greto	ɡrɛtɔ
grid	ɡrɪd
gril	ɡrɪl
griliau	ɡrɪlja
griliau	ɡrɪljaɨ̯
griliau	ɡrɪljɛ
grilio	ɡrɪljɔ
gris	ɡriːs
grisiau	ɡrɪʃa
gro	ɡroː
groes	ɡroːɨ̯s
groeso	ɡrɔɨ̯sɔ
grog	ɡroːɡ
gronell	ɡrɔnɛɬ
gronellau	ɡrɔnɛɬa
gronellau	ɡrɔnɛɬaɨ̯
gronellau	ɡrɔnɛɬɛ
gronyn	ɡrɔnɨ̞n
gronynnog	ɡrɔnənɔɡ
grug	ɡrɨːɡ
gruga	ɡrɨ̞ɡa
grugo	ɡrɨ̞ɡɔ
grugos	ɡrɨɡɔs
grwban	ɡrʊban
grwpiau	ɡrʊpja
grwpiau	ɡrʊpjaɨ̯
grwpiau	ɡrʊpjɛ
grwth	ɡruːθ
grwys	ɡruːɨ̯s
gryf	ɡrɨːv
grym	ɡrɨ̞m
grymus	ɡrəmɨ̞s
grêt	ɡreːt
grôt	ɡroːt
grŵp	ɡruːp
gu	ɡɨː
gusan	ɡɨ̞san
gusanau	ɡɨ̞sana
gusanau	ɡɨ̞sanaɨ̯
gusanau	ɡɨ̞sanɛ
gusanu	ɡɨ̞sanɨ̞
gut	ɡɨ̞t
gwach	ɡwaːχ
gwacter	ɡwaktɛr
gwactod	ɡwaktɔd
gwacáu	ɡwakaɨ̯
gwadd	ɡwaːð
gwadden	ɡwaðɛn
gwaddod	ɡwaðɔd
gwaddodi	ɡwaðɔdɪ
gwaddodiad	ɡwaðɔdjad
gwadiad	ɡwadjad
gwadn	ɡwaːdn̥
gwadu	ɡwadɨ̞
gwae	ɡwaːɨ̯
gwaed	ɡwaːɨ̯d
gwaedd	ɡwaːɨ̯ð
gwaedded	ɡweɨ̯ðɛd
gwaedu	ɡweɨ̯dɨ
gwael	ɡwaːɨ̯l
gwaell	ɡwaːɨ̯ɬ
gwaelod	ɡweɨ̯lɔd
gwaeth	ɡwaːɨ̯θ
gwaethaf	ɡweɨ̯θa
gwaethaf	ɡweɨ̯θav
gwag	ɡwaːɡ
gwagedd	ɡwaɡɛð
gwagen	ɡwaɡɛn
gwagio	ɡwaɡjɔ
gwahadden	ɡwaðɛn
gwahaddod	ɡwahaðɔd
gwahaniaeth	ɡwahanjaɨ̯θ
gwahaniaeth	ɡwahanjaθ
gwahaniaeth	ɡwahanjɛθ
gwahaniaeth	ɡwanjaθ
gwahaniaeth	ɡwanjɛθ
gwahaniaethiad	ɡwahanjeɨ̯θjad
gwahaniaethu	ɡwahanjeɨ̯θɨ
gwahaniaethu	ɡwanjeɨ̯θɨ
gwahanol	ɡwahanɔl
gwahanu	ɡwahanɨ
gwahardd	ɡwaharð
gwahodd	ɡwahoːð
gwahodd	ɡwahɔð
gwahân	ɡwahaːn
gwain	ɡwai̯n
gwair	ɡwai̯r
gwaith	ɡwai̯θ
gwal	ɡwal
gwaladr	ɡwaladr
gwalch	ɡwalχ
gwall	ɡwaɬ
gwallt	ɡwaːɬd
gwallus	ɡwaɬɨ̞s
gwan	ɡwan
gwanu	ɡwanɨ̞
gwanwyn	ɡwanwɨ̞n
gwanwynau	ɡwanwəna
gwanwynau	ɡwanwənaɨ̯
gwanwynau	ɡwanwənɛ
gwar	ɡwar
gwarchod	ɡwarχɔd
gwared	ɡwarɛd
gwaredu	ɡwarɛdɨ
gwariant	ɡwarjant
gwario	ɡwarjɔ
gwariodd	ɡwarjɔð
gwarthal	ɡwarθal
gwarthegydd	ɡwarθɛɡɨ̞ð
gwarthegyddion	ɡwarθɛɡəðjɔn
gwas	ɡwaːs
gwasanaeth	ɡwasanaɨ̯θ
gwasanaeth	ɡwasanaθ
gwasanaeth	ɡwasanɛθ
gwasanaethau	ɡwasaneɨ̯θa
gwasanaethau	ɡwasaneɨ̯θaɨ̯
gwasanaethau	ɡwasaneɨ̯θɛ
gwasg	ɡwasɡ
gwasgaru	ɡwasɡarɨ
gwasgod	ɡwaskɔd
gwasgu	ɡwasɡɨ̞
gwastad	ɡwasdad
gwastatáu	ɡwastataɨ̯
gwastraff	ɡwasdraf
gwastraffu	ɡwasdrafɨ̞
gwau	ɡwaɨ̯
gwaun	ɡwaɨ̞n
gwawch	ɡwau̯χ
gwawd	ɡwau̯d
gwawl	ɡwau̯l
gwawn	ɡwau̯n
gwawr	ɡwau̯r
gwayw	ɡweɨ̯ʊ
gwaywffon	ɡweɨ̯wfɔn
gwaywffyn	ɡweɨ̯wfɨ̞n
gwbl	ɡʊbl
gwbl	ɡʊbʊl
gwch	ɡʊχ
gwchi	ɡʊχi
gwddf	ɡʊðu
gwddf	ɡʊðv
gwddf	ɡʊðʊv
gwddw	ɡʊðu
gwddwg	ɡʊðʊɡ
gwdihŵ	ɡʊdɪhuː
gwe	ɡweː
gwead	ɡweːad
gweadedd	ɡwɛadɛð
gwedd	ɡweːð
gweddi	ɡwɛðɪ
gweddill	ɡwɛðɪɬ
gweddol	ɡwɛðɔl
gweddw	ɡwɛðu
gweddwon	ɡwɛðwɔn
gweddïau	ɡwɛðiːa
gweddïau	ɡwɛðiːaɨ̯
gweddïau	ɡwɛðiːɛ
gweddïo	ɡwɛðiːɔ
gweddïon	ɡwɛðɪɔn
gweddïwr	ɡwɛðiːʊr
gweddïwyr	ɡwɛðiːwɨ̞r
gweedig	ɡwɛɛdiɡ
gwefan	ɡwɛvan
gwefr	ɡwɛvr
gwegil	ɡwɛɡɪl
gweiddi	ɡwei̯ði
gweilch	ɡwei̯lχ
gweill	ɡwei̯ɬ
gweillen	ɡwei̯ɬɛn
gweinidog	ɡwei̯nɪdɔɡ
gweinidogion	ɡwei̯nɪdɔɡjɔn
gweinydd	ɡwei̯nɨ̞ð
gweinyddes	ɡwei̯nəðɛs
gweinyddesau	ɡwei̯nəðɛsa
gweinyddesau	ɡwei̯nəðɛsaɨ̯
gweinyddesau	ɡwei̯nəðɛsɛ
gweinyddiad	ɡwei̯nəðjad
gweinyddiadau	ɡwei̯nəðjada
gweinyddiadau	ɡwei̯nəðjadaɨ̯
gweinyddiadau	ɡwei̯nəðjadɛ
gweinyddiaeth	ɡwei̯nəðjaɨ̯θ
gweinyddiaeth	ɡwei̯nəðjɛθ
gweinyddiaethau	ɡwei̯nəðjeɨ̯θa
gweinyddiaethau	ɡwei̯nəðjeɨ̯θaɨ̯
gweinyddiaethau	ɡwei̯nəðjeɨ̯θɛ
gweinyddion	ɡwei̯nəðjɔn
gweinyddol	ɡwei̯nəðɔl
gweinyddu	ɡwei̯nəðɨ
gweinyddwr	ɡwei̯nəðʊr
gweinyddwyr	ɡwei̯nəðwɨ̞r
gweiriau	ɡwei̯rja
gweiriau	ɡwei̯rjaɨ̯
gweiriau	ɡwei̯rjɛ
gweision	ɡwei̯ʃɔn
gweithdy	ɡwei̯θdɨ̞
gweithgar	ɡwei̯θɡar
gweithgaredd	ɡwei̯θɡarɛð
gweithio	ɡwei̯θjɔ
gweithiwr	ɡwei̯θjʊr
gweithlu	ɡwei̯θlɨ
gweithluoedd	ɡwei̯θlɨːɔɨ̯ð
gweithred	ɡwei̯θrɛd
gweithredoedd	ɡwei̯θrɛdɔɨ̯ð
gweithredu	ɡwei̯θrɛdɨ
gweithwyr	ɡwei̯θwɨ̞r
gweladwy	ɡwɛladʊɨ̯
gwelais	ɡwɛlai̯s
gwelais	ɡwɛlɛs
gwelais	ɡwɛlɛʃ
gwelais	ɡwɛlɪʃ
gwelaist	ɡwɛlai̯st
gwelaist	ɡwɛlɛst
gweld	ɡwɛld
gweled	ɡwɛlɛd
gweledig	ɡwɛlɛdɪɡ
gwelen	ɡwɛlɛn
gweler	ɡwɛlɛr
gweles	ɡwɛlɛs
gwelet	ɡwɛlɛt
gwell	ɡwɛɬ
gwella	ɡwɛɬa
gwelliant	ɡwɛɬjant
gwellt	ɡweːɬd
gwellta	ɡwɛɬda
gwelsen	ɡwɛlsɛn
gwelwch	ɡwɛlʊχ
gwelwn	ɡwɛlʊn
gwely	ɡwɛlɨ̞
gwelydd	ɡwɛlɨ̞ð
gwen	ɡwɛn
gwenan	ɡwɛnan
gwenci	ɡwɛŋki
gwendid	ɡwɛndɪd
gwenen	ɡwɛnɛn
gwenith	ɡwɛnɪθ
gwenithfaen	ɡwɛnɪθvaɨ̯n
gwennol	ɡwɛnɔl
gwenoliaid	ɡwɛnɔljai̯d
gwenoliaid	ɡwɛnɔljɛd
gwenu	ɡwɛnɨ̞
gwenwyn	ɡwɛnwɨ̞n
gwenwynu	ɡwɛnwənɨ
gwenyn	ɡwɛnɨ̞n
gwenynen	ɡwenənan
gwenynen	ɡwenənɛn
gweoedd	ɡweːɔɨ̯ð
gwep	ɡwɛp
gwerdd	ɡwɛrð
gwerddon	ɡwɛrðɔn
gwerddonau	ɡwɛrðɔna
gwerddonau	ɡwɛrðɔnaɨ̯
gwerddonau	ɡwɛrðɔnɛ
gwerin	ɡwɛrɪn
gweriniaeth	ɡwɛrɪnjaɨ̯θ
gweriniaeth	ɡwɛrɪnjɛθ
gweriniaethau	ɡwɛrɪnjeɨ̯θa
gweriniaethau	ɡwɛrɪnjeɨ̯θaɨ̯
gweriniaethau	ɡwɛrɪnjeɨ̯θɛ
gwerinwr	ɡwɛrɪnʊr
gwerinwyr	ɡwɛrɪnwɨ̞r
gwern	ɡwɛrn
gwernen	ɡwɛrnɛn
gwernog	ɡwɛrnɔɡ
gwers	ɡwɛrs
gwerslyfr	ɡwerslɨ̞vr
gwerslyfr	ɡwerslɨ̞vɨ̞r
gwerth	ɡwɛrθ
gwerthfawrogi	ɡwɛrθvau̯rɔɡɪ
gwerthiant	ɡwɛrθjant
gwerthu	ɡwɛrθɨ̞
gwerthwr	ɡwɛrθʊr
gwerthwyr	ɡwɛrθwɨ̞r
gweryd	ɡwɛrɨ̞d
gwesgyr	ɡwɛsɡɨ̞r
gwest	ɡweːsd
gwestai	ɡwɛsdai̯
gwesteion	ɡwɛsdei̯ɔn
gwestiwn	ɡwɛsdjʊn
gwesty	ɡwɛsdɨ̞
gweu	ɡweɨ̯
gweud	ɡweɨ̯d
gweunydd	ɡweɨ̯nɨ̞ð
gwg	ɡuːɡ
gwib	ɡwiːb
gwiber	ɡwɪbɛr
gwiberlys	ɡwɪbɛrlɨ̞s
gwiberod	ɡwɪbɛrɔd
gwibredyn	ɡwɪbrɛdɨ̞n
gwig	ɡwiːɡ
gwin	ɡwiːn
gwinau	ɡwɪnaɨ̯
gwinoedd	ɡwɪnɔɨ̯ð
gwir	ɡwiːr
gwirf	ɡwɪrv
gwirfoddol	ɡwɪrvɔðɔl
gwirfwy	ɡwɪrvʊɨ̯
gwirion	ɡwɪrjɔn
gwirod	ɡwɪrɔd
gwirodlyn	ɡwɪrɔdlɨ̞n
gwisg	ɡwiːsɡ
gwisga	ɡwɪsɡa
gwisgo	ɡwɪsɡɔ
gwiw	ɡwɪu̯
gwiwer	ɡwɪu̯ar
gwiwerod	ɡwɪu̯ɛrɔd
gwlad	ɡwlaːd
gwladaidd	ɡwladai̯ð
gwladaidd	ɡwladɛð
gwladfa	ɡwladva
gwladfeydd	ɡwladveɨ̯ð
gwladgar	ɡwladɡar
gwladgarol	ɡwladɡarɔl
gwladgarwr	ɡwladɡarʊr
gwladgarwyr	ɡwladɡarwɨ̞r
gwladol	ɡwladɔl
gwlana	ɡwlana
gwlanog	ɡwlanɔɡ
gwledd	ɡwleːð
gwledig	ɡwlɛdɪɡ
gwledydd	ɡwlɛdɨ̞ð
gwleidydd	ɡwlei̯dɨ̞ð
gwleidyddol	ɡwlei̯dəðɔl
gwlith	ɡwliːθ
gwlithen	ɡwlɪθan
gwlithen	ɡwlɪθɛn
gwlithlaw	ɡwlɪθlau̯
gwlw	ɡʊlu
gwlyb	ɡwlɨːb
gwlybaniaeth	ɡwləbanjaɨ̯θ
gwlybaniaeth	ɡwləbanjaθ
gwlybaniaeth	ɡwləbanjɛθ
gwlych	ɡwlɨːχ
gwlychu	ɡləχi
gwlychu	ɡwləχɨ
gwlypach	ɡwləpaχ
gwlypaf	ɡwləpav
gwlân	ɡwlaːn
gwm	ɡʊm
gwnaer	ɡwnaːɨ̯r
gwnaeth	naːθ
gwnaeth	ɡnaːθ
gwnaeth	ɡwnaːɨ̯θ
gwnaethoch	ɡwneɨ̯θɔχ
gwnaethon	ɡwneɨ̯θɔn
gwnaethpwyd	ɡwneɨ̯θpʊɨ̯d
gwnes	ɡwneːs
gwpan	ɡʊpan
gwrando	ɡwrandɔ
gwrdd	ɡʊrð
gwregys	ɡwrɛɡɨ̞s
gwreiddio	ɡwrei̯ðjɔ
gwreiddioldeb	ɡwrei̯ðjɔldab
gwreiddioldeb	ɡwrei̯ðjɔldɛb
gwreiddyn	ɡwrei̯ðɨ̞n
gwrendy	ɡwrɛndɨ
gwres	ɡwreːs
gwresogi	ɡwrɛsɔɡɪ
gwrthdaro	ɡʊrθdarɔ
gwrthdaro	ɡʊrθdaːrɔ
gwrthdystio	ɡʊrθdəsdjɔ
gwrthgyferbyniol	ɡʊrθɡəvɛrbənjɔl
gwrthryfela	ɡʊrθrəvɛla
gwrthryfelgar	ɡʊrθrəvɛlɡar
gwrthryfeloedd	ɡʊrθrəvɛlɔɨ̯ð
gwrthryfelwr	ɡʊrθrəvɛlʊr
gwrthryfelwyr	ɡʊrθrəvɛlwɨ̞r
gwrywaidd	ɡʊrəu̯ai̯ð
gwrywaidd	ɡʊrəu̯ɛð
gwsberen	ɡʊsbɛran
gwsberen	ɡʊsbɛrɛn
gwybed	ɡwəbɛd
gwybodus	ɡwɨ̞bɔdɨ̞s
gwych	ɡwɨːχ
gwychach	ɡwəχaχ
gwyched	ɡwəχɛd
gwyddau	ɡʊɨ̯ða
gwyddau	ɡʊɨ̯ðaɨ̯
gwyddau	ɡʊɨ̯ðɛ
gwyddbwyll	ɡwɨ̞ðbʊɨ̯ɬ
gwydden	ɡwɨ̞ðɛn
gwyddfid	ɡwɨ̞ðvɪd
gwyddonol	ɡwɨ̞ðɔnɔl
gwyddonwyr	ɡwɨ̞ðɔnwɨ̞r
gwyddonydd	ɡwɨ̞ðɔnɨ̞ð
gwyddor	ɡwɨ̞ðɔr
gwydr	ɡwɨ̞dr
gwydr	ɡwɨ̞dɨ̞r
gwydraid	ɡwədrai̯d
gwydrau	ɡwədrɑ
gwydryn	ɡwədrɨ̞n
gwyfyn	ɡwəvɨ̞n
gwylaeth	ɡwəlaɨ̯θ
gwylaeth	ɡwəlaθ
gwylaeth	ɡwəlɛθ
gwylan	ɡʊɨ̯lan
gwylanod	ɡʊɨ̯lanɔd
gwylanwydd	ɡʊɨ̯lanʊɨ̯ð
gwyliau	ɡwɨ̞lja
gwyliau	ɡwɨ̞ljaɨ̯
gwyliau	ɡwɨ̞ljɛ
gwyliedydd	ɡwɨ̞ljɛdɨ̞ð
gwyliedyddion	ɡwɨ̞ljɛdəðjɔn
gwylio	ɡwɨ̞ljɔ
gwylio	ɡwɪljɔ
gwyll	ɡwɨ̞ɬ
gwylog	ɡʊɨ̯lɔɡ
gwylogod	ɡʊɨ̯lɔɡɔd
gwyn	ɡwɨ̞n
gwynnach	ɡwənaχ
gwynnu	ɡwənɨ̞
gwynt	ɡwɨ̞nt
gwyntog	ɡwɨ̞ntɔɡ
gwyrdd	ɡwɨ̞rð
gwyrddfaen	ɡwərðvaɨ̯n
gwyrddion	ɡwərðjɔn
gwâl	ɡwaːl
gwâr	ɡwaːr
gwäell	ɡwaːɛɬ
gwêl	ɡweːl
gwên	ɡweːn
gwëyll	ɡweːɨ̞ɬ
gwŷdd	ɡwɨːð
gwŷl	ɡwɨːl
gyda	ɡɨ̞da
gyfaredd	ɡəvarɛð
gyfarfod	ɡwarvɔd
gyfarfod	ɡəvarvɔd
gyfforddus	ɡəfɔrðɨ̞s
gyffrous	ɡəfrɔɨ̯s
gyfiawnder	ɡəvjau̯ndɛr
gyflym	ɡəvlɨ̞m
gyflymach	ɡəvləmaχ
gyfoethoced	ɡəvɔɨ̯θɔkɛd
gyfoethog	ɡəvɔɨ̯θɔɡ
gyfoethogion	ɡəvɔɨ̯θɔɡjɔn
gyfraith	ɡəvrai̯θ
gyfraith	ɡəvraθ
gyfraith	ɡəvrɛθ
gyfreithiwr	ɡəvrei̯θjʊr
gyfrifol	ɡəvrɪvɔl
gyfun	ɡəvɨ̞n
gylch	ɡɨ̞lχ
gylchgrawn	ɡəlχɡrau̯n
gylchgrawn	ɡɨ̞lχɡrau̯n
gylfin	ɡəlvɪn
gylfinau	ɡəlvɪna
gylfinau	ɡəlvɪnaɨ̯
gylfinau	ɡəlvɪnɛ
gylfinir	ɡəlvɪnɪr
gylfinirod	ɡəlvɪnɪrɔd
gyll	ɡɨ̞ɬ
gyllell	ɡəɬaɬ
gyllell	ɡəɬɛɬ
gymaint	ɡəmai̯nt
gymaint	ɡəmɛnt
gymdeithas	ɡəmdei̯θas
gymedrolwr	ɡəmɛdrɔlʊr
gymedrolwyr	ɡəmɛdrɔlwɨ̞r
gymnasteg	d͡ʒɨ̞mnasdɛɡ
gymnasteg	ɡɨ̞mnasdɛɡ
gymnastwr	d͡ʒɨ̞mnasdʊr
gymnastwr	ɡɨ̞mnasdʊr
gymorth	ɡəmɔrθ
gymryd	ɡəmrɨ̞d
gymylog	ɡəməlɔɡ
gynffon	ɡənfɔn
gyngerdd	ɡəŋɛrð
gynghrair	ɡəŋhrai̯r
gynghrair	ɡəŋhrɛr
gyngor	ɡəŋɔr
gynnon	ɡənɔn
gyrdd	ɡɨ̞rð
gyrfa	ɡərva
gyrru	ɡərɨ̞
gysgu	ɡəsɡɨ
gyson	ɡəsɔn
gystadlu	ɡəsdadlɨ
gythreuliaid	ɡəθreɨ̯ljai̯d
gythreuliaid	ɡəθreɨ̯ljɛd
gâl	ɡaːl
gât	ɡaːt
gêm	ɡeːm
gên	ɡeːn
gïau	ɡiːa
gïau	ɡiːaɨ̯
gïau	ɡiːɛ
gôl	ɡoːl
gôr	ɡoːr
gôt	ɡoːt
gŵydd	ɡuːɨ̯ð
gŵyl	ɡuːɨ̯l
gŵyl	ɡwɪljai̯
gŵyl	ɡʊi̯ljai̯
gŵyll	ɡuːɨ̯ɬ
habad	habad
habadaeth	habadaɨ̯θ
habadaeth	habadɛθ
habadaethau	habadeɨ̯θa
habadaethau	habadeɨ̯θaɨ̯
habadaethau	habadeɨ̯θɛ
habadau	habada
habadau	habadaɨ̯
habadau	habadɛ
habadesau	habadɛsa
habadesau	habadɛsaɨ̯
habadesau	habadɛsɛ
habaty	habatɨ
haber	habɛr
habwyd	habʊɨ̯d
habwydyn	habʊɨ̯dɨ̞n
hach	haːχ
hachos	haχɔs
hachosi	haχɔsi
hachub	haχɨ̞b
hachubwr	haχɨ̞bʊr
hachubwyr	haχɨ̞bwɨ̞r
hactor	haktɔr
hactoresau	haktɔrɛsa
hactoresau	haktɔrɛsaɨ̯
hactoresau	haktɔrɛsɛ
hactorion	haktɔrjɔn
hadar	hadar
hadeilad	hadei̯lad
haden	hadɛn
hadog	hadoɡ
hadolygu	hadɔləɡɨ̞
hadran	hadran
hadu	hadɨ̞
hael	haːɨ̯l
haethnen	heɨ̯θnɛn
haidd	hai̯ð
hail	hai̯l
haint	hai̯nt
hais	hais
halen	halan
halen	halɛn
halibalŵ	halɪbaluː
halid	halɪd
halio	haljɔ
hallt	haːɬd
halmanac	halmanak
halmanaciau	almanakja
halmanaciau	almanakjaɨ̯
halmanaciau	almanakjɛ
halogen	halɔɡɛn
hamgylch	hamɡɨ̞lχ
hamharu	hamharɨ̞
hamod	hamɔd
hamser	hamsar
hamser	hamsɛr
hangen	haŋan
hangen	haŋɛn
hangor	haŋɔr
haniaethol	hanjeɨ̯θɔl
hanifail	hanɪvai̯l
hanifail	hanɪvɛl
hanodd	hanɔð
haprif	haprɪv
hapus	hapɨ̞s
harddangos	harðaŋɔs
hardded	harðɛd
harglwydd	harɡlʊɨ̯ð
hargraffwr	harɡrafʊr
hargraffydd	harɡrafɨ̞ð
haros	harɔs
hathro	haθrɔ
hawliau	haʊ̯lja
hawliau	haʊ̯ljaɨ̯
hawlio	hau̯ljɔ
hechrydu	hɛχrədɨ
hechrydus	hɛχrədɨ̞s
hedd	heːð
heddferch	hɛðvɛrχ
heddwas	hɛðwas
hedfan	hɛdvan
hedyn	hɛdɨ̞n
hefyd	hɛvɨ̞d
heirdd	hei̯rð
heirin	hei̯rɪn
heirlys	hei̯rlɨ̞s
heirlysiau	hei̯rləʃa
heirlysiau	hei̯rləʃaɨ̯
heirlysiau	hei̯rləʃɛ
hela	hɛla
helc	hɛlk
heli	hɛlɪ
help	hɛlp
helpoch	hɛlpɔχ
helpodd	hɛlpɔð
helpon	hɛlpɔn
helpu	hɛlpɨ̞
helpwyr	hɛlpwɨ̞r
helwr	hɛlʊr
helwyr	hɛlwɨ̞r
helyg	hɛlɨ̞ɡ
helyg	hɛlɪɡ
helyntion	hɛləntjɔn
helyntoedd	hɛləntɔɨ̯ð
hemisffer	hɛmɪsfɛr
hen	heːn
henadur	hɛnadɨ̞r
henaint	hɛnai̯nt
hendrefa	hɛndrɛva
hendrefi	hɛndrɛvi
hendrefydd	hɛndrɛvɨ̞ð
hennill	hɛnɪɬ
heno	hɛnɔ
heog	hɛɔɡ
heol	heːɔl
her	hɛr
heraill	hɛraiɬ
heraill	hɛrɪɬ
herwhela	hɛrwhɛla
herwydd	hɛrwɨ̞ð
hesg	heːsɡ
hesgen	hɛsɡɛn
hesgob	hɛsɡɔb
het	hɛt
hetiwr	hɛtjʊr
heuldro	heɨ̯ldrɔ
heuliog	heɨ̯ljɔɡ
heulog	heɨ̯lɔɡ
heulsaf	heɨ̯lsav
heulwen	heɨ̯lwɛn
hi	hiː
hiaaidd	hjaːai̯ð
hidlydd	hɪdlɨ̞ð
hidlyddion	hɪdləðjɔn
hil	hiːl
hiliaeth	hɪljaɨ̯θ
hiliaeth	hɪljɛθ
hiliwr	hɪlɪʊr
hilydd	hɪlɨ̞ð
hilyddol	hɪlɪðɔl
hin	hiːn
hinon	hɪnɔn
hinsawdd	hɪnsau̯ð
hir	hiːr
hirgron	hɪrɡrɔn
hirgrynion	hɪrɡrənjɔn
hirgul	hɪrɡɨ̞l
hirion	hɪrjɔn
hirnod	hɪrnɔd
hirsgwar	hɪrsɡwar
hiâ	hjaː
hoci	hɔkɪ
hoe	hoːɨ̯
hoed	hoːɨ̯d
hoelio	hɔi̯ljɔ
hoelio	hɔɨ̯ljɔ
hoen	hoːɨ̯n
hoetian	hɔɨ̯tjan
hoff	hoːf
hoffest	hɔfɛsd
hoffwn	hɔfʊn
hogiau	hɔɡja
hogiau	hɔɡjaɨ̯
hogiau	hɔɡjɛ
hogldy	hɔɡldɨ̞
hogyn	hɔɡɨ̞n
holi	hɔli
hon	hɔn
hongl	hɔŋl
honna	hɔna
honni	hɔnɪ
honno	hɔnɔ
hun	hɨːn
huna	hɨ̞na
hunangofiaint	hɨ̞nanɡɔvjai̯nt
hunanladdol	hɨ̞nanlaðɔl
hunanladdwr	hi̞nanɬaðʊr
hunanladdwyr	hɨ̞nanlaðwɨ̞r
hunanynysu	hɨnanənəsɨ
hunarddeg	hɨːnarðeːɡ
hurt	hɨ̞rt
hurten	hɨ̞rtɛn
hurtyn	hɨ̞rtɨ̞n
hwnnw	hʊnʊ
hychod	həχɔd
hyd	hɨːd
hydawdd	hədau̯ð
hydoddaf	hədɔða
hydoddaf	hədɔðav
hydoddedd	hədɔðɛð
hydoddedig	hədɔðɛdɪɡ
hydoddeiddio	hədɔðei̯ðjɔ
hydoddi	hədɔðɪ
hydoddiannau	hədɔðjana
hydoddiannau	hədɔðjanaɨ̯
hydoddiannau	hədɔðjanɛ
hydoddiant	hədɔðjant
hydoddion	hədɔðjɔn
hydoddydd	hədɔðɨ̞ð
hydref	hədra
hydref	hədrɛ
hydref	hədrɛv
hydrefau	hədrɛva
hydrefau	hədrɛvaɨ̯
hydrefau	hədrɛvɛ
hydrogen	hədrɔɡɛn
hydrogen	hɨ̞drɔɡɛn
hygyrch	həɡɨ̞rχ
hymenyn	həmɛnɨ̞n
hynna	hɨ̞na
hynny	hənɨ̞
hynod	hənɔd
hynt	hɨ̞nt
hyrddod	hərðɔd
hyrwyddo	hərwɨ̞ðɔ
hyrwyddo	hərʊɨ̯ðɔ
hyrwyddwyr	hərwɨ̞ðwɨ̞r
hyrwyddwyr	hərʊɨ̯ðwɨ̞r
hysb	hɨ̞sb
hysbys	həsbɨ̞s
hysbyseb	həsbəsɛb
hysbysebion	həsbəsɛbjɔn
hysbysebu	həsbəsɛbɨ̞
hysbysu	həsbəsɨ̞
hysgadan	həsɡadan
hysgi	həsɡi
i	iː
i'w	ɪu̯
ia	iːa
ia	ja
iaaidd	jaːai̯ð
iach	jaːχ
iarll	jarɬ
iarllaeth	jarɬaɨ̯θ
iarllaeth	jarɬɛθ
ias	jaːs
iasau	jasa
iasau	jasaɨ̯
iasau	jasɛ
iasoer	jasɔɨ̯r
iasol	jasɔl
iau	jaɨ̯
iawn	jau̯n
ichwi	ɪχwi
iddi	ɪði
iddot	iːðɔt
iddych	iːðɨ̞χ
iddyn	ɪðɨ̞n
iddynt	ɪðɨ̞nt
ie	iːɛ
iechyd	jɛχɨ̞d
ieirll	jei̯rɬ
ieithadur	jeiθadɨ̞r
ieithoedd	jei̯θɔɨ̯ð
ieithydd	jei̯θɨ̞ð
imâm	ɪmaːm
in	ɪn
indiwm	ɪndjʊm
indrawn	ɪndrau̯n
innau	ɪna
innau	ɪnaɨ̯
inni	ɪni
iorwg	jɔrʊɡ
ir	iːr
iridiwm	ɪrɪdjʊm
iro	ɪrɔ
is	iːs
is	iːʃ
isaf	ɪsav
isatomig	iːsatɔmɪɡ
iselder	ɪsɛldar
iselder	ɪsɛldɛr
isetholiad	ɪsɛθɔljad
isfyd	iːsvɨːd
islaw	iːslaːu̯
isod	ɪsɔd
isrywogaeth	iːsrɪu̯ɔɡaɨ̯θ
isrywogaeth	iːsrɪu̯ɔɡɛθ
isteitl	iːsdei̯tl
isteitlau	iːsdei̯tlaɨ̯
isteitlau	iːsdei̯tlɛ
isteitlo	iːsdei̯tlɔ
it	ɪt
ith	iːθ
ithfaen	ɪθvaɨ̯n
iti	ɪti
iwch	ɪu̯χ
iwnifform	ɪu̯nɪfɔrm
iwrch	jʊrχ
iyrchod	jərχɔd
iytan	jətan
iâ	jaː
iâr	jaːr
jac	dʒak
jam	d͡ʒam
je	dʒeː
jip	d͡ʒɪp
jips	d͡ʒɪps
jipsen	d͡ʒɪpsan
jipsen	d͡ʒɪpsɛn
jolihoetian	d͡ʒɔlɪhɔɨ̯tjan
jyngl	d͡ʒəŋɡl
jyngls	d͡ʒəŋɡls
jyst	d͡ʒəsd
jîp	d͡ʒiːp
jîps	d͡ʒiːps
jôc	d͡ʒoːk
lafant	lavant
lama	lama
lamaod	lamaːɔd
lan	lan
lanach	lanaχ
lanaf	lana
lanaf	lanav
lanast	lanasd
lanast	laːnasd
lanc	laŋk
laned	lanɛd
lanhau	lanhaɨ̯
lansio	lanʃɔ
lanthanwm	lanθanʊm
larswydd	larswɨ̞ð
larts	larts
larts	lart͡ʃ
larwm	larʊm
las	laːs
lasach	lasaχ
lased	lasɛd
lasen	lasɛn
lasgoch	lasɡɔχ
lau	laɨ̯
lawen	lau̯an
lawen	lau̯ɛn
lawer	lau̯ɛr
lawes	lau̯ɛs
lawio	lau̯jɔ
lechi	lɛχi
led	leːd
ledled	lɛdlɛd
lefel	lɛvɛl
lefrith	lɛvrɪθ
leicia	lei̯kja
leicia	lɪkja
leician	lei̯kjan
leician	lɪkjan
leicio	lei̯kjɔ
leicio	lɪkjɔ
leidr	lei̯dr
leihau	lei̯haɨ̯
lein	lei̯n
leision	lei̯ʃɔn
lembo	lɛmbɔ
lembos	lɛmbɔs
lemon	lɛmɔn
lemonêd	lɛmɔneːd
lemwn	lɛmʊn
lentyl	lɛntɨ̞l
lentys	lɛntɨ̞s
les	leːs
lesau	lɛsa
lesau	lɛsaɨ̯
lesau	lɛsɛ
lesbiaidd	lɛsbjaɪð
lesddeiliad	leːsðei̯ljad
lesddeiliaid	leːsðei̯ljai̯d
lesddeiliaid	leːsðei̯ljɛd
lesoedd	lɛsɔɨ̯ð
lestair	lɛsdai̯r
lestr	lɛstr
limpin	lɪmpɪn
lin	liːn
lindys	lɪndɨ̞s
lindysyn	lɪndəsɨ̞n
lithiwm	lɪθjʊm
liwio	lɪu̯jɔ
llaeth	ɬaːɨ̯θ
llai	ɬai̯
llaid	ɬai̯d
llanw	ɬanʊ
llaw	ɬaːu̯
llawdriniaeth	ɬaʊdrɪnjaɨ̯θ
llawfeddygon	ɬau̯vɛðəɡɔn
llawlyfr	ɬau̯lɨ̞vɨ̞r
llawn	ɬau̯n
llawr	ɬau̯r
lled	ɬeːd
llefrith	ɬɛvrɪθ
lleiandy	ɬei̯andɨ̞
lleianod	ɬei̯anɔd
llen	ɬɛn
llenni	ɬɛni
llenwad	ɬɛnwad
llenwi	ɬɛnwi
llenydd	ɬɛnɨ̞ð
llenydda	ɬɛnəða
llenyddiaeth	ɬɛnəðjaɨ̯θ
llenyddiaeth	ɬɛnəðjɛθ
llenyddol	ɬɛnəðɔl
lleoedd	ɬeːɔɨ̯ð
lleol	ɬeːɔl
lleoli	ɬɛɔlɪ
lleoliad	ɬɛɔljad
lles	ɬeːs
llesg	ɬeːsɡ
llesgáu	ɬɛsɡaɨ̯
llesol	ɬɛsɔl
llestair	ɬɛsdai̯r
llesteiriannau	ɬɛsdei̯rjana
llesteiriannau	ɬɛsdei̯rjanaɨ̯
llesteiriannau	ɬɛsdei̯rjanɛ
llesteiriant	ɬɛsdei̯rjant
llesteiriau	ɬɛsdei̯rja
llesteiriau	ɬɛsdei̯rjaɨ̯
llesteiriau	ɬɛsdei̯rjɛ
llesáu	ɬɛsaɨ̯
lleu	ɬei̯
lleua	ɬeɨ̯a
lleuad	ɬeɨ̯ad
lleuen	ɬeɨ̯an
lleuen	ɬeɨ̯ɛn
llewod	ɬɛu̯ɔd
llid	ɬiːd
llif	ɬiːv
llifed	ɬɪvɛd
llifo	ɬɪvɔ
llifogydd	ɬivɔɡɨ̞ð
llin	ɬiːn
llinell	ɬɪnaɬ
llinell	ɬɪnɛɬ
llinos	ɬɪnɔs
lliw	ɬɪu̯
llnau	ɬnaɨ̯
llo	ɬoː
lloches	ɬɔχas
lloches	ɬɔχɛs
llochi	ɬɔχi
lloer	ɬoːɨ̯r
llom	ɬɔm
llong	ɬɔŋ
llongwr	ɬɔŋʊr
llonyddwch	ɬɔnəðʊχ
llosgydd	ɬɔsɡɨ̞ð
llost	ɬɔsd
llostchwydd	ɬɔsdχwɨ̞ð
llu	ɬɨː
lluddias	ɬɨ̞ðjas
lluest	ɬɨɛsd
lluesty	ɬjɛsdɨ̞
lluesty	ɬɨɛsdɨ̞
llug	ɬɨːɡ
llugwe	ɬɨ̞ɡwɛ
llungopi	ɬɨːŋɡɔpi
llungopi	ɬɨ̞ŋɡɔpi
llungopïau	ɬɨːŋɡɔpiːa
llungopïau	ɬɨːŋɡɔpiːaɨ̯
llungopïau	ɬɨːŋɡɔpiːɛ
llungopïau	ɬɨ̞ŋɡɔpiːa
llungopïau	ɬɨ̞ŋɡɔpiːaɨ̯
llungopïau	ɬɨ̞ŋɡɔpiːɛ
lluniad	ɬɨ̞njad
llusa	ɬɨ̞sa
llusen	ɬɨ̞san
llusen	ɬɨ̞sɛn
llusg	ɬɨːsɡ
llusgo	ɬɨ̞sɡɔ
lluwch	ɬɨ̞u̯χ
lluyrth	ɬɨːɨ̞rθ
llw	ɬuː
llwch	ɬuːχ
llwfrhau	ɬʊvrhaɨ̯
llwg	ɬuːɡ
llwglyd	ɬʊɡlɨ̞d
llwgu	ɬʊɡɨ
llwm	ɬʊm
llwnc	ɬʊŋk
llwrw	ɬʊru
llwy	ɬuːɨ̯
llwyau	ɬʊɨ̯a
llwyau	ɬʊɨ̯aɨ̯
llwyau	ɬʊɨ̯ɛ
llwybr	ɬʊɨ̯br
llwyd	ɬuːɨ̯d
llwydaidd	ɬʊɨ̯dai̯ð
llwydaidd	ɬʊɨ̯dɛð
llwyrymwrthodol	ɬʊɨ̯rəmʊrθɔdɔl
llwythais	ɬʊi̯θas
llwythais	ɬʊɨ̯θai̯s
llwythau	ɬʊɨ̯θa
llwythau	ɬʊɨ̯θaɨ̯
llwythau	ɬʊɨ̯θɛ
llwythi	ɬʊɨ̯θi
llwytho	ɬʊɨ̯θɔ
llwythodd	ɬʊɨ̯θɔð
llwythydd	ɬʊɨ̯θɨ̞ð
llydan	ɬədan
llyfu	ɬəvɨ̞
llyg	ɬɨːɡ
llygad	ɬɨ̞ɡad
llygru	ɬəɡrɨ
llym	ɬɨ̞m
llyn	ɬɨ̞n
llynedd	ɬənað
llynedd	ɬənɛð
llynedd	ɬɪnɛð
llynnoedd	ɬənɔɨ̯ð
llyriad	ɬərjad
llys	ɬɨːs
llysenw	ɬɨ̞sɛnu
llysenw	ɬɨ̞ːsɛnu
llysfab	ɬɨ̞svab
llysfam	ɬɨ̞svam
llysferch	ɬɨ̞svɛrχ
llysieuol	ɬəʃeɨ̯ɔl
llysieuwyr	ɬəʃeɨ̯wɨ̞r
llythrennol	ɬəθrɛnɔl
llythrennu	ɬəθrɛnɨ
llythyr	ɬəθɨ̞r
llythyren	ɬəθəran
llythyren	ɬəθərɛn
llythyrennau	ɬəθrɛna
llythyrennau	ɬəθərɛnaɨ̯
llythyrennau	ɬəθərɛnɛ
llyw	ɬɨ̞u̯
llywyddion	ɬəu̯əðjɔn
loc	lɔk
lol	lɔl
lolfa	lɔlva
lon	lɔn
loncian	lɔŋkjan
long	lɔŋ
longau	lɔŋa
longau	lɔŋaɨ̯
longau	lɔŋɛ
longwr	lɔŋʊr
longwyr	lɔŋwɨ̞r
loris	lɔrɪs
lorïau	lɔriːa
lorïau	lɔriːaɨ̯
lorïau	lɔriːɛ
lu	lɨː
lud	lɨːd
lun	lɨːn
lwcus	lʊkɨ̞s
lwyddo	lʊɨ̯ðɔ
lwyth	lʊɨ̯θ
lwythais	lʊi̯θas
lwythais	lʊɨ̯θai̯s
lwytho	lʊɨ̯θɔ
lwythodd	lʊɨ̯θɔð
lyd	lɨːd
lydan	lədan
lydanbigau	lədambɪɡa
lydanbigau	lədambɪɡɛ
lydanbigau	lədanbɪɡaɨ̯
lyf	lɨːv
lyfr	lɨ̞vr
lyfr	lɨ̞vɨ̞r
lyfrau	ləvra
lyfrau	ləvraɨ̯
lyfrau	ləvrɛ
lyfrgellydd	ləvrɡɛɬɨ̞ð
lysenw	lɨ̞sɛnu
lysenw	lɨ̞ːsɛnu
lysfab	lɨ̞svab
lysfam	lɨ̞svam
lysferch	lɨ̞svɛrχ
lysiau	ləʃa
lysiau	ləʃaɨ̯
lysiau	ləʃɛ
lysieuol	ləʃeɨ̯ɔl
lysieuwr	ləʃeɨ̯ʊr
lysieuwyr	ləʃeɨ̯wɨ̞r
lywydd	ləu̯ɨ̞ð
lywyddes	ləu̯əðɛs
lywyddiaeth	ləu̯əðjaɨ̯θ
lywyddiaeth	ləu̯əðjɛθ
lywyddiaethau	ləu̯əðjeɨ̯θa
lywyddiaethau	ləu̯əðjeɨ̯θaɨ̯
lywyddiaethau	ləu̯əðjeɨ̯θɛ
lân	laːn
mab	maːb
mabwysiadu	mabʊɨ̯ʃadɨ
macadelgi	makadɛlɡi
macamwn	makamʊn
mach	maːχ
machgen	maχɡɛn
machgenyn	maχɡɛni̞n
macon	makɔn
maconen	makɔnan
maconen	makɔnɛn
maent	maɨ̯nt
maer	maːɨ̯r
magnelwr	maɡnɛlʊr
magnelwyr	maɡnɛlʊr
magnesiwm	maɡnɛsjʊm
magu	maɡɨ
mai	ma
mai	mai̯
mai	mə
maidd	mai̯ð
main	mai̯n
mainc	mai̯ŋk
maint	mai̯nt
maleiswedd	malei̯swɛð
malwoden	malwɔdɛn
malwota	malwɔta
malwr	malʊr
malws	malʊs
mamau	mama
mamau	mamaɨ̯
mamau	mamɛ
mambŵ	mambuː
mamoth	mamɔθ
man	man
manag	manaɡ
maneg	manaɡ
maneg	manɛɡ
manflew	manvlɛu̯
mango	maŋɡɔ
mantais	mantai̯s
mantais	mantɛs
manteision	mantei̯ʃɔn
manyldeb	manəldɛb
manylder	manəldɛr
manyldra	manəldra
manyleb	manəlɛb
manylebau	manəlɛba
manylebau	manəlɛbaɨ̯
manylebau	manəlɛbɛ
manylion	manəljɔn
manylrwydd	manəlrʊɨ̯ð
manylu	manəlɨ̞
manylwch	manəlʊχ
map	map
marchnata	marχnata
marchocáu	marχɔkaɨ̯
marchog	marχɔɡ
marchogaeth	marχɔɡaɨ̯θ
marchogaeth	marχɔɡɛθ
marchogion	marχɔɡjɔn
marchrawn	marχrau̯n
marchredyn	marχrɛdɨ̞n
marddanadl	marðanad
marddanadl	marðanadl
mardon	mardɔn
marnau	marna
marnau	marnaɨ̯
marnau	marnɛ
marnwr	marnʊr
maro	marɔ
marus	marɨ̞s
marw	marʊ
mas	maːs
masen	masan
masen	masɛn
masgau	masɡa
masgau	masɡaɨ̯
masgau	masɡɛ
masgio	masɡjɔ
masnachdy	masnaχdɨ
math	maːθ
mathemateg	maθɛmatɛɡ
mawn	mau̯n
medd	meːð
meddai	mɛða
meddai	mɛðai̯
meddai	mɛðɛ
meddal	mɛðal
meddaliad	mɛðaljad
meddalu	mɛðalɨ̞
medden	mɛðɛn
meddu	mɛðɨ
meddw	mɛðu
meddygaeth	mɛðəɡaɨ̯θ
meddygaeth	mɛðəɡɛθ
meddygfa	mɛðəɡva
meddygfeydd	mɛðəɡveɨ̯ð
meddygol	mɛðəɡɔl
meddylgar	mɛðəlɡar
medren	mɛdrɛn
medro	mɛdrɔ
medru	mɛdrɨ̞
mefus	mɛvɨ̞s
megis	mɛɡɪs
meidrol	mei̯drɔl
meinwen	mei̯nwɛn
meithrinfeydd	mei̯θrɪnveɨ̯ð
meitneriwm	mai̯tnɛrjʊm
meitneriwm	mei̯tnɛrjʊm
melin	mɛlɪn
mellt	meːɬd
mellten	mɛɬdan
mellten	mɛɬdɛn
melltith	mɛɬdɪθ
melltithio	mɛɬdɪθjɔ
melon	mɛlɔn
melyn	mɛlɨ̞n
melyngoch	mɛləŋɡɔχ
melynion	mɛlənjɔn
melynwyn	mɛlənwɨ̞n
melynwyrdd	mɛlənwɨ̞rð
melys	mɛlɨ̞s
melyster	mɛləsdɛr
men	mɛn
menig	mɛnɪɡ
menyw	mɛnɨ̞u̯
menywaidd	mɛnəu̯ai̯ð
menywaidd	mɛnəu̯ɛð
merch	mɛrχ
mercwri	mɛrkʊrɪ
merfenw	mɛrvɛnu
merlen	mɛrlɛn
merlod	mɛrlɔd
merlota	mɛrlɔta
merlotwr	mɛrlɔtʊr
merlyn	mɛrlɨ̞n
merthyr	mɛrθɨ̞r
merthyrdod	mɛrθərdɔd
merthyres	mɛrθərɛs
merthyru	mɛrθərɨ̞
merysbren	mɛrəsbrɛn
meryswydd	mɛrəswɨ̞ð
meryw	mɛrɨ̞u̯
meryw	mɛrɪu̯
mesa	mɛsa
mesur	mɛsɨ̞r
metel	mɛtɛl
meteleg	mɛtɛlɛɡ
metelegol	mɛtɛlɛɡɔl
metelegwr	mɛtɛlɛɡʊr
metelegwyr	mɛtɛlɛɡwɨ̞r
metelegydd	mɛtɛlɛɡɨ̞ð
methan	mɛθan
methanöig	mɛθanoːɪɡ
mether	mɛθɛr
methi	mɛθi
methiant	mɛθjant
metho	mɛθɔ
methu	mɛθɨ̞
metr	mɛtr
metrig	mɛtrɪɡ
mewn	mɨ̞u̯n
mewnanadlu	mɛu̯nanadlɨ̞
mewnblyg	mɛu̯nblɨ̞ɡ
mewnddodiad	mɛu̯nðɔdjad
mewndro	mɛu̯ndrɔ
mewnfodol	mɛu̯nvɔdɔl
mewnforiadwy	mɛu̯nvɔrjadʊɨ̯
mewnforio	mɛu̯nvɔrjɔ
mewnforion	mɛu̯nvɔrjɔn
mewnforiwr	mɛu̯nvɔrjʊr
mewnforwyr	mɛu̯nvɔrwɨ̞r
mewnforyn	mɛu̯nvɔrɨ̞n
mewnfudo	mɛu̯nvɨ̞dɔ
mewngofnodi	mɛu̯ŋɡɔvnɔdi
mewnlifol	mɛu̯nlɪvɔl
mewnol	mɛu̯nɔl
mewnrwyd	mɛu̯nrʊɨ̯d
meysydd	meɨ̯sɨ̞ð
mhabell	m̥abaɬ
mhabell	m̥abɛɬ
mhac	m̥ak
mhacio	m̥akjɔ
mhaith	m̥ai̯θ
mham	m̥am
mhaned	m̥anad
mhaned	m̥anɛd
mhant	m̥ant
mhapur	m̥apɨ̞r
mhara	m̥ara
mharc	m̥ark
mharcio	m̥arkjɔ
mharcio	m̥arkɔ
mharod	m̥arɔd
mharti	m̥artɪ
mhartner	m̥artnar
mhartner	m̥artnɛr
mhartïon	m̥artiːɔn
mhasbort	m̥asbɔrt
mhasta	m̥asda
mhastai	m̥asdai̯
mhawb	m̥au̯b
mhecyn	m̥ɛkɨ̞n
mhedair	m̥ɛdai̯r
mhedair	m̥ɛdɛr
mhedol	m̥ɛdɔl
mhedwar	m̥ɛdwar
mhei	m̥ei
mheint	m̥ei̯nt
mheiriannwr	m̥ei̯rjanʊr
mheiriannwyr	m̥eɨ̯rjanwɨ̞r
mheiriannydd	m̥eɨ̯rjanɨ̞ð
mheis	m̥eis
mhen	m̥ɛn
mhencampwr	m̥ɛŋkampʊr
mhencampwriaeth	m̥ɛŋkampʊrjaɨ̯θ
mhencampwriaeth	m̥ɛŋkampʊrjɛθ
mhencampwriaethau	m̥ɛŋkampʊrjeɨ̯θa
mhencampwriaethau	m̥ɛŋkampʊrjeɨ̯θaɨ̯
mhencampwriaethau	m̥ɛŋkampʊrjeɨ̯θɛ
mhencampwyr	m̥ɛŋkampwɨ̞r
mhenderfynu	m̥ɛndɛrvənɨ̞
mhenglog	m̥ɛŋɡlɔɡ
mhengwin	m̥ɛŋɡwɪn
mhengwiniaid	m̥ɛŋɡwɪnjai̯d
mhengwiniaid	m̥ɛŋɡwɪnjɛd
mherl	m̥ɛrl
mherlau	m̥ɛrla
mherlau	m̥ɛrlaɨ̯
mherlau	m̥ɛrlɛ
mherth	m̥ɛrθ
mherthnasau	m̥ɛrθnasa
mherthnasau	m̥ɛrθnasaɨ̯
mherthnasau	m̥ɛrθnasɛ
mherthynas	m̥ɛrθənas
mheswch	m̥ɛsʊχ
mheth	m̥eːθ
mhethau	m̥ɛθa
mhethau	m̥ɛθaɨ̯
mhethau	m̥ɛθɛ
mhib	m̥iːb
mhibau	m̥ɪba
mhibau	m̥ɪbaɨ̯
mhibau	m̥ɪbɛ
mhibgorn	m̥ɪbɡɔrn
mhig	m̥iːɡ
mhigau	m̥ɪɡa
mhigau	m̥ɪɡaɨ̯
mhigau	m̥ɪɡɛ
mhigwrn	m̥ɪɡʊrn
mhigyn	m̥ɪɡɨ̞n
mhigynnau	m̥ɪɡəna
mhigynnau	m̥ɪɡənaɨ̯
mhigynnau	m̥ɪɡənɛ
mhila	m̥ɪla
mhilaon	m̥ɪlaːɔn
mhinc	m̥ɪŋk
mhincod	m̥ɪŋkɔd
mhiwi	m̥ɪu̯ɪ
mhiwïaid	m̥ɪu̯iːai̯d
mhiwïaid	m̥ɪu̯iːɛd
mhla	m̥laː
mhladur	m̥ladɨ̞r
mhlu	m̥lɨː
mhlymio	m̥ləmjɔ
mhob	m̥oːb
mhobl	m̥ɔbl
mhobl	m̥ɔbɔl
mhobloedd	m̥ɔblɔɨ̯ð
mhoeni	m̥ɔɨ̯nɨ
mhont	m̥ɔnt
mhoptai	m̥ɔptai̯
mhopty	m̥ɔptɨ
mhotel	m̥ɔtal
mhotel	m̥ɔtɛl
mhrif	m̥riːv
mhrifddinas	m̥riːvðɪnas
mhrifddinas	m̥rɪvðɪnas
mhriodas	m̥rjɔdas
mhriodas	m̥rɪɔdas
mhriodi	m̥riɔdi
mhris	m̥riːs
mhris	m̥riːʃ
mhroblem	m̥rɔblam
mhroblem	m̥rɔblɛm
mhroblemau	m̥rɔblɛma
mhroblemau	m̥rɔblɛmaɨ̯
mhroblemau	m̥rɔblɛmɛ
mhrydferth	m̥rədvɛθ
mhryf	m̥rɨːv
mhryfed	m̥rəvad
mhryfed	m̥rəvɛd
mhrynu	m̥rənɨ
mhum	m̥ɨ̞m
mhumdegau	m̥ɨ̞mdɛɡa
mhunnau	m̥ɨ̞na
mhunnau	m̥ɨ̞naɨ̯
mhunnau	m̥ɨ̞nɛ
mhunt	m̥ɨ̞nt
mhwl	m̥ʊl
mhwmpen	m̥ʊmpan
mhwmpen	m̥ʊmpɛn
mhêl	m̥eːl
mi	miː
microdon	mɪkrɔdɔn
mieri	miɛri
mieri	mjɛri
migwyn	mɪɡwɨ̞n
mil	miːl
milcant	milkant
milfeddyg	mɪlvɛðɨ̞ɡ
milfeddyg	mɪlvɛðɪɡ
miliwn	mɪljʊn
miloedd	mɪlɔɨ̯ð
milwr	mɪlʊr
milwrol	mɪlʊrɔl
milwyr	mɪlwɨ̞r
min	miːn
minc	mɪŋk
miniog	mɪnjɔɡ
mis	miːs
mis	miːʃ
mislif	mɪslɪv
mislifol	mɪslɪvɔl
misol	mɪsɔl
mitsio	mɪt͡ʃɔ
mlaidd	mlai̯ð
mlas	mlaːs
mleiddiaid	mlei̯ðjai̯d
mleiddiaid	mlei̯ðjɛd
mleiddiau	mlei̯ðja
mleiddiau	mlei̯ðjaɨ̯
mleiddiau	mlei̯ðjɛ
mlew	mleːu̯
mlewyn	mlɛu̯ɨ̞n
mlodau	mlɔda
mlodau	mlɔdaɨ̯
mlodau	mlɔdɛ
mlodyn	mlɔdɨ̞n
mlog	mlɔɡ
mlows	mlou̯s
mlwydd	mluːɨ̯ð
mlwyddi	mlʊɨ̯ði
mlwyddyn	mlʊɨ̯ðɨ̞n
mlynedd	mlənað
mlynedd	mlənɛð
mlynyddoedd	mlənəðɔɨ̯ð
mnemonig	mnɛmɔnɪɡ
mo	mɔ
moch	moːχ
mochyn	mɔχɨ̞n
mod	moːd
modd	moːð
moddion	mɔðjɔn
model	mɔdɛl
modfedd	mɔdvað
modfedd	mɔdvɛð
modrwy	mɔdrʊɨ̯
modryb	mɔdrɨ̞b
modur	mɔdɨ̞r
moed	moːɨ̯d
moel	moːɨ̯l
moelni	mɔɨ̯lnɪ
moes	moːɨ̯s
moesol	moːɨ̯sɔl
mol	mɔl
mola	mɔla
moleciwlaidd	mɔlɛkiu̯lai̯ð
moleciwlaidd	mɔlɛkiu̯lɛð
moli	mɔli
moliannau	mɔljana
moliannau	mɔljanaɨ̯
moliannau	mɔljanɛ
moliant	mɔljant
moll	mɔɬ
mollt	moːɬd
molybdenwm	mɔlɨ̞bdɛnʊm
moment	mɔmɛnt
moneteiddio	mɔnɛtei̯ðjɔ
mor	mɔr
mordaith	mɔrdai̯θ
mordeithiau	mɔrdei̯θja
mordeithiau	mɔrdei̯θjaɨ̯
mordeithiau	mɔrdei̯θjɛ
mordwy	mɔrdʊɨ̯
mordydd	mɔrdɨ̞ð
more	mɔra
more	mɔrɛ
moresg	mɔrɛsɡ
morfarch	mɔrvarχ
morffoleg	mɔrfɔlɛɡ
morfil	mɔrvɪl
morfilod	mɔrvɪlɔd
morflaidd	mɔrvlai̯ð
morfuwch	mɔrvɨ̞u̯χ
morgeisio	mɔrɡei̯ʃɔ
morgi	mɔrɡi
morgrug	mɔrɡrɨ̞ɡ
morgrugyn	mɔrɡrɨ̞ɡɨ̞n
morio	mɔrjɔ
morlo	mɔrlɔ
moron	mɔrɔn
moronen	mɔrɔnɛn
morthwyl	mɔrθuɨ̯l
morwennol	moːrwɛnɔl
morwennol	mɔrwɛnɔl
morwyn	mɔrʊɨ̯n
moryn	mɔrɨ̞n
morynnau	mɔrəna
morynnau	mɔrənaɨ̯
morynnau	mɔrənɛ
moscofium	mɔsɡɔvjʊm
mosg	mɔsɡ
mosgiau	mɔsɡja
mosgiau	mɔsɡjaɨ̯
mosgiau	mɔsɡjɛ
moth	moːθ
mothau	vɔθa
mothau	vɔθaɨ̯
mothau	vɔθɛ
motél	mɔtɛl
mrain	mrai̯n
mrathu	mraθɨ̞
mrawd	mrau̯d
mrechdan	mrɛχdan
mrecwast	mrɛkwast
mrenhines	mrɛnhɪnas
mrenhines	mrɛnhɪnɛs
mrenin	mrɛnɪn
mrest	mrɛsd
mreuddwyd	mreɨ̯ðʊɨ̯d
mreuddwydio	mreɨ̯ðʊɨ̯djɔ
mreuddwydion	mreɨ̯ðʊɨ̯djɔn
mri	mriː
mricyll	mrɪkɨ̞ɬ
mricyllen	mrɪkəɬɛn
mroc	mrɔk
mroch	mroːχ
mron	mrɔn
mronlas	mrɔnlas
mronleision	mrɔnlei̯ʃɔn
mronnau	mrɔna
mronnau	mrɔnaɨ̯
mrwsio	mrʊʃɔ
mryn	mrɨ̞n
mryniau	mrənja
mryniau	mrənjaɨ̯
mryniau	mrənjɛ
mryoffyt	mrɨːɔfɨ̞t
mrân	mraːn
muchudd	mɨ̞χɨ̞ð
mud	mɨːd
mudan	mɨ̞dan
mudiad	mɨ̞djad
mudo	mɨ̞dɔ
mudol	mɨ̞dɔl
mudoledd	mɨ̞dɔlɛð
mudwr	mɨ̞dʊr
mudydd	mɨ̞dɨ̞ð
mul	mɨːl
munud	mɨ̞nɨ̞d
munudau	mɨ̞nɨ̞da
munudau	mɨ̞nɨ̞daɨ̯
munudau	mɨ̞nɨ̞dɛ
mur	mɨːr
murddun	mɨ̞rðɨ̞n
murddunnod	mɨ̞rðɨ̞nɔd
mursen	mɨ̞rsɛn
mursennod	mɨ̞rsɛnɔd
muwch	mɨu̯χ
mwcws	mʊkʊs
mwg	muːɡ
mwll	mʊɬ
mwmian	mʊmjan
mwnci	mʊŋki
mwy	muːɨ̯
mwya	mʊɨ̯a
mwyara	mʊɨ̯ara
mwyaren	mʊɨ̯aran
mwyaren	mʊɨ̯arɛn
mwyd	muːɨ̯d
mwydod	mʊɨ̯dɔd
mwydyn	mʊɨ̯dɨ̞n
mwyeilch	muɨ̯ei̯lχ
mwyngloddio	mʊɨ̯ŋɡlɔðjɔ
mwyngloddiol	mʊɨ̯ŋɡlɔðjɔl
mwynwr	mʊɨ̯nʊr
mwytho	mʊɨ̯θɔ
mychan	məχan
myfi	məviː
myfyrio	məvərjɔ
myfyriwr	məvərjʊr
myfïol	məviːɔl
mygu	məɡɨ
mygydog	məɡədɔɡ
myn	mɨn
mynach	mənaχ
mynachlog	mənaχlɔɡ
mynachod	mənaχɔd
mynaich	mənai̯χ
mynydd	mənɨ̞ð
mys	miːs
mys	mɨːs
mysedd	məsað
mysedd	məsɛð
mysg	mɨːsɡ
myth	mɨːθ
mân	maːn
mêl	meːl
mêr	meːr
mêt	meːt
mêts	meːts
môl	moːl
môn	moːn
môr	moːr
mẁg	mʊɡ
mỳn	mən
nadlwytho	nadlʊɨ̯θɔ
nadredd	nadrɛð
nag	naɡ
nage	naɡɛ
namyn	namɨ̞n
nant	nant
narn	narn
naw	naːu̯
nawf	nau̯v
nawfed	nau̯vad
nawfed	nau̯vɛd
nawr	nau̯r
naws	nau̯s
ne	neː
neb	neːb
nedd	neːð
nedden	nɛðɛn
nef	neːv
nefaid	nɛvai̯d
nefaid	nɛvɛd
nefoedd	nɛvɔɨ̯ð
nefol	nɛvɔl
nefolaidd	nɛvɔlai̯ð
neg	neːɡ
neges	nɛɡɛs
negeseua	nɛɡɛseɨ̯a
neidiau	nei̯dja
neidiau	nei̯djaɨ̯
neidiau	nei̯djɛ
neidr	nei̯dr
neilen	nei̯lan
neilen	nei̯lɛn
neiliad	nei̯ljad
neiliaid	nei̯ljai̯d
neiliaid	nei̯ljɛd
neiniau	nei̯nja
neiniau	nei̯njaɨ̯
neiniau	nei̯njɛ
neithdar	nei̯θdar
neithiwr	nei̯θjʊr
neithiwyr	nei̯θjʊɨ̯r
nelw	nɛlʊ
nenfwd	nɛnvʊd
neno	nɛnɔ
neon	neːɔn
neptwniwm	nɛptʊnjʊm
nerbyn	nɛrbɨ̞n
nerf	nɛrv
nerthoedd	nɛrθɔɨ̯ð
nerw	nɛru
nerwen	nɛrwɛn
neshi	nɛʃi
neuadd	neɨ̯að
neuaddau	neɨ̯aða
neuaddau	neɨ̯aðaɨ̯
neuaddau	neɨ̯aðɛ
neud	neɨ̯d
neuddegfed	neɨ̯ðɛɡvad
neuddegfed	neɨ̯ðɛɡvɛd
newyddion	nɛu̯əðjɔn
newyn	nɛu̯ɨ̞n
newynau	nɛu̯əna
newynau	nɛu̯ənaɨ̯
newynau	nɛu̯ənɛ
newynllyd	nɛwənɬɨ̞d
ngaeaf	ŋeɨ̯a
ngaeaf	ŋeɨ̯av
ngafr	ŋavr
ngaran	ŋaran
ngardd	ŋarð
ngardd	ŋaːrð
ngeiriadurwr	ŋei̯rjadɨ̞rʊr
ngeiriadurwyr	ŋei̯rjadɨ̞rwɨ̞r
ngelli	ŋɛɬɪ
ngelyn	ŋɛlɨ̞n
ngeneth	ŋɛnɛθ
nghadeiriau	ŋ̊adei̯rja
nghadeiriau	ŋ̊adei̯rjaɨ̯
nghadeiriau	ŋ̊adei̯rjɛ
nghae	ŋ̊aːɨ̯
nghael	ŋ̊aːl
nghael	ŋ̊aːɨ̯l
nghaffi	ŋ̊afi
nghain	ŋ̊ai̯n
nghais	ŋ̊ai̯s
nghalan	ŋ̊alan
nghaled	ŋ̊alad
nghaled	ŋ̊alɛd
nghaledu	ŋ̊alɛdɨ
nghalenigion	ŋ̊alɛnɪɡjɔn
nghalennig	ŋ̊alɛnɪɡ
nghaleted	ŋ̊alɛtɛd
nghalon	ŋ̊alɔn
nghamlas	ŋ̊amlas
nghanolbarthau	ŋ̊anɔlbarθa
nghanolbarthau	ŋ̊anɔlbarθaɨ̯
nghanolbarthau	ŋ̊anɔlbarθɛ
ngharchar	ŋ̊arχar
ngharcharu	ŋ̊arχarɨ̞
nghardinal	ŋ̊ardɪnal
nghardinaliaid	ŋ̊ardɪnaljai̯d
nghardinaliaid	ŋ̊ardɪnaljɛd
nghariad	ŋ̊arjad
ngharreg	ŋ̊araɡ
ngharreg	ŋ̊arɛɡ
ngharthen	ŋ̊arθan
ngharthen	ŋ̊arθɛn
nghastell	ŋ̊asdaɬ
nghastell	ŋ̊asdɛɬ
nghathod	ŋ̊aθɔd
nghawl	ŋ̊au̯l
nghawod	ŋ̊au̯ɔd
nghaws	ŋ̊au̯s
ngheffyl	ŋ̊ɛfɨ̞l
nghefn	ŋ̊ɛvn
nghefnau	ŋ̊ɛvna
nghefnau	ŋ̊ɛvnaɨ̯
nghefnau	ŋ̊ɛvnɛ
nghefnfor	ŋ̊ɛvn̩vɔr
nghegin	ŋ̊ɛɡɪn
nghenhinen	ŋ̊ɛnhɪnan
nghenhinen	ŋ̊ɛnhɪnɛn
ngherdded	ŋ̊ɛrðɛd
ngherddi	ŋ̊ɛrðɪ
ngherddoriaeth	ŋ̊ɛrðɔrjaɨ̯θ
ngherddoriaeth	ŋ̊ɛrðɔrjɛθ
ngherrig	ŋ̊ɛrɪɡ
nghestyll	ŋ̊ɛsdɨ̞ɬ
nghlwb	ŋ̊lʊb
nghlwyfo	ŋ̊lʊɨ̯vɔ
nghnwd	ŋ̊nuːd
nghoch	ŋ̊oːχ
ngholli	ŋ̊ɔɬi
nghosyn	ŋ̊ɔsɨ̞n
nghroes	ŋ̊roːɨ̯s
nghroeso	ŋ̊rɔɨ̯sɔ
nghrug	ŋ̊rɨːɡ
nghrwban	ŋ̊rʊban
nghrwth	ŋ̊ruːθ
nghrwys	ŋ̊ruːɨ̯s
nghut	ŋ̊ɨ̞t
nghwest	ŋ̊weːsd
nghwestiwn	kwɛsdjʊn
nghwpan	ŋ̊ʊpan
nghwpwrdd	ŋ̊ʊpʊrð
nghwrdd	ŋ̊ʊrð
nghychwyn	ŋ̊əχwɨ̞n
nghydbreswylwyr	ŋ̊ɨːdbrɛsʊɨ̯lwɨ̞r
nghyfaill	ŋ̊əvai̯ɬ
nghyfaredd	ŋ̊əvarɛð
nghyfarfod	ŋ̊warvɔd
nghyfarfod	ŋ̊əvarvɔd
nghyfeillion	ŋ̊əvei̯ɬjɔn
nghyfiawnder	ŋ̊əvjau̯ndɛr
nghyfnither	ŋ̊əvnɪθar
nghyfnither	ŋ̊əvnɪθɛr
nghyfreithiwr	ŋ̊əvrei̯θjʊr
nghymedrolwyr	ŋ̊əmɛdrɔlwɨ̞r
nghymorth	ŋ̊əmɔrθ
nghynffon	ŋ̊ənfɔn
nghyngor	ŋ̊əŋɔr
nghynhadledd	ŋ̊ənhadlɛð
nghynnwrf	ŋ̊ənʊrv
nghysawd	ŋ̊əsau̯d
nghysgod	ŋ̊əsɡɔd
nghytgan	ŋ̊ətɡan
nghythraul	ŋ̊əθral
nghythraul	ŋ̊əθraɨ̯l
nghythraul	ŋ̊əθrɛl
nglanach	ŋlanaχ
nglasach	ŋlasaχ
nglased	ŋlasɛd
nglawio	ŋlau̯jɔ
ngleision	ŋlei̯ʃɔn
ngobennydd	ŋɔbɛnɨ̞ð
ngogledd	ŋɔɡlað
ngogledd	ŋɔɡlɛð
ngolau	ŋɔla
ngolau	ŋɔlaɨ̯
ngolau	ŋɔlɛ
ngolchi	ŋɔlχɪ
ngollwng	ŋɔɬʊŋ
ngollwng	ŋʊɬʊn
ngollwng	ŋʊɬʊŋ
ngolwg	ŋɔlʊɡ
ngolygfa	ŋɔləɡva
ngolygfeydd	ŋɔləɡveɨ̯ð
ngorllewin	ŋɔrɬɛu̯ɪn
ngorsaf	ŋɔrsav
ngorwedd	ŋɔrwɛð
ngwallt	ŋwaːɬd
ngwanwyn	ŋwanwɨ̞n
ngwario	ŋwarjɔ
ngwas	ŋwaːs
ngweddi	ŋwɛði
ngweddïo	ŋwɛðɪɔ
ngweld	ŋwɛld
ngwella	ŋwɛɬa
ngwely	ŋwɛlɨ
ngwenoliaid	ŋwɛnɔljai̯d
ngwenoliaid	ŋwɛnɔljɛd
ngwerthu	ŋwɛrθɨ
ngwiber	ŋwɪbɛr
ngwin	ŋwiːn
ngwinoedd	ŋwɪnɔɨ̯ð
ngwiwer	ŋwɪu̯ar
ngwiwer	ŋwɪu̯ɛr
ngwiwerod	ŋwɪu̯ɛrɔd
ngwlad	ŋwlaːd
ngwladfa	ŋwladva
ngwledydd	ŋwlɛdɨ̞ð
ngwres	ŋwreːs
ngwresogi	ŋwrɛsɔɡɪ
ngwybod	ŋwɨ̞bɔd
ngwybod	ŋʊbɔd
ngwybodaeth	ŋwəbɔdaɨ̯θ
ngwybodaeth	ŋwəbɔdɛθ
ngwybodaeth	ŋwɨ̞bɔdaɨ̯θ
ngwybodaeth	ŋwɨ̞bɔdɛθ
ngwych	ŋwɨːχ
ngwychach	ŋwəχaχ
ngwyched	ŋwəχɛd
ngwŷr	ŋwɨːr
ngŵr	ŋuːr
nhad	n̥aːd
nhair	n̥ai̯r
nhaith	n̥ai̯θ
nhalent	n̥alɛnt
nharian	n̥arjan
nhatws	n̥atʊs
nhe	n̥eː
nheigr	n̥ei̯ɡr
nheigrod	n̥ei̯ɡrɔd
nheimlad	n̥ei̯mlad
nheimlo	n̥ei̯mlɔ
nheirw	n̥ei̯ru
nheisen	n̥ei̯san
nheisen	n̥ei̯sɛn
nheisen	n̥ei̯ʃan
nheisen	n̥ei̯ʃɛn
nheisen	n̥ɪʃan
nheisen	n̥ɪʃɛn
nheledu	n̥ɛlɛdɨ
nhelyn	n̥ɛlɨn
nhelynau	n̥ɛləna
nhelynau	n̥ɛlənaɨ̯
nhelynau	n̥ɛlənɛ
nhelynor	n̥ɛlənɔr
nhelynores	n̥ɛlənɔras
nhelynores	n̥ɛlənɔrɛs
nheulu	n̥eɨ̯lɨ
nhew	n̥eːu̯
nhewed	n̥ɛu̯ɛd
nhewi	n̥ɛu̯i
nheyrn	n̥eɨ̯rn
nheyrnaddoliant	n̥eɨ̯rnaðɔljant
nheyrnas	n̥eɨ̯rnas
nhi	n̥iː
nhipyn	n̥ɪpɨ̞n
nhitw	n̥ɪtʊ
nhlodion	n̥lɔdjɔn
nhocyn	n̥ɔkɨ̞n
nhorri	n̥ɔri
nhost	dɔst
nhraed	n̥raːɨ̯d
nhraeth	n̥raːɨ̯θ
nhre	n̥reː
nhrefydd	n̥rɛvɨ̞ð
nhreiglad	n̥rei̯ɡlad
nhreiglo	n̥rei̯ɡlɔ
nhreisiwr	n̥rei̯ʃʊr
nhri	n̥riː
nhriongl	n̥riːɔŋl
nhro	n̥roː
nhroed	n̥roːɨ̯d
nhrwydded	n̥rʊɨ̯ðad
nhrwydded	n̥rʊɨ̯ðɛd
nhrwyddedau	n̥rʊɨ̯ðɛda
nhrwyddedau	n̥rʊɨ̯ðɛdaɨ̯
nhrwyddedau	n̥rʊɨ̯ðɛdɛ
nhrwyn	n̥ruːɨ̯n
nhrydanwr	n̥rədanʊr
nhrydanwyr	n̥rədanwɨ̞r
nhu	n̥ɨː
nhudalen	n̥ɨ̞dalan
nhudalen	n̥ɨ̞dalɛn
nhwll	n̥ʊɬ
nhwrci	n̥ʊrki
nhwthau	nʊθa
nhwthau	n̥ʊθaɨ̯
nhwymyn	n̥ʊɨ̯mɨ̞n
nhybaco	n̥əbakɔ
nhyn	n̥ɨ̞n
nhyrrau	n̥əra
nhyrrau	n̥əraɨ
nhyrrau	n̥ərɛ
nhywyll	n̥əu̯ɨ̞ɬ
nhîm	n̥iːm
nhŵr	n̥uːr
nhŷ	n̥ɨː
ni	niː
nial	niːal
nianc	niːaŋk
nicel	nɪkɛl
nico	nɪkɔ
nicotin	nɪkɔtiːn
nicotin	nɪkɔtɪn
nicotîn	nɪkɔtiːn
nid	nɪd
nifer	nɪvɛr
nifwl	nɪvʊl
nigar	nɪɡar
nigid	nɪɡɪd
nigidau	nɪɡɪda
nigidau	nɪɡɪdaɨ̯
nigidau	nɪɡɪdɛ
nigon	nɪɡɔn
nigwyddiad	nɪɡʊi̯ðjad
nihoniwm	nɪhɔnjʊm
nilledyn	nɪɬɛdɨ̞n
nilyn	nɪlɨ̞n
nilyn	nɪlɪn
ninnau	nɪna
ninnau	nɪnaɨ̯
niobiwm	njɔbjʊm
niobiwm	nɪɔbjʊm
niod	niːɔd
nis	niːs
nisgwyl	nɪsɡʊɨ̯l
nisgyn	nɪsɡɪn
nisgynebau	nɪsɡənɛbaɨ̯
nisgynebau	nɪsɡənɛbɛ
nisgynneb	nɪsɡənɛb
nithio	nɪθjɔ
nitrad	nɪtrad
nitradu	nɪtradɨ̞
nitrogen	nɪtrɔɡɛn
niwclear	nɪu̯klɛar
niwed	nɪu̯ad
niwed	nɪu̯ɛd
niweidio	nɪu̯ei̯djɔ
niweidiol	nɪu̯ei̯djɔl
niwl	nɪu̯l
niwlen	nɪu̯lɛn
niwliog	nɪu̯ljɔɡ
niwlog	nɪu̯lɔɡ
nobeliwm	nɔbɛljʊm
nod	noːd
nodau	nɔda
nodau	nɔdaɨ̯
nodau	nɔdɛ
noddfa	nɔðva
noddi	nɔði
noddwr	nɔðʊr
nodedig	nɔdɛdɪɡ
nodedigrwydd	nɔdɛdɪɡrʊɨ̯ð
nodi	nɔdi
nodrefn	nɔdrɛvn
nodwydd	nɔdwɨ̞ð
nodyn	nɔdɨ̞n
noeth	noːɨ̯θ
noethni	nɔɨ̯θnɪ
nofel	nɔvɛl
nofio	nɔvjɔ
nofiwr	nɔvjʊr
nofwraig	nɔvwrai̯ɡ
nofwyr	nɔvwɨ̞r
noli	nɔli
nolis	nɔlɪs
nos	noːs
nosbarth	nɔsbarθ
nosbarthau	nɔsbarθaɨ̯
nosbarthau	nɔsbarθɛ
noson	nɔsɔn
noswaith	nɔswai̯θ
noswaith	nɔswɛθ
not	nɔt
nraenog	nrɑːɨ̯nɔɡ
nraig	nrai̯ɡ
nrama	nrama
nrwm	nrʊm
nudd	nɨːð
nudden	nɨ̞ðɛn
nwfr	nʊvr
nwy	nuːɨ̯
nwydd	nuːɨ̯ð
nwyddau	nʊɨ̯ða
nwyddau	nʊɨ̯ðaɨ̯
nwyf	nuːɨ̯v
nwyflwydd	nəvlʊɨ̯ð
nwyflwydd	nʊɨ̯vlʊɨ̯ð
nwylo	nʊɨ̯lɔ
nwyon	nʊɨ̯ɔn
nwyrain	nʊɨ̯rain
nwyrain	nʊɨ̯rɛn
nydd	nɨːð
nydden	nəðɛn
nyddu	nəðɨ
nyflwydd	nəvlʊɨ̯ð
nyfrgi	nəvrɡɪ
nymff	nɨ̞mf
nynes	nənɛs
nynoliaeth	nənɔljaɨ̯θ
nynoliaeth	nənɔljɛθ
nyrs	nərs
nyrsio	nərʃɔ
nyrsys	nərsɨ̞s
nysgu	nəsɡɨ̞
nyth	nɨːθ
nythfa	nəθva
nythfeydd	nəθveɨ̯ð
nythu	nəθɨ̞
nâd	naːd
nôl	noːl
o	oː
o	ɔ
o'ch	ɔχ
obennydd	ɔbɛnɨ̞ð
obeutu	ɔbeɨ̯tɨ̞
oblegid	ɔblɛɡɨ̞d
oce	ɔkɛ
ochr	oːχɔr
ochr	ɔχr
ochr	ɔχɔr
ocr	ɔkr
ocsid	ɔksɪd
ocsidaidd	oksɪdai̯ð
ocsidiad	oksɪdjad
ocsidydd	ɔksɪdɨ̞ð
ocsigenu	ɔksɪɡɛnɨ
ocsiwn	ɔkʃʊn
ocsiynau	ɔkʃəna
ocsiynau	ɔkʃənaɨ̯
ocsiynau	ɔkʃənɛ
ocê	ɔkeː
od	ɔd
oddeutu	ɔðeɨ̯tɨ
oddf	ɔðv
oddi	ɔðɪ
odi	ɔdɪ
odl	ɔdl
odrif	ɔdriːv
oed	oːɨ̯d
oedd	oːɨ̯ð
oedi	ɔɨ̯di
oedolion	ɔɨ̯dɔljɔn
oedolyn	ɔɨ̯dɔlɨ̞n
oen	oːɨ̯n
oer	oːɨ̯r
oerach	ɔɨ̯raχ
oerfel	ɔɨ̯rvɛl
oeri	ɔɨ̯rɪ
oes	oːɨ̯s
oesfyr	ɔɨ̯svɨ̞r
ofalus	ɔvalɨ̞s
ofer	ɔvɛr
oferedd	ɔvɛrɛð
ofergoel	ɔvɛrɡɔɨ̯l
offeiriad	ɔfei̯rjad
offer	ɔfar
offer	ɔfɛr
offeren	ɔfɛrɛn
offerennau	ɔfɛrɛna
offerennau	ɔfɛrɛnaɨ̯
offerennau	ɔfɛrɛnɛ
offeryn	ɔfɛrɨ̞n
offerynnau	ɔfɛrəna
offerynnau	ɔfɛrənaɨ̯
offerynnau	ɔfɛrənɛ
offrwm	ɔfrʊm
offrymiad	ɔfrəmjad
offrymu	ɔfrəmɨ̞
offrymwr	ɔfrəmʊr
offrymydd	ɔfrəmɨ̞ð
ofn	ɔvn
ofnadwy	ɔvnadu
ofnadwy	ɔvnadʊɨ̯
ofni	ɔvni
ofyn	ɔvɨ̞n
oganeson	ɔɡanɛsɔn
ogledd	ɔɡlað
ogledd	ɔɡlɛð
ogof	ɔɡɔv
ogofeydd	ɔɡɔvfei̯ð
ogofeydd	ɔɡɔvfeɨ̯ð
ogofâu	ɔɡɔvfaːi̯
ogofâu	ɔɡɔvfaːɨ̯
ogystal	ɔɡəsdal
ogystal	ɔɡəstal
oherwydd	ɔhɛrwɨ̞ð
ohirio	ɔhɪrjɔ
ohonoch	ɔhɔnɔχ
ohonon	ɔhɔnɔn
ohonyn	ɔhɔnɨn
olaf	ɔla
olaf	ɔlav
olau	ɔla
olau	ɔlaɨ̯
olau	ɔlɛ
olchi	ɔlχɪ
olddodiad	oːlðɔdjad
oleuadau	ɔleɨ̯ada
oleuadau	ɔleɨ̯adaɨ̯
oleuadau	ɔleɨ̯adɛ
olew	ɔlɛu̯
olewydd	ɔlɛu̯ɨ̞ð
olewydden	ɔlɛu̯əðɛn
olif	ɔlɪv
olifau	ɔlɪva
olifau	ɔlɪvaɨ̯
olifau	ɔlɪvɛ
olifs	ɔlɪvs
ollwng	ɔɬʊŋ
ollwng	ʊɬʊn
ollwng	ʊɬʊŋ
olwg	ɔlʊɡ
olwyn	ɔlwɨ̞n
olwyn	ɔlʊɨ̯n
olygfa	ɔləɡva
olygfeydd	ɔləɡveɨ̯ð
olygu	ɔləɡɨ̞
olygus	ɔləɡɨ̞s
olynol	ɔlənɔl
olynu	ɔlənɨ̞
ombwdsmon	ɔmbʊdsmɔn
omled	ɔmlɛd
ongl	ɔŋl
onglydd	ɔŋlɨ̞ð
oni	ɔni
onid	ɔnɪd
onn	ɔn
onnen	ɔnan
onnen	ɔnɛn
opteg	ɔptɛɡ
optegol	ɔptɛɡɔl
optegwr	ɔptɛɡʊr
optegydd	ɔptɛɡɨ̞ð
oren	ɔrɛn
orffen	ɔrfan
orffen	ɔrfɛn
organig	ɔrɡanɪɡ
oriau	ɔrja
oriau	ɔrjaɨ̯
oriau	ɔrjɛ
oriawr	ɔrjau̯r
oriel	ɔrjɛl
origami	ɔrɪɡami
orllewin	ɔrɬɛu̯ɪn
ormod	ɔrmɔd
orsaf	ɔrsav
orwedd	ɔrwɛð
os	ɔs
osgiliad	ɔsɡɪljad
osgiliadu	ɔsɡɪljadɨ̞
osgiliadur	ɔsɡɪljadʊr
osgled	ɔsɡlɛd
osgoi	ɔsɡɔi̯
osmiwm	ɔsmjʊm
osod	ɔsɔd
ots	ɔts
ots	ɔtʃ
p'nawn	pnau̯n
p'un	pɨːn
pa	paː
pab	paːb
pabell	pabaɬ
pabell	pabɛɬ
pabi	pabɪ
pabydd	pabɨ̞ð
pabyddiaeth	pabəðjaɨ̯θ
pabyddiaeth	pabəðjɛθ
pabyddion	pabəðjɔn
pabyddol	pabəðɔl
pabïau	pabiːa
pabïau	pabiːaɨ̯
pabïau	pabiːɛ
pac	pak
pacio	pakjɔ
paciodd	pakjɔð
paciwch	pakjʊχ
padell	padaɬ
padell	padɛɬ
pader	padɛr
paent	paːɨ̯nt
paentiad	peɨ̯ntjad
paentiau	peɨ̯ntja
paentiau	peɨ̯ntjaɨ̯
paentiau	peɨ̯ntjɛ
paentio	peɨ̯ntjɔ
paffio	pafjɔ
paffiwr	pafjʊr
paffwyr	pafwɨ̞r
pafin	pavɪn
pafán	pavan
paganiaeth	paɡanjaɨ̯θ
paham	paham
paid	pai̯d
paill	pai̯ɬ
pair	pai̯r
paith	pai̯θ
pajamas	pad͡ʒamas
paladiwm	paladjʊm
palf	palv
palimpsest	palɪmpsɛsd
pall	paɬ
pallu	paɬɨ̞
palmant	palmant
palu	palɨ̞
pam	pam
pan	pan
panasen	panasan
panasen	panasɛn
pandai	pandai̯
pandemig	pandɛmɪɡ
pandemigau	pandɛmɪɡa
pandemigau	pandɛmɪɡaɨ̯
pandemigau	pandɛmɪɡɛ
pandy	pandɨ̞
paned	panad
paned	panɛd
paneidiau	panei̯dja
paneidiau	panei̯djaɨ̯
paneidiau	panei̯djɛ
pannas	panas
pannog	panɔɡ
panog	panɔɡ
pant	pant
pantomeim	pantɔmei̯m
papaia	papai̯a
papur	papɨ̞r
papws	papʊs
para	para
paradwys	paradʊɨ̯s
parafeddyg	paravɛðɨ̞ɡ
parafeddyg	paravɛðɪɡ
paramaethu	parameɨ̯θɨ̞
paratoi	paratɔi̯
paratôdd	paratoːð
parc	park
parch	parχ
parchedig	parχɛdɪɡ
parchu	parχɨ
parchus	parχɨ̞s
parcio	parkjɔ
parcio	parkɔ
parddu	parðɨ̞
pardduo	parðɨːɔ
parhad	par̥aːd
parhau	parhaɨ̯
parod	parɔd
parot	parɔt
parotach	parɔtaχ
paroted	parɔtɛd
parth	parθ
parthau	parθa
parthau	parθaɨ̯
parthau	parθɛ
parti	partɪ
partner	partnar
partner	partnɛr
partïon	partiːɔn
pasbort	pasbɔrt
pasiaf	paʃa
pasiaf	paʃav
pasio	paʃɔ
pasta	pasda
pastai	pasdai̯
pasteiod	pasdei̯ɔd
pastwn	pastʊn
pathew	paθɛu̯
pathewod	paθɛu̯ɔd
patrwm	patrʊm
patrwm	patrʊn
pau	paɨ̯
paun	paɨ̯n
pawb	pau̯b
pawb	pou̯b
pawr	pau̯r
pe	peː
pe	pɛ
pechadur	pɛχadɨ̞r
pechod	pɛχɔd
pechu	pɛχɨ
pecyn	pɛkɨ̞n
pedair	pɛdai̯r
pedair	pɛdɛr
pedol	pɛdɔl
pedolau	pɛdɔla
pedolau	pɛdɔlaɨ̯
pedolau	pɛdɔlɛ
pedoli	pɛdɔlɪ
pedolwr	pɛdɔlʊr
pedolwyr	pɛdɔlwɨ̞r
pedrannu	pɛdranɨ̞
pedrongl	pɛdrɔŋl
pedronglau	pɛdrɔŋla
pedronglau	pɛdrɔŋlaɨ̯
pedronglau	pɛdrɔŋlɛ
pedrsill	pɛdrsɪɬ
pedryn	pɛdrɨ̞n
pedwar	pɛdwar
pedwarawd	pɛdwarau̯d
pedwaredd	pɛdwarað
pedwaredd	pɛdwarɛð
pedwerydd	pɛdwɛrɨ̞ð
pefrwydd	pɛvrwɨ̞ð
pegwn	pɛɡʊn
pei	pei̯
peidio	pei̯djɔ
peint	pei̯nt
peintiau	pei̯ntja
peintiau	pei̯ntjaɨ̯
peintiau	pei̯ntjɛ
peintio	pei̯ntjɔ
peintiwr	pei̯ntjʊr
peintwyr	pei̯ntwɨ̞r
peipen	pei̯pɛn
peiriannau	pei̯rjana
peiriannau	pei̯rjanaɨ̯
peiriannau	pei̯rjanɛ
peirianneg	pei̯rjanɛɡ
peiriannol	pei̯rjanɔl
peiriannwr	pei̯rjanʊr
peiriannwyr	peɨ̯rjanwɨ̞r
peiriannydd	peɨ̯rjanɨ̞ð
peiriant	pei̯rjant
peirianwaith	pei̯rjanwai̯θ
peirianwaith	pei̯rjanwɛθ
peis	peis
peithiau	pei̯θja
peithiau	pei̯θjaɨ̯
peithiau	pei̯θjɛ
pelanllys	pɛlanɬɨ̞s
pelenllys	pɛlɛnɬɨ̞s
pell	pɛɬ
pellach	pɛɬaχ
pellter	pɛɬdɛr
pellweledydd	pɛɬwɛlɛdɨ̞ð
pelydrau	pɛlədra
pelydrau	pɛlədraɨ̯
pen	pɛn
penbleth	pɛmblɛθ
penblethau	pɛmblɛθa
penblethau	pɛmblɛθaɨ̯
penblethau	pɛmblɛθɛ
pencampwr	pɛŋkampʊr
pencampwriaeth	pɛŋkampʊrjaɨ̯θ
pencampwriaeth	pɛŋkampʊrjɛθ
pencampwriaethau	pɛŋkampʊrjeɨ̯θa
pencampwriaethau	pɛŋkampʊrjeɨ̯θaɨ̯
pencampwriaethau	pɛŋkampʊrjeɨ̯θɛ
pencampwyr	pɛŋkampwɨ̞r
pendant	pɛndant
penddu	pɛnðɨ
penderfyniad	pɛndɛrvənjad
penderfyniaeth	pɛndɛrvənjaɨ̯θ
penderfyniaeth	pɛndɛrvənjɛθ
penderfynol	pɛndɛrvənɔl
penderfynu	pɛndɛrvənɨ̞
penderfynwch	pɛndɛrvənʊχ
pendew	pɛndɛu̯
pendolcio	pɛndɔlkjɔ
pendoncio	pɛndɔŋkjɔ
pendonciwr	pɛndɔŋkjʊr
pendrist	pɛndrɪsd
pendro	pɛndro
pendrwm	pɛndrʊm
penelin	pɛnɛlɪn
penfelen	penvɛlɛn
penfelyn	pɛnvɛlɨ̞n
penfras	pɛnvras
penglog	pɛŋɡlɔɡ
pengwin	pɛŋɡwɪn
pengwiniaid	pɛŋɡwɪnjai̯d
pengwiniaid	pɛŋɡwɪnjɛd
peniad	pɛnjad
peniadau	pɛnjada
peniadau	pɛnjadaɨ̯
peniadau	pɛnjadɛ
penillion	pɛnɪɬjɔn
penisel	pɛnɨ̞sɛl
pennaeth	pɛnaɨ̯θ
pennau	pɛna
pennau	pɛnaɨ̯
pennau	pɛnɛ
pennill	pɛnɪɬ
pennod	pɛnɔd
pennog	pɛnɔɡ
pennyg	pɛnɨ̞ɡ
penodol	pɛnɔdɔl
pensaer	pɛnsaːɨ̯r
pensaernïaeth	pɛnsaɨ̯rniːaɨ̯θ
pensaernïaeth	pɛnsɛrniːɛθ
penseiri	pɛnsei̯ri
penseren	pɛnsɛrɛn
pensil	pɛnsɪl
pensiliau	pɛnsɪlja
pensiliau	pɛnsɪljaɨ̯
pensiwn	pɛnʃʊn
pensiynwr	pɛnʃənʊr
pentis	pɛntɪs
pentref	pɛntra
pentref	pɛntrɛ
pentref	pɛntrɛv
pentwr	pɛntʊr
pentyrru	pɛntərɨ
penwag	pɛnwaɡ
perchen	pɛrχɛn
perchennog	pɛrχɛnɔɡ
perchentyaeth	pɛrχɛntɨːaɨ̯θ
perchentyaeth	pɛrχɛntɨːɛθ
perchentyol	pɛrχɛntɨːɔl
perchyll	pɛrχɨ̞ɬ
peren	pɛran
peren	pɛrɛn
perfedd	pɛrvɛð
perfeddion	pɛrvɛðjɔn
perfieri	pɛrviɛrɪ
perfieri	pɛrvjɛrɪ
perihelion	pɛrɪhɛljɔn
perl	pɛrl
perlau	pɛrla
perlau	pɛrlaɨ̯
perlau	pɛrlɛ
perllan	pɛrɬan
permanganad	pɛrmaŋɡanad
perocsid	pɛrɔksɪd
perseiniol	pɛrsei̯njɔl
persli	pɛrslɪ
person	pɛrsɔn
personél	pɛrsɔnɛl
pert	pɛrt
perth	pɛrθ
perthi	pɛrθi
perthnasau	pɛrθnasa
perthnasau	pɛrθnasaɨ̯
perthnasau	pɛrθnasɛ
perthyn	pɛrθɨ̞n
perthynas	pɛrθənas
pery	pɛrɨ
perygl	pɛrɨɡl̩
perygl	pɛrɨɡɨl
peryglus	pɛrəɡlɨ̞s
pesto	pɛsdɔ
peswch	pɛsʊχ
pesychu	pɛsəχɨ̞
peth	peːθ
pethach	pɛθaχ
pethau	pɛθa
pethau	pɛθaɨ̯
pethau	pɛθɛ
petris	pɛtrɪs
petroliwm	pɛtrɔljʊm
petruso	pɛtrɨ̞sɔ
petryal	pɛtrɨːal
petryalau	pɛtrɨ̞ala
petryalau	pɛtrɨ̞alaɨ̯
petryalau	pɛtrɨ̞alɛ
peunaidd	peɨ̯nai̯ð
peunaidd	peɨ̯nɛð
peunes	peɨ̯nɛs
peunesau	peɨ̯nɛsa
peunesau	peɨ̯nɛsaɨ̯
peunesau	peɨ̯nɛsɛ
peunod	peɨ̯nɔd
peunydd	peɨ̯nɨ̞ð
peutu	peɨ̯tɨ̞
phabell	fabaɬ
phabell	fabɛɬ
phac	fak
phacio	fakjɔ
phaciodd	fakjɔð
phaentiad	feɨ̯ntjad
phaith	fai̯θ
phan	fan
phaned	fanad
phaned	fanɛd
phant	fant
phapur	fapɨ̞r
phara	fara
pharatoi	faratɔi̯
pharatôdd	faratoːð
pharc	fark
pharcio	farkjɔ
pharcio	farkɔ
pharhau	farhaɨ̯
pharod	farɔd
pharotach	farɔtaχ
pharoted	farɔtɛd
pharti	fartɪ
phartner	fartnar
phartner	fartnɛr
phartïon	fartiːɔn
phasbort	fasbɔrt
phasta	fasda
phastai	fasdai̯
phawb	fau̯b
phecyn	fɛkɨ̞n
phedair	fɛdai̯r
phedair	fɛdɛr
phedol	fɛdɔl
phedrannu	fɛdranɨ̞
phedwar	fɛdwar
phei	fei
pheidio	feidjɔ
pheint	fei̯nt
pheiriannwr	fei̯rjanʊr
pheiriannwyr	feɨ̯rjanwɨ̞r
pheiriannydd	feɨ̯rjanɨ̞ð
pheis	feis
phen	fɛn
phencampwr	fɛŋkampʊr
phencampwriaeth	fɛŋkampʊrjaɨ̯θ
phencampwriaeth	fɛŋkampʊrjɛθ
phencampwriaethau	fɛŋkampʊrjeɨ̯θa
phencampwriaethau	fɛŋkampʊrjeɨ̯θaɨ̯
phencampwriaethau	fɛŋkampʊrjeɨ̯θɛ
phencampwyr	fɛŋkampwɨ̞r
phenderfynu	fɛndɛrvənɨ̞
phenglog	fɛŋɡlɔɡ
phengwin	fɛŋɡwɪn
phengwiniaid	fɛŋɡwɪnjai̯d
phengwiniaid	fɛŋɡwɪnjɛd
pherl	fɛrl
pherlau	fɛrla
pherlau	fɛrlaɨ̯
pherlau	fɛrlɛ
pherth	fɛrθ
pherthnasau	fɛrθnasa
pherthnasau	fɛrθnasaɨ̯
pherthnasau	fɛrθnasɛ
pherthynas	fɛrθənas
pheswch	fɛsʊχ
pheth	feːθ
phethau	fɛθa
phethau	fɛθaɨ̯
phethau	fɛθɛ
phetroliwm	fɛtrɔljʊm
phib	fiːb
phibau	fɪba
phibau	fɪbaɨ̯
phibau	fɪbɛ
phibgorn	fɪbɡɔrn
phig	fiːɡ
phigau	fɪɡa
phigau	fɪɡaɨ̯
phigau	fɪɡɛ
phigddu	fɨ̞ɡðɨ̞
phigfelyn	fɨ̞ɡvɛlɨ̞n
phigwrn	fɪɡʊrn
phigyn	fɪɡɨ̞n
phigynnau	fɪɡəna
phigynnau	fɪɡənaɨ̯
phigynnau	fɪɡənɛ
phila	fɪla
philaon	fɪlaːɔn
phinc	fɪŋk
phincod	fɪŋkɔd
phiwi	fɪu̯ɪ
phiws	fɪu̯s
phiwïaid	fɪu̯iːai̯d
phiwïaid	fɪu̯iːɛd
phladur	fladɨ̞r
phlu	flɨː
phlwm	flʊm
phlymio	fləmjɔ
phobl	fɔbl
phobl	fɔbɔl
phobloedd	fɔblɔɨ̯ð
phoeni	fɔɨ̯nɨ
phoeth	foːɨ̯θ
phoethach	fɔi̯θaχ
phont	fɔnt
phoptai	fɔptai̯
phopty	fɔptɨ
photel	fɔtal
photel	fɔtɛl
phrif	friːv
phrifddinas	friːvðɪnas
phrifddinas	frɪvðɪnas
phriodas	frjɔdas
phriodas	frɪɔdas
phriodi	friɔdi
phris	friːs
phris	friːʃ
phroblem	frɔblam
phroblem	frɔblɛm
phroblemau	frɔblɛma
phroblemau	frɔblɛmaɨ̯
phroblemau	frɔblɛmɛ
phrydferth	frədvɛθ
phryf	frɨːv
phryfed	frəvad
phryfed	frəvɛd
phrynoch	frənɔχ
phrynodd	frənɔð
phrynon	frənɔð
phrynu	frənɨ
phrysur	frəsɨ̞r
phum	fɨ̞m
phumdegau	fɨ̞mdɛɡa
phunnau	fɨ̞na
phunnau	fɨ̞naɨ̯
phunnau	fɨ̞nɛ
phunt	fɨ̞nt
phur	fɨːr
phwl	fʊl
phwmpen	fʊmpan
phwmpen	fʊmpɛn
phwysig	fʊɨ̯sɪɡ
phyliau	fəlja
phyliau	fəljaɨ̯
phyliau	fəljɛ
physgod	fəsɡɔd
physgodyn	fəsɡɔdɨ̯n
physgota	fəsɡɔta
phêl	feːl
pi	piː
piano	pjano
piau	piːa
piau	piːaɨ̯
piau	piːɛ
pib	piːb
pibau	pɪba
pibau	pɪbaɨ̯
pibau	pɪbɛ
pibell	pɪbɛɬ
piben	pɪbɛn
pibgorn	pɪbɡɔrn
pibo	pɪbɔ
pibonwy	pɪbɔnuɨ̯
pibonwyen	pɪbɔnuɨ̯ɛn
pibydd	pɪbɨ̞ð
picau	pɪka
picau	pɪkaɨ̯
picau	pɪkɛ
picen	pɪkɛn
picil	pɪkɪl
picl	pɪkl
piclau	pɪkla
piclau	pɪklaɨ̯
piclau	pɪklɛ
piclo	pɪklɔ
picls	pɪkls
pics	pɪks
picwnen	pɪkuːnɛn
picwnen	pɪkʊnɛn
picwns	pɪkʊns
pidyn	pɪdɨ̞n
pig	piːɡ
pigan	pɪɡan
pigau	pɪɡa
pigau	pɪɡaɨ̯
pigau	pɪɡɛ
pigddu	pɨ̞ɡðɨ̞
pigfelyn	pɨ̞ɡvɛlɨ̞n
piglas	pɪɡlas
pigwrn	pɪɡʊrn
pigwyn	pɪɡwɨ̞n
pigyn	pɪɡɨ̞n
pigynnau	pɪɡəna
pigynnau	pɪɡənaɨ̯
pigynnau	pɪɡənɛ
pila	pɪla
pilaon	pɪlaːɔn
pilen	pɪlɛn
pilipala	pɪlɪpala
pillffon	pɪɬfɔn
pin	piːn
pin	pɪn
pinafal	piːnaval
pinafal	pɪnaval
pinc	pɪŋk
pincod	pɪŋkɔd
pinwydd	pɪnwɨ̞ð
piod	piːɔd
pioden	piɔdan
pioden	piɔdɛn
pioden	pjɔdan
pioden	pjɔdɛn
pipa	pɪpa
pipai	pɪpai̯
pipan	pɪpan
pipen	pɪpɛn
pipes	pɪpɛs
pipet	pɪpɛt
pipi	pɪpi
pipo	pɪpɔ
pipon	pɪpɔn
piso	pɪsɔ
piston	pɪsdɔn
pitwidol	pɪtui̯dɔl
piw	piːu̯
piwi	pɪu̯ɪ
piws	pɪu̯s
piwïaid	pɪu̯iːai̯d
piwïaid	pɪu̯iːɛd
pla	plaː
pladur	pladɨ̞r
pladuriau	pladɨ̞rja
pladuriau	pladɨ̞rjaɨ̯
pladuriau	pladɨ̞rjɛ
plaen	plaːɨ̯n
plaid	plai̯d
planed	planɛd
planhigion	planhɪɡjɔn
planhigyn	planhɪɡɨ̞n
plannu	planɨ̞
plant	plant
plas	plaːs
plastig	plasdɪɡ
platfform	platfɔrm
platinwm	platɪnʊm
pleidiol	plei̯djɔl
pleidlais	plei̯dlai̯s
pleidleisiau	plei̯dlei̯ʃa
pleidleisiau	plei̯dlei̯ʃaɨ̯
pleidleisiau	plei̯dlei̯ʃɛ
pleidleisio	plei̯dlei̯ʃɔ
plentyn	plɛntɨ̞n
plentynnaidd	plɛntənai̯ð
plentynnaidd	plɛntənɛð
pleth	pleːθ
plethau	plɛθa
plethau	plɛθaɨ̯
plethau	plɛθɛ
plethdorch	plɛθdɔrχ
plethedig	plɛθɛdɪɡ
plethu	plɛθɨ
plethwaith	plɛθwai̯θ
plis	pliːs
plismon	plɪsmɔn
plismones	plismɔnas
plismones	plismɔnɛs
plismyn	plɪsmɨ̞n
plith	pliːθ
plorod	plɔrɔd
ploryn	plɔrɨ̞n
plu	plɨː
pluen	plɨːan
pluen	plɨːɛn
pluf	plɨːv
plufyn	plɨ̞vɨ̞n
plwg	pluːɡ
plwg	plʊɡ
plwm	plʊm
plwmws	plʊmʊs
plwtoniwm	plʊtɔnjʊm
plwyf	pluːɨ̯
plwyf	pluːɨ̯v
plyg	plɨːɡ
plygain	pləɡai̯n
plygain	pləɡɛn
plygiau	pləɡja
plygiau	pləɡjaɨ̯
plygiau	pləɡjɛ
plygio	pləɡjɔ
plygu	pləɡɨ̞
plymer	pləmɛr
plymio	pləmjɔ
plymiwr	pləmjʊr
plymwr	pləmʊr
plymwyr	pləmwɨ̞r
plôr	ploːr
pob	poːb
pobi	pɔbi
pobl	pɔbl
pobl	pɔbɔl
pobloedd	pɔblɔɨ̯ð
poblog	pɔblɔɡ
poblogaidd	pɔblɔɡai̯ð
pobman	pɔbman
pobol	pɔbɔl
poced	pɔkɛd
poed	poːɨ̯d
poen	poːɨ̯n
poena	pɔɨ̯na
poenen	pɔɨ̯nɛn
poeni	pɔɨ̯nɪ
poenit	pɔɨ̯nɪt
poenus	pɔɨ̯nɨ̞s
poenydio	pɔɨ̯nədjɔ
poeth	poːɨ̯θ
poethach	pɔi̯θaχ
poethrawn	poɨ̯θrau̯n
poethwg	pɔɨ̯θʊɡ
polisi	pɔlɪsi
polisïau	pɔlɪsia
polisïau	pɔlɪsiaɨ̯
poloniwm	pɔlɔnjʊm
pont	pɔnt
pontydd	pɔntɨ̞ð
pop	pɔp
popeth	pɔpɛθ
poptai	pɔptai̯
popty	pɔptɨ̞
porchell	pɔrχɛɬ
porfa	pɔrva
porffor	pɔrfɔr
pori	pɔri
porth	pɔrθ
porthiant	pɔrθjant
posib	pɔsɪb
posibil	pɔsɪbɪl
post	poːsd
poster	pɔsdar
poster	pɔsdɛr
posteri	pɔsdɛri
postio	pɔsdjɔ
postmon	pɔsdmon
postmyn	pɔsdmɨ̞n
potasiwm	pɔtasjʊm
potel	pɔtal
potel	pɔtɛl
potes	pɔtas
potes	pɔtɛs
pothell	pɔθɛɬ
pothelli	pɔθɛɬɪ
pothellog	pɔθɛɬɔɡ
pothellu	pɔθɛɬɨ̞
poti	pɔti
potsio	pɔtʃɔ
powdr	pou̯dr
praff	praːf
pragmateg	praɡmatɛɡ
praseodymiwm	prasɛɔdɨ̞mjʊm
prawf	prau̯
prawf	prau̯v
pregeth	prɛɡaθ
pregeth	prɛɡɛθ
pregethu	prɛɡɛθɨ̞
preifat	prei̯vat
preifatrwydd	prei̯vatrʊɨ̯ð
pren	prɛn
pres	preːs
pres	prɛs
presgripsiwn	prɛsɡrɪpʃʊn
preswyl	prɛsʊɨ̯l
preswylio	prɛsʊɨ̯ljo
priapaeth	prjapaɨ̯θ
priapaeth	prɪapaɨ̯θ
pridd	priːð
prif	priːv
prifair	prɪvai̯r
prifardd	prɪvarð
prifathrawes	prɪvaθrau̯ɛs
prifathro	prɪvaθrɔ
prifbwnc	prɪvbʊŋk
prifddinas	priːvðɪnas
prifddinas	prɪvðɪnas
prifeirdd	prɪvei̯rð
priffordd	prɪfɔrð
prifgost	prɪvɡɔsd
prifiau	prɪvja
prifiau	prɪvjaɨ̯
prifiau	prɪvjɛ
prifion	prɪvjɔn
priflythyren	prɪvləθərɛn
prifodl	prɪvɔdl
prifwynt	prɪvwɨ̞nt
prin	priːn
prin	prɪn
prinned	prɪnɛd
printio	prɪntjɔ
priod	priɔd
priodas	prjɔdas
priodas	prɪɔdas
priodi	prjɔdɪ
priodi	prɪɔdɪ
pris	priːs
pris	priːʃ
problem	prɔblam
problem	prɔblɛm
problemau	prɔblɛma
problemau	prɔblɛmaɨ̯
problemau	prɔblɛmɛ
profi	prɔvi
profiad	prɔvjad
profion	prɔvjɔn
promethiwm	prɔmɛθjʊm
prop	prɔp
prosiect	prɔʃɛkt
protactiniwm	prɔtaktɪnjʊm
protest	prɔtɛsd
protestiadau	prɔtɛsdjada
protestiadau	prɔtɛsdjadaɨ̯
protestiadau	prɔtɛsdjadɛ
protestio	prɔtɛsdjɔ
protocol	prɔtɔkɔl
prudd	prɨːð
pryd	prɨːd
prydeinig	prədei̯nɪɡ
pryder	prədar
pryder	prədɛr
prydferth	prədvɛrθ
prydlondeb	prədlɔndab
pryf	prɨː
pryf	prɨːv
pryfed	prəvad
pryfed	prəvɛd
pryfyn	prəvɨ̞n
pryfysol	prəvəsɔl
pryna	prəna
prynhawn	pnau̯n
prynhawn	prənau̯n
prynhawn	prənhau̯n
prynhawn	prɨ̞nhau̯n
prynhawniau	pnau̯nja
prynhawniau	pnau̯njɛ
prynhawniau	prənhau̯nja
prynhawniau	prənhau̯njɛ
prynhawniau	prɨ̞nhau̯nja
prynhawniau	prɨ̞nhau̯njaɨ̯
prynhawniau	prɨ̞nhau̯njɛ
prynoch	prənɔχ
prynodd	prənɔð
prynon	prənɔn
prynu	prənɨ̞
prynwch	prənʊχ
prys	prɨːs
prysglwyn	prəsɡlʊɨ̯n
prysglwyni	prəsɡlʊɨ̯nɪ
prysur	prəsɨ̞r
prŷn	prɨːn
pum	pɨ̞m
pumawd	pɨ̞mau̯d
pumdegau	pɨ̞mdɛɡa
pumed	pɨ̞mad
pumed	pɨ̞mɛd
pumongl	pɨ̞mɔŋl
pump	pɨ̞mp
punnau	pɨ̞na
punnau	pɨ̞naɨ̯
punnau	pɨ̞nɛ
punnoedd	pɨ̞nɔɨ̯ð
punt	pɨ̞nt
pupur	pɨ̞pɨ̞r
pur	pɨːr
puramid	pɨ̞ramɪd
purdeb	pɨ̞rdab
purdeb	pɨ̞rdɛb
pured	pɨ̞rɛd
purlan	pɨ̞rlan
putain	pɨ̞tai̯n
putain	pɨ̞tɛn
puteindy	pɨ̞tei̯ndɨ̞
pwd	puːd
pweru	pʊɛrɨ
pwl	pʊl
pwll	pʊɬ
pwmpen	pʊmpan
pwmpen	pʊmpɛn
pwn	pʊn
pwnc	pʊŋk
pwrpas	pʊrpas
pwy	puːɨ̯
pwy	pʊ
pwyll	puːɨ̯ɬ
pwyllgor	pʊɨ̯ɬɡɔr
pwyllgora	pʊɨ̯ɬɡɔra
pwyllgorau	pʊɨ̯ɬɡɔra
pwyllgorau	pʊɨ̯ɬɡɔraɨ̯
pwyllgorau	pʊɨ̯ɬɡɔrɛ
pwynt	puːɨ̯nt
pwys	puːɨ̯s
pwysau	pʊɨ̯sa
pwysau	pʊɨ̯saɨ̯
pwysau	pʊɨ̯sɛ
pwysi	pʊɨ̯sɪ
pwysig	pʊɨ̯sɪɡ
pwysigrwydd	pʊɨ̯sɪɡrʊɨ̯ð
pwyslais	pʊɨ̯slai̯s
pwysleisio	pʊɨ̯slei̯ʃɔ
pwyso	pʊɨ̯sɔ
pydredd	pədrað
pydredd	pədrɛð
pydru	pədrɨ̞
pyg	pɨːɡ
pyglyd	pəɡlɨ̞d
pyjamas	pəd͡ʒamas
pyliau	pəlja
pyliau	pəljaɨ̯
pyliau	pəljɛ
pylor	pəlɔr
pylu	pəlɨ
pymtheg	pəmθaɡ
pymtheg	pəmθɛɡ
pymthegfed	pəmθɛɡvad
pymthegfed	pəmθɛɡvɛd
pymthegnos	pəmθɛɡnɔs
pyramid	pɨ̞ramɪd
pyrwydd	pɨ̞rwɨ̞ð
pys	pɨːs
pysen	pəsan
pysen	pəsɛn
pysgadain	pəsɡadai̯n
pysgod	pəsɡɔd
pysgodfa	pəsɡɔdva
pysgodle	pəsɡɔdlɛ
pysgodyn	pəsɡɔdɨ̞n
pysgota	pəsɡɔta
pysgotwr	pəsɡɔtʊr
pythefnos	pəθɛvnɔs
pâl	paːl
pâr	paːr
pêl	peːl
pêr	peːr
pìn	pɪn
pŵer	pʊar
pŵer	pʊɛr
pŵl	puːl
pỳg	pəɡ
rabi	rabi
raced	rakɛd
rad	raːd
radio	radjɔ
radiwm	radjʊm
radon	radɔn
radwla	radʊla
raff	raːf
rai	rai̯
randibŵ	randɪbuː
ras	raːs
rasel	rasal
rasel	rasɛl
raser	rasɛr
rasys	rasɨ̞s
rech	reːχ
record	rɛkɔrd
recordiad	rɛkɔrdjad
recordio	rɛkɔrdjɔ
recriwtiaid	rɛkrɪu̯tjai̯d
recriwtiaid	rɛkrɪu̯tjɛd
recríwt	rɛkrɪu̯t
redais	rɛdai̯s
redais	rɛdɛs
redaist	rɛdai̯sd
redaist	rɛdɛsd
redeg	rɛdaɡ
redeg	rɛdɛɡ
rediad	rɛdjad
rediadau	rɛdjada
rediadau	rɛdjadaɨ̯
rediadau	rɛdjadɛ
redoch	rɛdɔχ
redodd	rɛdɔð
redon	rɛdɔn
regen	rɛɡɛn
regennod	rɛɡɛnɔd
regi	rɛɡi
reiat	rei̯at
reis	rei̯s
reit	rei̯t
reolaeth	rɛɔlaɨ̯θ
restr	rɛsdr
rew	reːu̯
rewgell	rɛu̯ɡɛɬ
rewi	rɛu̯i
rhacs	r̥aks
rhad	r̥aːd
rhadlon	r̥adlɔn
rhaeadr	r̥eɨ̯adr
rhaff	r̥aːf
rhafn	r̥avn
rhafnwydd	r̥avnwɨ̞ð
rhag	r̥aɡ
rhagddodiad	r̥aɡðɔdjad
rhagdybiaeth	r̥aɡdəbjaɨ̯θ
rhagdybiaeth	r̥aɡdəbjɛθ
rhagenw	r̥aɡɛnu
rhai	r̥ai̯
rhan	r̥an
rhanbarthau	r̥ambarθa
rhanbarthau	r̥ambarθɛ
rhanbarthau	r̥anbarθaɨ̯
rhanddeiliad	r̥anðei̯ljad
rhanddeiliaid	r̥anðei̯ljai̯d
rhanddeiliaid	r̥anðei̯ljɛd
rhandy	r̥andɨ̞
rhannu	r̥anɨ̞
rhatach	r͈aːtaχ
rhathu	r̥aθɨ̞
rhaw	r̥aːu̯
rhawch	r̥au̯χ
rhawiau	r̥au̯ja
rhawiau	r̥au̯jaɨ̯
rhawiau	r̥au̯jɛ
rhawn	r̥au̯n
rhech	r̥eːχ
rheda	r̥ɛda
rhedais	r̥ɛdai̯s
rhedais	r̥ɛdɛs
rhedaist	r̥ɛdai̯sd
rhedaist	r̥ɛdɛsd
rhediadau	r̥ɛdjada
rhediadau	r̥ɛdjadaɨ̯
rhediadau	r̥ɛdjadɛ
rhedoch	r̥ɛdɔχ
rhedodd	r̥ɛdɔð
rhedon	r̥ɛdɔn
rhedwch	r̥ɛdʊχ
rhedyn	r̥ɛdɨ̞n
rhedynach	r̥ɛdənaχ
rhedynaidd	r̥ɛdənai̯ð
rhedynaidd	r̥ɛdənɛð
rhedynos	r̥ɛdənɔs
rheg	r̥eːɡ
rhegen	r̥ɛɡɛn
rhegennod	r̥ɛɡɛnɔd
rhegfa	r̥ɛɡva
rhegfeydd	r̥ɛɡveɨ̯ð
rhegi	r̥ɛɡi
rhegion	r̥ɛɡjɔn
rheiddiadur	r̥ei̯ðjadɨ̞r
rheiddiau	r̥ei̯ðja
rheiddiau	r̥ei̯ðjaɨ̯
rheiddiau	r̥ei̯ðjɛ
rheiddio	r̥eiðjɔ
rheiddyn	r̥ei̯ðɨ̞n
rheidrwydd	r̥ei̯drʊi̯ð
rheidrwydd	r̥ei̯drʊɨ̯ð
rheilffordd	r̥ei̯lfɔrð
rheina	hei̯na
rheina	r̥ei̯na
rheini	r̥ei̯nɪ
rheniwm	r̥ɛnjʊm
rhent	r̥ɛnt
rhenti	r̥ɛnti
rhentu	r̥ɛntɨ
rhentwr	r̥ɛntʊr
rhentwyr	r̥ɛntwɨ̞r
rheol	r̥eːɔl
rheolaeth	r̥ɛɔlaɨ̯θ
rheolaidd	r̥ɛɔlai̯ð
rheolaidd	r̥ɛɔlɛð
rheolau	r̥ɛɔla
rheolau	r̥ɛɔlaɨ̯
rheolau	r̥ɛɔlɛ
rheoli	r̥ɛɔli
rheoliad	r̥ɛɔljad
rheoliadau	r̥ɛɔljada
rheoliadau	r̥ɛɔljadaɨ̯
rheoliadau	r̥ɛɔljadɛ
rheoliadur	r̥ɛɔljadɨ̞r
rheoliaduron	r̥ɛɔljadɨ̞rɔn
rheolwr	r̥ɛɔlʊr
rheolydd	r̥ɛɔlɨ̞ð
rhes	r̥eːs
rhesi	r̥ɛsi
rhestr	r̥ɛsdr
rhestrau	r̥ɛsdra
rhestrau	r̥ɛsdraɨ̯
rhestrau	r̥ɛsdrɛ
rhestri	r̥ɛsdri
rheswm	r̥ɛsʊm
rhesymol	r̥ɛsəmɔl
rhesymoldeb	r̥ɛsəmɔldɛb
rhew	r̥eːu̯
rhewbwynt	r̥ɛu̯bʊɨ̯nt
rheweiddio	r̥ɛu̯ei̞ðjɔ
rhewgell	r̥ɛu̯ɡɛɬ
rhewi	r̥ɛu̯ɪ
rhewiad	r̥ɛu̯jad
rhewlif	r̥ɛu̯lɪv
rhewlifeg	r̥ɛu̯lɪvɛɡ
rhewlifo	r̥ɛu̯lɪvɔ
rhewlifoedd	r̥ɛu̯lɪvɔɨ̯ð
rhi	r̥iː
rhiain	r̥iai̯n
rhiant	r̥iːant
rhic	r̥ɪk
rhieni	r̥jɛni
rhif	r̥iːv
rhifau	r̥ɪva
rhifau	r̥ɪvaɨ̯
rhifau	r̥ɪvɛ
rhiffio	r̥ɪfjɔ
rhifo	r̥ɪvɔ
rhin	r̥iːn
rhinart	r̥ɪnart
rhingyll	r̥ɨnɡɨɬ
rhiniart	r̥ɪnjart
rhiniog	r̥ɪnjɔɡ
rhinoseros	r̥ɪnɔsɛrɔs
rhith	r̥iːθ
rhithweledigaeth	r̥ɪθwɛlɛdɪɡaɨ̯θ
rhithweledigaeth	r̥ɪθwɛlɛdɪɡɛθ
rhiw	r̥ɪu̯
rho	r̥oː
rhoces	r̥ɔkɛs
rhodd	r̥oːð
rhoddwr	r̥ɔðʊr
rhodiwch	r̥ɔdjʊχ
rhodiwm	r̥ɔdjʊm
rhofio	r̥ɔvjɔ
rhoi	r̥ɔi̯
rhos	r̥oːs
rhosb	r̥ɔsb
rhosmari	r̥ɔsmarɪ
rhosod	r̥ɔsɔd
rhostio	r̥ɔsdjɔ
rhostog	r̥ɔsdɔɡ
rhostogion	r̥ɔsdɔɡjɔn
rhosyn	r̥ɔsɨ̞n
rhosynnau	r̥ɔsəna
rhosynnau	r̥ɔsənaɨ̯
rhosynnau	r̥ɔsənɛ
rhosys	r̥ɔsɨ̞s
rhudd	r̥ɨːð
rhuddgoch	r̥ɨ̞ðɡɔχ
rhuddlas	r̥ɨ̞ðlas
rhuddlasu	r̥ɨ̞ðlasɨ̞
rhuddlaswyn	r̥ɨ̞ðlaswɨ̞n
rhuddog	r̥ɨ̞ðɔɡ
rhuddwyn	r̥ɨ̞ðwɨ̞n
rhuddygl	r̥ɨ̞ðɨ̞ɡl
rhued	r̥ɨɛd
rhwbio	r̥ʊbjɔ
rhwd	r̥uːd
rhwng	r̥ʊŋ
rhwth	r̥uːθ
rhwyd	r̥uːɨ̯d
rhwydd	r̥uːɨ̯ð
rhwyddlwyn	r̥ʊɨ̯ðlʊɨ̯n
rhwydo	r̥ʊɨ̯dɔ
rhwydwaith	r̥ʊi̯dwɛθ
rhwydwaith	r̥ʊɨ̯dwai̯θ
rhwydwaith	r̥ʊɨ̯dwɛθ
rhwydweithio	r̥ʊɨ̯dwei̯θjɔ
rhwyf	r̥uːɨ̯v
rhwyfau	r̥ʊɨ̯va
rhwyfau	r̥ʊɨ̯vaɨ
rhwyfau	r̥ʊɨ̯vɛ
rhwyfo	r̥ʊɨ̯vɔ
rhwyg	r̥uːɨ̯ɡ
rhwygo	r̥ʊɨ̯ɡɔ
rhwyll	r̥uːɨ̯ɬ
rhwyllau	r̥ʊɨ̯ɬa
rhwyllau	r̥ʊɨ̯ɬaɨ̯
rhwyllau	r̥ʊɨ̯ɬɛ
rhwym	r̥uːɨ̯m
rhwymiad	r̥ʊɨ̯mjad
rhwymo	r̥ʊɨ̯mɔ
rhwystr	r̥ʊɨ̯sdr
rhwystrau	r̥ʊɨ̯sdra
rhwystrau	r̥ʊɨ̯sdraɨ̯
rhwystrau	r̥ʊɨ̯sdrɛ
rhwystredig	r̥ʊɨ̯sdrɛdɨ̞ɡ
rhwystredigaeth	r̥ʊɨ̯sdrɛdɨ̞ɡaɨ̯θ
rhwystredigaeth	r̥ʊɨ̯sdrɛdɨ̞ɡaθ
rhwystredigaeth	r̥ʊɨ̯sdrɛdɨ̞ɡɛθ
rhwystredigaethau	r̥ʊɨ̯sdrɛdɨ̞ɡeɨ̯θa
rhwystredigaethau	r̥ʊɨ̯sdrɛdɨ̞ɡeɨ̯θaɨ̯
rhwystredigaethau	r̥ʊɨ̯sdrɛdɨ̞ɡeɨ̯θɛ
rhwystro	r̥ʊɨ̯sdrɔ
rhydau	r̥əda
rhydau	r̥ədaɨ̯
rhydau	r̥ədɛ
rhydd	r̥ɨː
rhydd	r̥ɨːð
rhyddfarn	r̥əðvarn
rhyddfraint	r̥əðvrai̯nt
rhyddfreiniad	r̥əðvrei̯njad
rhyddfreinio	r̥əðvrei̯njɔ
rhyddfreiniwr	r̥əðvrei̯njʊr
rhyddfrydedd	r̥ɪðvrɪdɛð
rhyddfrydiaeth	r̥ɪðvrɪðjaɪθ
rhyddfrydol	r̥ɨːðvrədɔl
rhyddfrydol	r̥ɨ̞ðvrədɔl
rhyddhad	r̥əðhaːd
rhyddhaf	r̥əðhaːv
rhyddhau	r̥əðhaɨ̯
rhyddid	r̥əðɪd
rhydni	r̥ədnɪ
rhydwythol	r̥əduːɨ̯θɔl
rhyfedd	r̥əvað
rhyfedd	r̥əvɛð
rhyfeddu	r̥əvɛðɨ̞
rhyfel	r̥əval
rhyfel	r̥əvɛl
rhyfela	r̥əvɛla
rhyfelwr	r̥əvɛlʊr
rhyfelwyr	r̥əvɛlwɨ̞r
rhyg	r̥ɨːɡ
rhygwenith	r̥əɡwɛnɪθ
rhyn	r̥ɨ̞n
rhynion	r̥ənjɔn
rhywbeth	r̥ɨu̯baθ
rhywbeth	r̥ɨu̯bɛθ
rhywbeth	r̥ɪu̯baθ
rhywbeth	r̥ɪu̯bɛθ
rhywbeth	r̥ʊbaθ
rhywbeth	r̥ʊbɛθ
rhywbryd	r̥ɨu̯brɨ̞d
rhywbryd	r̥ɪu̯brɨ̞d
rhywle	r̥ɨu̯la
rhywle	r̥ɨu̯lɛ
rhywle	r̥ɪu̯la
rhywle	r̥ɪu̯lɛ
rhywle	r̥ʊla
rhywle	r̥ʊlɛ
rhywogaeth	r̥ɪu̯ɔɡaɨ̯θ
rhywogaeth	r̥ɪu̯ɔɡɛθ
rhywsut	r̥ɨu̯sɨ̞t
rhywsut	r̥ɪu̯sɨ̞t
rhywun	r̥ɨu̯ɨ̞n
rhywun	r̥ɪu̯ɨ̞n
ricriwtiaid	rɪkrɪu̯tjai̯d
ricriwtiaid	rɪkrɪu̯tjɛd
ricríwt	rikrɪu̯t
rif	riːv
ril	riːl
riliau	jrɪla
riliau	rɪljaɨ̯
riliau	rɪljɛ
rils	riːls
rith	riːθ
ro	roː
ro'ch	rɔχ
roc	rɔk
rod	roːd
roedd	roːɨ̯ð
roeddech	rɔɨ̯ðaχ
roeddech	rɔɨ̯ðɛχ
roedden	rɔɨ̯ðan
roedden	rɔɨ̯ðɛn
roeddet	rɔɨ̯ðat
roeddet	rɔɨ̯ðɛt
roeddwn	rɔɨ̯ðʊn
roentgeniwm	rɛntɡɛnjʊm
roi	rɔi̯
rondefŵ	rɔndɛvuː
rosmari	rɔsmarɪ
rosod	rɔsɔd
rosynnau	rɔsəna
rosynnau	rɔsənaɨ̯
rosynnau	rɔsənɛ
rosys	rɔsɨ̞s
rownd	rɔu̯nd
rutherffordiwm	rəðərfɔrdjʊm
rw	rʊ
rwber	rʊbɛr
rwbidiwm	rʊbɪdjʊm
rwtheniwm	rʊθɛnjʊm
rwy	ruːɨ̯
rwyd	ruːɨ̯d
rwyf	ruːɨ̯v
rwyfau	rʊɨ̯va
rwyfau	rʊɨ̯vaɨ
rwyfau	rʊɨ̯vɛ
rwyfo	rʊɨ̯vɔ
rwyt	ruːɨ̯t
ry	rɨː
rybela	rəbɛla
rydd	rɨːð
ryddhaf	rəðhaːv
ryddhau	rəðhaɨ̯
ryddid	rəðɪd
rydw	rədu
rydw	rədw
rydych	rədɨ̞χ
ryfelwr	rəvɛlʊr
ryfelwyr	rəvɛlwɨ̞r
rygbi	rəɡbi
ryseitiau	rəsei̯tja
ryseitiau	rəsei̯tjaɨ̯
ryseitiau	rəsei̯tjɛ
rysáit	rəsai̯t
rywbeth	rɨu̯baθ
rywbeth	rɨu̯bɛθ
rywbeth	rɪu̯baθ
rywbeth	rɪu̯bɛθ
rywbeth	rʊbaθ
rywbeth	rʊbɛθ
rywbryd	rɨu̯brɨ̞d
rywbryd	rɪu̯brɨ̞d
rywle	rɨu̯la
rywle	rɨu̯lɛ
rywle	rɪu̯la
rywle	rɪu̯lɛ
rywle	rʊla
rywle	rʊlɛ
rywsut	rɨu̯sɨ̞t
rywsut	rɪu̯sɨ̞t
rywun	rɨu̯ɨ̞n
rywun	rɪu̯ɨ̞n
rŵan	ruːan
sach	saːχ
sachell	saχɛɬ
saer	saːɨ̯r
saeth	saːɨ̯θ
saethdwll	sei̯θdʊɬ
saethu	seɨ̯θɨ
saethwr	seɨ̯θʊr
saethwyr	seɨ̯θwɨ̞r
saethyddiaeth	seɨ̯θəðjaɨ̯θ
saethyddiaeth	seɨ̯θəðjɛθ
safbwynt	savbʊɨ̯nt
saff	saːf
saffari	safarɪ
safle	savlɛ
safon	savɔn
safri	savri
saib	sai̯b
saif	sai̯v
saig	sai̯ɡ
sail	sai̯l
saim	sai̯m
saim	saːm
sain	sai̯n
saint	sai̯nt
saith	sai̯θ
salad	salad
salamandr	salamandr
sallwyr	saɬʊɨ̯r
salm	salm
saltring	saltrɪŋ
salw	salu
salwch	salʊχ
samariwm	samarjʊm
sanctaidd	saŋktai̯ð
sancteiddier	saŋktei̯ðjɛr
sancteiddio	saŋktei̯ðjɔ
sancteiddrwydd	saŋktei̯ðrʊɨ̯ð
sandio	sandjɔ
sant	sant
santes	santas
santes	santɛs
santesau	santɛsa
santesau	santɛsaɨ̯
santesau	santɛsɛ
sarff	sarf
sarhad	sarhaːd
sarhau	sarhaɨ̯
sarhaus	sarhaɨ̯s
sashimi	saʃɪmɪ
sawdd	sau̯ð
sawdl	sau̯dl
sawl	sau̯l
sawr	sau̯r
sawrus	sau̯rɨ̞s
saws	sau̯s
sawsiau	sau̯ʃa
sawsiau	sau̯ʃaɨ̯
sawsiau	sau̯ʃɛ
sba	sbaː
sbriws	sbrɪu̯s
sbwliau	sbʊlja
sbwliau	sbʊljaɨ̯
sbwlio	sbʊljɔ
sbwriel	sbʊrjal
sbwriel	sbʊrjɛl
sbâr	sbaːr
sbŵl	sbuːl
scandiwm	sɡandjʊm
sdim	sdɪm
se	sɛ
seaborgiwm	sɪbɔrɡjʊm
sebon	sɛbɔn
sebonllyd	sɛbɔnɬɨ̞d
sebra	sebra
sebraod	sebraːɔd
sebras	sebras
sedd	seːð
seddi	sɛði
sef	seːv
sefwch	sɛvʊχ
sefydlog	sɛvədlɔɡ
sefydlogi	sɛvədlɔɡi
sefydlu	sɛvədlɨ
sefyll	sɛvɨ̞ɬ
sefyllfa	sɛvəɬva
sefyllfaoedd	sɛvəɬvaːɔɨ̯ð
segur	sɛɡɨ̞r
seibiau	sei̯bja
seibiau	sei̯bjaɨ̯
seibiau	sei̯bjɛ
seiclo	sei̯klɔ
seicloch	sei̯klɔχ
seiclodd	sei̯klɔð
seiclon	sei̯klɔn
seiclwr	sei̯klʊr
seidr	sei̯dɪr
seineg	sei̯nɛɡ
seler	sɛlar
seler	sɛlɛr
selsig	sɛlsɪɡ
senana	sɛnana
senedd	sɛnɛð
senon	sɛnɔn
ser	sɛr
serch	sɛrχ
serchog	sɛrχɔɡ
seremoni	sɛrɛmɔni
seren	sɛrɛn
serenllys	sɛrɛnɬɨ̞s
sero	sɛrɔ
seryddiaeth	sɛrəðjaɨ̯θ
sesh	sɛʃ
sesiwn	sɛʃʊn
sesiynau	sɛʃəna
sesiynau	sɛʃənaɨ̯
sesiynau	sɛʃənɛ
sgarff	sɡarf
sgen	sɡɛn
sgerbwd	sɡɛrbʊd
sgert	sɡɛrt
sgil	sɡiːl
sgil	sɡɪl
sgileffaith	sɡiːlɛfai̯θ
sgileffaith	sɡiːlɛfɛθ
sgipio	sɡɪpjɔ
sgiwen	sɡiu̯ɛn
sglodion	sɡlɔdjɔn
sglodyn	sɡlɔdɨ̞n
sgorio	sɡɔrjɔ
sgorpion	sɡɔrpjɔn
sgramblo	sɡramblɔ
sgrechian	sɡrɛχjan
sgri	sɡriː
sgriau	sɡriːa
sgriau	sɡriːaɨ̯
sgriau	sɡriːɛ
sgrin	sɡriːn
sgriniau	sɡrɪnja
sgriniau	sɡrɪnjaɨ̯
sgriniau	sɡrɪnjɛ
sgrinio	sɡrinjɔ
sgwariau	sɡwarja
sgwariau	sɡwarjaɨ̯
sgwariau	sɡwarjɛ
sgynni	sɡənɪ
sgynno	sɡənɔ
sgynnoch	sɡənɔχ
sgynnon	sɡənɔn
sgynnyn	sɡənɨ̞n
sgyrsiol	sɡərʃɔl
sgìl	sɡɪl
sgïo	sɡiɔ
sgôr	sɡoːr
shibwns	ʃɪbʊns
shibwnsyn	ʃɪbʊnsɨ̞n
shrwmsa	ʃrʊmsa
si	siː
siaced	ʃakad
siaced	ʃakɛd
siafio	ʃavjɔ
siampên	ʃampeːn
siani	ʃanɪ
sianis	ʃanɪs
siapiau	ʃapja
siapiau	ʃapjai̯
siapiau	ʃapjaɨ̯
siapiau	ʃapjɛ
siarad	ʃarad
siaradwr	ʃaradʊr
siaradwyr	ʃaradwɨ̞r
sied	ʃɛd
siei	ʃei̯
sifil	sɪvɪl
silicon	sɪlɪkɔn
silwair	sɪlwai̯r
sin	siːn
sinc	sɪŋk
sinsir	sɪnsɪr
siobyn	ʃɔbɪn
sioc	ʃɔk
siocled	ʃɔklad
siocled	ʃɔklɛd
siocledi	ʃɔklɛdi
sioe	ʃoːɨ̯
sioeau	ʃɔɨ̯a
sioeau	ʃɔɨ̯aɨ̯
siom	ʃɔm
siomau	ʃɔma
siomau	ʃɔmaɨ̯
siomau	ʃɔmɛ
siomedig	ʃɔmɛdɪɡ
siomi	ʃɔmi
sionc	ʃɔŋk
siopwr	ʃɔpʊr
siort	ʃɔrt
sir	siːr
sir	ʃiːr
sirconiwm	sɪrkɔnjʊm
sirol	sɪrɔl
siswrn	sɪsʊrn
siswrn	sɪʃʊn
siswrn	ʃɪʃʊn
siwgr	ʃʊɡr
siwgr	ʃʊɡʊr
siwmae	smaːɨ̯
siwmae	sɨmaːɨ̯
siwmae	ʃɨmaːɨ̯
siwmper	ʃʊmpɛr
siwmperi	ʃʊmpɛri
siwr	ʃuːr
siwrnai	ʃʊrna
siwrnai	ʃʊrnai̯
siwrnai	ʃʊrnɛ
siwrwd	ʃʊrʊd
siwt	sɪu̯t
siâp	ʃaːp
siŵr	ʃuːr
slaf	slaːv
slebog	slɛbɔɡ
slej	slɛd͡ʒ
slejys	slɛd͡ʒɨ̞s
sliper	slɪpɛr
slorwm	slɔrʊm
smot	smɔt
smwddio	smʊðjɔ
smygu	sməɡɨ
snwcer	snʊkar
snwcer	snʊkɛr
so	soː
soch	soːχ
soddi	sɔði
sodiwm	sɔdjʊm
sodlau	sɔdla
sodlau	sɔdlaɨ̯
sodlau	sɔdlɛ
sodor	sɔdɔr
sodro	sɔdrɔ
soeglyd	sɔi̯ɡlɪd
soeglyd	sɔɨ̯ɡlɨ̞d
soffa	sɔfa
sofren	sɔvrɛn
sorgwm	sɔrɡʊm
sorod	sɔrɔd
sorth	sɔrθ
sos	soːs
sosban	sɔsban
sosej	sɔsɛd͡ʒ
sosialaeth	sɔʃalaɨ̯θ
sosialaidd	sɔʃalai̯ð
sosialydd	sɔʃalɨ̞ð
sosys	sɔsɨ̯s
sothach	sɔθaχ
sownd	sou̯nd
spleinsio	sblei̯nʃɔ
staen	sdaːɨ̯n
stafell	sdavaɬ
stafell	sdavɛɬ
staff	sdaf
stamp	sdamp
stampiau	stampja
steiloffôn	sdei̯lɔfoːn
stemar	sdɛmar
stemars	sdɛmars
stemio	sdɛmjɔ
stethosgop	sdɛθɔsɡɔp
stigma	stɪɡma
stiwdio	sdɪu̯djɔ
stopi	sdɔpi
stopiem	sdɔpjɛm
stopio	sdɔpjɔ
stori	sdɔrɪ
stormus	stɔrmɨ̞s
storïau	sdɔriːa
storïau	sdɔriːaɨ̯
storïau	sdɔriːɛ
strach	sdraːχ
straeon	sdreɨ̯ɔn
streic	sdrei̯k
streiciau	sdrei̯kja
streiciau	sdrei̯kjaɨ̯
streiciau	sdrei̯kjɛ
streicio	sdrei̯kjɔ
streicwr	strɛikʊr
streip	sdrei̯p
strontiwm	sdrɔntjʊm
strwythur	strʊɨ̯θɨ̞r
stryd	sdrɨːd
stwnsh	sdʊnʃ
stwnsio	sdʊnʃɔ
stwrsiwn	sdʊrʃʊn
stwrsiynod	sdʊrʃənɔd
styfnig	sdəvnɪɡ
stêm	sdeːm
stôl	stoːl
stŵr	sduːr
sudd	sɨːð
sumbol	sɨ̞mbɔl
sunthesis	sɨ̞nθɛsɪs
sur	sɨːr
suran	sɨ̞ran
suranen	sɨ̞ranɛn
surdoes	sɨ̞rdɔɨ̯s
sustem	sɨ̞sdɛm
sut	sɨ̞d
sut	sɨ̞t
sw	suː
swch	suːχ
swigen	swɪɡan
swigen	swɪɡɛn
swigod	swɪɡan
swigod	swɪɡɛn
swil	swɪl
switsh	swɪt͡ʃ
switshys	swɪtʃɨ̞s
switsio	swɪtʃɔ
swllt	suːɬd
swm	sʊm
swn	sʊn
swnian	sʊnjan
swnio	sʊnjɔ
swnllyd	sʊnɬɨ̞d
swnt	sʊnt
swoleg	sʊɔlɛɡ
swolegydd	sʊɔlɛɡɨ̞ð
swper	sʊpar
swper	sʊpɛr
swrth	sʊrθ
swshi	suːʃi
swshi	sʊʃi
swydd	suːɨ̯ð
swyddfa	sʊɨ̯ðva
swyddfeydd	sʊɨ̯ðveɨ̯ð
swyddi	sʊɨ̯ði
swyddog	sʊɨ̯ðɔɡ
swyddogaeth	sʊɨ̯ðɔɡaɨ̯θ
swyddogaeth	sʊɨ̯ðɔɡɛθ
swyddwr	sʊɨ̯ðʊr
swyn	suːɨ̯n
swyno	sʊɨ̯nɔ
swynol	sʊɨ̯nɔl
sy	sɨː
sych	sɨːχ
sychach	səχaχ
sychdarthiad	səχdarθjad
sychdarthu	səχdarθɨ̞
sychder	səχdɛr
sychdwr	səχdʊr
syched	səχad
syched	səχɛd
sychin	səχɪn
sychnant	səχnant
sychnentydd	səχnɛntɨ̞ð
sychu	səχɨ̞
sychwr	səχʊr
sydd	sɨːð
syfi	səvi
syfl	sɨ̞vl
syflyd	səvlɨ̞d
syfrdan	səvrdan
syfrdanol	səvrdanɔl
syfrdanu	səvrdanɨ̞
syfïa	səviːa
syfïen	səviːɛn
sylfaen	səlvaɨ̯n
sylfaenol	səlveɨ̯nɔl
sylffad	səlfad
sylffwr	səlfʊr
syllta	səɬda
syllu	səɬɨ
sylw	səlu
sylw	sɪlu
sylwebu	səlwɛbɨ
sylwedd	səlwɛð
sylweddol	səlweːðɔl
sylweddol	səlwɛðɔl
sylweddoli	səlwɛðɔli
sylwi	səlwi
symbol	sɨ̞mbɔl
symiau	səmja
symiau	səmjaɨ̯
symiau	səmjɛ
syml	sɨ̞ml
symud	səmɨ̞d
symudais	səmɨ̞dai̯s
symudais	səmɨ̞dɛs
symudaist	səmɨ̞dai̯sd
symudaist	səmɨ̞dɛsd
symudliw	səmɨ̞dlɪu̯
symudoch	səmɨ̞dɔχ
symudodd	səmɨ̞dɔð
symudol	səmɨ̞dɔl
symudon	səmɨ̞dɔn
syn	sɨːn
synagog	sɨ̞naɡɔɡ
synau	səna
synau	sənaɨ̯
synau	sənɛ
syndod	səndɔd
syndodau	səndɔda
syndodau	səndɔdaɨ̯
syndodau	səndɔdɛ
syndodol	səndɔdɔl
syndodus	səndɔdɨ̞s
syniad	sənjad
synio	sənjɔ
synnu	sənɨ̞
synnwyr	sənwɨ̞r
synthesis	sɨ̞nθɛsɪs
syrjeri	sərd͡ʒəri
syrjeris	sərd͡ʒərɪs
syrpréis	sərprei̯s
syrthio	sərθjɔ
system	sɨ̞sdɛm
syth	sɨːθ
sâl	saːl
sèd	sɛd
sêls	seːls
sêr	seːr
sôn	soːn
söolegwr	sɔɔlɛɡʊr
söolegwyr	sɔɔlɛɡwɨ̞r
söolegydd	sɔɔlɛɡɨ̞ð
sŵau	suːa
sŵau	suːaɨ̯
sŵau	suːɛ
sŵn	suːn
t'mod	tmɔd
ta	ta
tab	tab
tacl	takl
taclus	taklɨ̞s
tacluso	taklɨ̞sɔ
tacluswch	taklɨ̞sʊχ
tad	taːd
tadau	tada
tadau	tadaɨ̯
tadau	tadɛ
taen	taːɨ̯n
taenu	teɨ̯nɨ
taeog	teɨ̯ɔɡ
taeogtref	teɨ̯ɔɡtrɛv
taeru	teɨ̯rɨ
tafarn	tavarn
tafarnwr	tavarnʊr
tafarnwraig	tavarnwrai̯ɡ
tafarnwyr	tavarnwɨ̞r
tafell	tavɛɬ
taflegryn	tavlɛɡrɨ̞n
taflen	tavlɛn
taflod	tavlɔd
taflodol	tavlɔdɔl
taflodoledig	tavlɔdɔlɛdɪɡ
taflodoli	tavlɔdɔlɪ
taflu	tavlɨ̞
tafod	tavɔd
tafodau	tavɔda
tafodau	tavɔdaɨ̯
tafodieithoedd	tavɔdjei̯θɔɨ̯ð
tafodieithol	tavɔdjei̯θɔl
tafol	tavɔl
tai	tai̯
taid	tai̯d
tail	tai̯l
tair	tai̯r
taith	tai̯θ
tal	tal
tal	taːl
tala	tala
talach	talaχ
talaf	tala
talaf	talav
talai	talai̯
talai	talɛ
talais	talai̯s
talais	talɛs
talais	talɛʃ
talais	talɪʃ
talaist	talai̯sd
talaist	talɛsd
talaith	talai̯θ
talaith	talɛθ
talan	talan
talant	talant
talcen	talkan
talcen	talkɛn
talch	talχ
taldra	taldra
taleb	talɛb
taled	talɛd
taleithiau	talei̯θja
taleithiau	talei̯θjaɨ̯
taleithiau	talei̯θjɛ
talem	talɛm
talen	talɛn
talent	talɛnt
talentog	talɛntɔɡ
taler	talɛr
tales	talɛs
talet	talɛt
tali	talɪ
taliadau	taljada
taliadau	taljadaɨ̯
taliadau	taljadɛ
taliff	talɪf
talit	talɪt
talo	talɔ
taloch	talɔχ
talodd	talɔð
talom	talɔm
talon	talɔn
talu	talɨ̞
talwch	talʊχ
talwm	talʊm
talwn	talʊn
tan	tan
tanagr	tanaɡr
tanagrod	tanaɡrɔd
tanbaid	tambai̯d
tanbeidrwydd	tambei̯drʊɨ̯ð
tanfor	tanvɔr
taniwr	tanjʊr
tannau	tana
tannau	tanaɨ̯
tannau	tanɛ
tant	tant
tantalwm	tantalʊm
tanwydd	tanwɨ̞ð
tanwyr	tanwɨ̞r
taradr	taradr
taran	taran
taranau	tarana
taranau	taranaɨ̯
taranau	taranɛ
taranu	taranɨ̞
tarddiant	tarðjant
tarian	tarjan
tarianau	tarjana
tarianau	tarjanaɨ̯
tarianau	tarjanɛ
taro	tarɔ
tarth	tarθ
tarthiad	tarθjad
tarthu	tarθɨ̞
tarw	taru
taten	tatan
taten	tatɛn
tato	tatɔ
tatws	tatʊs
tatŵ	tatuː
tatŵs	tatuːs
tau	taɨ̯
taw	ta
taw	taːu̯
taw	tə
tawa	tau̯a
tawch	tau̯χ
tawchu	tau̯χɨ̞
tawdd	tau̯ð
tawel	tau̯ɛl
tawelion	tau̯ɛljɔn
tawelu	tau̯ɛlɨ̞
tawelwch	tau̯ɛlʊχ
tawelwch	twɛlʊχ
tawelyn	tau̯ɛlɨ̞n
tawl	tau̯l
tawn	tau̯n
te	teː
tebyg	tɛbɨ̞ɡ
tebyg	tɛbɪɡ
tebygol	tɛbəɡɔl
technegydd	tɛχnɛɡɨ̞ð
technetiwm	tɛχnɛtjʊm
technoleg	tɛχnɔlɛɡ
teclyn	tɛklɨ̞n
tecáu	tɛkaɨ̯
teg	teːɡ
tegan	tɛɡan
teganau	tɛɡana
teganau	tɛɡanaɨ̯
teganau	tɛɡanɛ
tegeirian	tɛɡei̯rjan
tegell	tɛɡɛɬ
tegwch	tɛɡʊχ
tei	tei̯
teiar	tei̯ar
teiars	tei̯ars
teifl	tei̯vl
teigr	tei̯ɡr
teigrod	tei̯ɡrɔd
teimlad	tei̯mlad
teimlo	tei̯mlɔ
teios	teɨ̯ɔs
teipiadur	tei̯pjadɨ̞r
teipio	tei̯pjɔ
teirannu	tei̯rani
teirannu	tei̯ranɨ̞
teirawr	tei̯rau̯r
teires	tei̯rɛs
teirw	tei̯ru
teisen	tei̯san
teisen	tei̯sɛn
teisen	tei̯ʃan
teisen	tei̯ʃɛn
teisen	tɪʃan
teisen	tɪʃɛn
teisennau	tei̯sɛna
teisennau	tei̯sɛnaɨ̯
teisennau	tei̯sɛnɛ
teisennau	tei̯ʃɛnaɨ̯
teisennau	tɪʃɛna
teisennau	tɪʃɛnɛ
teithi	tei̯θi
teithiau	tei̯θja
teithiau	tei̯θjaɨ̯
teithiau	tei̯θjɛ
teithlyfr	tei̯θlɨ̞vr
teithlyfr	tei̯θɬɨ̞vɨ̞r
teitl	tei̯tl
teitlau	tei̯tla
teitlau	tei̯tlaɨ̯
teitlau	tei̯tlɛ
teits	tei̯ts
telais	tɛlai̯s
teledu	tɛlɛdɨ
teli	tɛli
telid	tɛlɪd
telir	tɛlɪr
telor	tɛlɔr
telori	tɛlɔrɪ
telwriwm	tɛlʊrjʊm
telyn	tɛlɨn
telynau	tɛləna
telynau	tɛlənaɨ̯
telynau	tɛlənɛ
telynor	tɛlənɔr
telynores	tɛlənɔras
telynores	tɛlənɔrɛs
telynoresau	tɛlənɔrɛsa
telynoresau	tɛlənɔrɛsaɨ̯
telynoresau	tɛlənɔrɛsɛ
telynorion	tɛlənɔrjɔn
teml	tɛml
temlau	tɛmla
temlau	tɛmlaɨ̯
temlau	tɛmlɛ
templed	tɛmplɛd
tenant	tɛnant
tenantiaeth	tɛnantjaɨ̯θ
tenantiaeth	tɛnantjɛθ
tenantiaethau	tɛnantjeɨ̯θa
tenantiaethau	tɛnantjeɨ̯θaɨ̯
tenantiaethau	tɛnantjeɨ̯θɛ
tenantiaid	tɛnantjai̯d
tenantiaid	tɛnantjɛd
tenau	tɛna
tenau	tɛnaɨ̯
tenau	tɛnɛ
tenesin	tɛnɛsɪn
teneuwe	tɛnɛɨ̯wɛ
terbiwm	tɛrbjʊm
terfyn	tɛrvɨn
terfynau	tɛrvəna
terfynau	tɛrvənaɨ̯
terfynau	tɛrvənɛ
terfyniad	tɛrvənjad
terfynol	tɛrvənɔl
terfynu	tɛrvənɨ̞
terfysg	tɛrvɨ̞sɡ
terfysgaeth	tɛrvəsɡaɨ̯θ
terfysgaeth	tɛrvəsɡɛθ
terfysgaidd	tɛrvəsɡai̯ð
terfysglyd	tɛrvəsɡlɨ̞d
terfysgoedd	tɛrvəsɡɔɨ̯ð
terfysgu	tɛrvəsɡɨ
terfysgwr	tɛrvəsɡʊr
terfysgwyr	tɛrvəsɡwɨ̞r
termiadur	tɛrmjadɨ̞r
tery	tɛrɨ
terydr	tɛrɨ̞dr
tes	teːs
tesog	tɛsɔɡ
testun	tɛsdɨ̞n
teth	teːθ
teulu	teɨ̯lɨ̞
tew	teːu̯
tewach	tɛu̯aχ
tewbig	tɛu̯bɪɡ
tewbigau	tɛu̯bɪɡa
tewbigau	tɛu̯bɪɡaɨ̯
tewbigau	tɛu̯bɪɡɛ
tewed	tɛu̯ɛd
tewi	tɛu̯i
tewyn	tɛu̯ɨ̞n
teyrn	teɨ̯rn
teyrnaddoliant	teɨ̯rnaðɔljant
teyrnas	teɨ̯rnas
teyrnged	teɨ̯rŋɡɛd
teyrniaid	teɨ̯rnjai̯d
teyrniaid	teɨ̯rnjɛd
tha	θa
thaclus	θaklɨ̞s
thacluso	θaklɨ̞sɔ
thad	θaːd
thafarn	θavarn
thafarnwr	θavarnʊr
thafarnwraig	θavarnwrai̯ɡ
thaflu	θavlɨ
thafod	θavɔd
thafodau	θavɔda
thafodau	θavɔdaɨ̯
thaid	θai̯d
thair	θai̯r
thaith	θai̯θ
thal	θal
thala	θala
thalach	θalaχ
thalai	θalai̯
thalai	θalɛ
thalais	θalai̯s
thalais	θalɛs
thalais	θalɛʃ
thalais	θalɪʃ
thalaist	θalai̯sd
thalaist	θalɛsd
thalcen	θalkan
thalcen	θalkɛn
thalent	θalɛnt
thaler	θalɛr
thali	θali
thaliadau	θaljada
thaliadau	θaljadaɨ̯
thaliadau	θaljadɛ
thaliwm	θaljʊm
thalo	θalɔ
thaloch	θalɔχ
thalodd	θalɔð
thalon	θalɔn
thalu	θalɨ
tharian	θarjan
tharianau	θarjana
tharianau	θarjanaɨ̯
tharianau	θarjanɛ
tharth	θarθ
tharw	θaru
thatws	θatʊs
thaw	θau̯
thawel	θau̯ɛl
theatr	θeːatar
theatr	θeːatr
thebyg	θɛbɨ̞ɡ
thebyg	θɛbɪɡ
theclyn	θɛklɨ̞n
thegan	θɛɡan
thegell	θɛɡɛɬ
thei	θei̯
theigr	θei̯ɡr
theigrod	θei̯ɡrɔd
theimlad	θei̯mlad
theimlo	θei̯mlɔ
theipio	θei̯pjɔ
theirw	θei̯ru
theisen	θei̯san
theisen	θei̯sɛn
theisen	θei̯ʃan
theisen	θei̯ʃɛn
theisen	θɪʃan
theisen	θɪʃɛn
theledu	θɛlɛdɨ
thelyn	θɛlɨn
thelynau	θɛləna
thelynau	θɛlənaɨ̯
thelynau	θɛlənɛ
thelynor	θɛlənɔr
thelynores	θɛlənɔras
thelynores	θɛlənɔrɛs
thematig	θɛmatɪɡ
theth	θeːθ
theulu	θeɨ̯lɨ
thew	θeːu̯
thewed	θɛu̯ɛd
thewi	θɛu̯i
theyrn	θeɨ̯rn
theyrnaddoliant	θeɨ̯rnaðɔljant
theyrnas	θeɨ̯rnas
thi	θiː
thipyn	θɪpɨ̞n
thitw	θɪtʊ
thlawd	θlau̯d
thlodion	θlɔdjɔn
thocyn	θɔkɨ̞n
thor	θɔr
thoriwm	θɔrjʊm
thorrent	θɔrɛnt
thorri	θɔri
thorrid	θɔrɪd
thraed	θraːɨ̯d
thraeth	θraːɨ̯θ
thrafod	θravɔd
thrannoeth	θranɔɨ̯θ
thraw	θrau̯
thrawant	θrau̯ant
thrawn	θrau̯n
thre	θreː
threfydd	θrɛvɨ̞ð
threiglad	θrei̯ɡlad
threiglo	θrei̯ɡlɔ
threisiol	θrei̯ʃɔl
threisiwr	θrei̯ʃʊr
thrennydd	θrɛnɨ̞ð
thri	θriː
thrigain	θrɪɡai̯n
thrigain	θrɪɡɛn
thriongl	θriːɔŋl
thro	θroː
throed	θroːɨ̯d
throednoeth	θrɔɨ̯dnɔɨ̯θ
throes	θroːɨ̯s
throi	θrɔi̯
throid	θrɔi̯d
thrown	θrou̯n
thrwydded	θrʊɨ̯ðad
thrwydded	θrʊɨ̯ðɛd
thrwyddedau	θrʊɨ̯ðɛda
thrwyddedau	θrʊɨ̯ðɛdaɨ̯
thrwyddedau	θrʊɨ̯ðɛdɛ
thrwyn	θruːɨ̯n
thrydanwr	θrədanʊr
thrydanwyr	θrədanwɨ̞r
thu	θɨː
thud	θɨːd
thudalen	θɨ̞dalan
thudalen	θɨ̞dalɛn
thwliwm	θʊljʊm
thwll	θʊɬ
thwrci	θʊrki
thwymyn	θʊɨ̯mɨ̞n
thybaco	θəbakɔ
thyn	θɨ̞n
thyrrau	θəra
thyrrau	θəraɨ
thyrrau	θərɛ
thywyll	θəu̯ɨ̞ɬ
thâl	θaːl
thân	θaːn
thîm	θiːm
thôn	θoːn
thŵr	θuːr
thŷ	θɨː
ti	tiː
ticio	tɪkjɔ
ticio	tɪkɔ
timau	tɪma
timau	tɪmaɨ̯
timau	tɪmɛ
timod	tɪmɔd
timoedd	tɪmɔɨ̯ð
tin	tiːn
tinboeth	tɪnboɨ̯θ
tindew	tɪndɛu̯
tindroed	tɪndrɔɨ̯d
tinfelyn	tɪnvɛlɨ̞n
tingoch	tɪŋɡɔχ
tipyn	tɪpɨ̞n
tir	tiːr
tiroedd	tɪrɔɨ̯ð
tisiad	ɪʃad
tisian	tɪʃan
titaniwm	tɪtanjʊm
tithau	tɪθa
tithau	tɪθaɨ̯
titr	tɪtr
titw	tɪtʊ
titwod	tɪtwɔd
titŵod	tɪtuːɔd
tiwb	tɪu̯b
tiwba	tɪu̯ba
tiwbâu	tɪu̯baːɨ̯
tiwlip	tɪu̯lɪp
tiwn	tjuːn
tiwtor	tɪu̯tɔr
tlawd	tlau̯d
tlodaidd	tlɔdai̯ð
tlodaidd	tlɔdɛð
tlodion	tlɔdjɔn
tlotai	tlɔtai̯
tloty	tlɔtɨ̞
tlotyn	tlɔtɨ̞n
tlws	tluːs
to	toː
toc	tɔk
tochi	tɔχi
tocyn	tɔkɨ̞n
tocynnau	tɔkəna
tocynnau	tɔkənaɨ̯
tocynnau	tɔkənɛ
toddbwynt	tɔðbʊɨ̯nt
toddf	tɔðv
toddi	tɔðɪ
toddiad	tɔðjad
toddyf	tɔðɨ̞v
toes	toːɨ̯s
toesaidd	tɔɨ̯sai̯ð
toesen	tɔɨ̯sɛn
toeslyd	tɔɨ̯slɨ̞d
toiled	tɔi̯lad
toiled	tɔi̯lɛd
toiledau	tɔi̯lɛda
toiledau	tɔi̯lɛdaɨ̯
toiledau	tɔi̯lɛdɛ
toiledi	tɔi̯lɛdi
tolc	tɔlk
tolch	tɔlχ
tolchi	tɔlχi
tolchiad	tɔlχjad
tolcio	tɔlkjɔ
tolio	tɔljɔ
tom	tɔm
tomato	tɔmatɔ
tomatos	tɔmatɔs
tomen	tɔmɛn
ton	tɔn
tonau	tɔna
tonau	tɔnaɨ̯
tonau	tɔnɛ
toncio	tɔŋkjɔ
tonfedd	tɔnvɛð
tonnau	tɔna
tonnau	tɔnaɨ̯
tonnau	tɔnɛ
top	tɔp
tor	tɔr
torcalondid	tɔrkalɔndɪd
torch	tɔrχ
torchau	tɔrχa
torchau	tɔrχaɨ̯
torchau	tɔrχɛ
torchi	tɔrχi
torchog	tɔrχɔɡ
torf	tɔrv
torheulo	tɔrheɨ̯lɔ
toriad	tɔrjad
torlan	tɔrlan
torlannau	tɔrlana
torlannau	tɔrlanaɨ̯
torlannau	tɔrlanɛ
tormaen	tɔrmaɨ̯n
torogen	tɔrɔɡan
torogen	tɔrɔɡɛn
torra	tɔra
torrai	tɔrai̯
torrai	tɔrɛ
torran	tɔran
torrem	tɔrɛm
torren	tɔrɛn
torrent	tɔrɛnt
torres	tɔrɛs
torret	tɔrɛt
torri	tɔrɪ
torrid	tɔrɪd
torro	tɔrɔ
torsen	tɔrsɛn
torso	tɔrsɔ
torth	tɔrθ
tost	toːsd
tostio	tɔsdjɔ
towio	tou̯jɔ
towyr	tɔu̯ɨ̞r
tra	traː
traddodiad	traðɔdjad
traddodiadol	traðɔdjadɔl
tradwy	tradʊɨ̯
traean	treɨ̯an
traeanu	treɨ̯anɨ̞
traed	traːɨ̯d
traeth	traːɨ̯θ
traethawd	treɨ̯θau̯d
traethodau	treɨ̯θɔda
traethodau	treɨ̯θɔdaɨ̯
traethodau	treɨ̯θɔdɛ
traethu	treɨ̯θɨ̞
trafferth	trafarθ
trafferth	trafɛrθ
trafferthion	trafɛrθjɔn
trafferthu	trafɛrθɨ
trafferthus	trafɛrθɨ̞s
traffordd	trafɔrð
trafod	travɔd
traidd	trai̯ð
trais	trai̯s
tramgwydd	tramɡwɨ̞ð
tramgwyddo	tramɡwɨ̞ðɔ
tramor	tramɔr
trannoeth	tranɔɨ̯θ
traphoethi	trafɔɨ̯θɨ
traphont	trafɔnt
traul	traɨ̯l
traw	traːu̯
trawant	trau̯ant
trawiau	trau̯ja
trawiau	trau̯jaɨ̯
trawiau	trau̯jɛ
trawn	trau̯n
trawo	trau̯ɔ
trawom	trau̯ɔm
trawsenw	trau̯sɛnu
trawsleoli	trau̯slɛɔlɪ
trawsrywedd	trau̯srɨ̞u̯að
trawsrywedd	trau̯srɨ̞u̯ɛð
trawsrywedd	trau̯srɪu̯að
trawsrywedd	trau̯srɪu̯ɛð
trawsryweddol	trau̯srɨ̞u̯ɛðɔl
trawsryweddol	trau̯srɪu̯ɛðɔl
trawst	trau̯sd
trawstoriad	trau̯sdɔrjad
trawstorri	trau̯sdɔrɪ
trawstrefa	trau̯sdrɛva
tre	treː
trech	treːχ
trechiad	trɛχjad
trechu	trɛχɨ̞
trefedigaeth	trɛvɛdɪɡaɨ̯θ
trefedigaeth	trɛvɛdɪɡɛθ
trefedigaethau	trɛvɛdɪɡeɨ̯θa
trefedigaethau	trɛvɛdɪɡeɨ̯θaɨ̯
trefedigaethau	trɛvɛdɪɡeɨ̯θɛ
trefgordd	trɛvɡɔrð
trefi	trɛvi
trefn	trɛvn
trefnu	trɛvnɨ
trefnus	trɛvnɨ̞s
trefol	trɛvɔl
trefolaeth	trɛvɔlaɪθ
treftadaeth	trɛvtadaɨ̯θ
treftadaeth	trɛvtadɛθ
trefydd	trɛvɨ̞ð
treiddio	treiðjɔ
treigl	trei̯ɡl
treiglad	trei̯ɡlad
treigladau	treiɡlada
treigladau	treiɡladaɨ̯
treigladau	treiɡladɛ
treigladau	treiɡljada
treigladau	treiɡljadɛ
treiglo	trei̯ɡlɔ
treisio	trei̯ʃɔ
treisiol	trei̯ʃɔl
treisiwr	trei̯ʃʊr
treiswyr	trei̯swɨ̞r
trenau	trɛna
trenau	trɛnaɨ̯
trenau	trɛnɛ
trengholiad	trɛŋhɔljad
trengholiadau	trɛŋhɔljada
trengholiadau	trɛŋhɔljadaɨ̯
trengholiadau	trɛŋhɔljadɛ
trennydd	trɛnɨ̞ð
treth	treːθ
trethu	trɛθɨ̞
treulio	treɨ̯ljɔ
treuliodd	treɨ̯ljɔð
trew	treːu̯
trewi	trɛu̯ɪ
tri	triː
triawd	triːau̯d
tridiau	trɪdja
tridiau	trɪdjaɨ̯
tridiau	trɪdjɛ
trigain	trɪɡai̯n
trigain	trɪɡɛn
trigeiniau	trɪɡei̯nja
trigeiniau	trɪɡei̯njaɨ̯
trigeiniau	trɪɡei̯njɛ
tril	trɪl
trilio	trɪljɔ
trillawr	trɪɬau̯r
trilliw	trɪɬɪu̯
trin	triːn
triniaeth	trɪnjaɨ̯θ
triongl	triːɔŋl
trionglau	trɪɔŋla
trionglau	trɪɔŋlaɨ̯
trionglau	trɪɔŋlɛ
trisain	trɪsai̯n
trist	triːsd
tristáu	trɪsdaɨ̯
tro	troː
troa	trɔa
troan	trɔan
troch	troːχ
trochi	trɔχi
trochwr	trɔχʊr
trochydd	trɔχɨ̞ð
trodd	troːð
troed	troːɨ̯d
troedfedd	trɔɨ̯dvað
troedfedd	trɔɨ̯dvɛð
troedfys	trɔɨ̯dvɨ̞s
troednoeth	trɔɨ̯dnɔɨ̯θ
troen	troːɨ̯n
troer	troːɨ̯r
troes	troːɨ̯s
troet	troːɨ̯t
trof	troːv
trofwrdd	trɔvʊrð
trogen	trɔɡan
trogen	trɔɡɛn
troi	trɔi̯
troid	trɔi̯d
trois	trɔi̯s
trois	trɔi̯ʃ
troli	trɔli
trolïau	trɔlɪa
trolïau	trɔlɪaɨ̯
trolïau	trɔlɪɛ
trom	trɔm
trombonau	trɔmbɔna
trombonau	trɔmbɔnaɨ̯
trombonau	trɔmbɔnɛ
trombôn	trɔmboːn
tros	trɔs
troseddeg	trɔsɛðɛɡ
troseddu	trɔsɛðɨ̞
trosi	trɔsi
trosleisio	trɔslei̯ʃɔ
trowch	trou̯χ
trown	trou̯n
trowsus	trou̯sɨ̞s
trowsusau	trou̯sɨ̞sa
trowsusau	trou̯sɨ̞saɨ̯
trowsusau	trou̯sɨ̞sɛ
troëdig	trɔɛdɪɡ
trueni	triɛnɨ
trwbl	trʊbl
trwbl	trʊbʊl
trwblus	trʊblɨ̞s
trwch	truːχ
trwchus	trʊχɨ̞s
trwm	trʊm
trwnc	trʊŋk
trwsgl	trʊsɡl
trwsio	trʊsjɔ
trwy	truːɨ̯
trwydded	trʊɨ̯ðad
trwydded	trʊɨ̯ðɛd
trwyddedau	trʊɨ̯ðɛda
trwyddedau	trʊɨ̯ðɛdaɨ̯
trwyddedau	trʊɨ̯ðɛdɛ
trwyn	truːɨ̯n
trwynol	trʊɨ̯nɔl
trwynoli	trʊɨ̯nɔlɪ
trwynolyn	trʊɨ̯nɔlɨ̞n
trwyth	truːɨ̯θ
try	trɨː
trybedd	trəbɛð
tryblith	trəblɪθ
trydan	trədan
trydanwr	trədanʊr
trydanwyr	trədanwɨ̞r
trydedd	trədað
trydedd	trədɛð
trydedd	trɪdɛð
trydydd	trədɨ̞ð
tryfer	trəvɛr
tryferi	trəvɛrɪ
tryferu	trəvɛrɨ̞
tryloyw	trəlɔɨ̯ʊ
tryloywder	trəlɔɨ̯wdɛr
trymder	trəmdɛr
trymhau	trəmhaɨ̯
trysor	trəsɔr
trywel	trəu̯ɛl
tryweli	trəu̯ɛli
trywelion	trəu̯ɛljɔn
trywydd	trəu̯ɨ̞ð
trên	treːn
trôi	troːi̯
tsimpansî	tʃɪmpansiː
tsip	t͡ʃɪp
tsips	t͡ʃɪps
tsipsen	t͡ʃɪpsan
tsipsen	t͡ʃɪpsɛn
tu	tɨː
tua	tɨːa
tuag	tɨːaɡ
tud	tɨːd
tudalen	tɨ̞dalan
tudalen	tɨ̞dalɛn
tudalennau	tɨdalɛna
tudalennau	tɨ̞dalɛnaɨ̯
tudalennau	tɨ̞dalɛnɛ
tueddol	tɨ̞ɛðɔl
tun	tɨ̞n
turtur	tɨ̞rtɨ̞r
twf	tuːv
twgu	tʊɡɨ
twll	tʊɬ
twlu	tʊlɨ
twmffat	tʊmfat
twmpath	tʊmpaθ
twndish	tʊndɪʃ
twng	tʊŋ
twngsten	tʊŋsdɛn
twp	tʊp
twptra	tʊptra
twr	tʊr
twrbanau	tʊrbana
twrbanau	tʊrbanaɨ̯
twrbanau	tʊrbanɛ
twrch	tʊrχ
twrci	tʊrki
twrf	tʊrv
twrw	tʊrʊ
twt	tʊt
twyll	tuːɨ̯ɬ
twym	tuːɨ̯m
twymo	tʊɨ̯mɔ
twymyn	tʊɨ̯mɨ̞n
twymynau	tʊɨ̯mənaɨ̯
twyn	tuːɨ̯n
twyt	tuːt
twyt	tuːɨ̯t
twyth	tuːɨ̯θ
tyb	tɨːb
tybaco	təbakɔ
tybed	təbɛd
tybio	təbjɔ
tybiwyd	təbjʊɨ̯d
tydan	tədan
tydw	tədʊ
tydy	tədi
tydych	tədɨ̞χ
tydyn	tədɨ̞n
tyfu	təvɨ̞
tyle	təlɛ
tyllau	təɬa
tyllau	təɬaɨ̯
tyllau	təɬɛ
tylluan	təɬɨ̞ːan
tymer	təmɛr
tymheredd	təmhɛrɛð
tymor	təmɔr
tyn	tɨ̞n
tyndra	təndra
tyner	tənɛr
tynerder	tənɛrdɛr
tynged	təŋɛd
tyngedfenyddiaeth	təŋɛdvɛnəðjaɨ̯θ
tyngedfenyddiaeth	təŋɛdvɛnəðjɛθ
tyngu	təŋɨ̞
tynhaodd	tənhaɔð
tynhau	tənhaɨ̯
tynnu	tənɨ̞
tyr	tɨ̞r
tyrchod	tərχɔd
tyrchu	tərχɨ̞
tyrd	tɨ̞rd
tyred	tərɛd
tyrrau	təra
tyrrau	təraɨ
tyrrau	tərɛ
tyrru	tərɨ
tyst	tɨːsd
tysteb	təstɛb
tystio	təsdjɔ
tystiolaeth	təsdjɔlɑːɨ̯θ
tystiolaethu	təsdjɔlaːɨ̯θɨ̞
tystiolaethu	təsdjɔleɨ̯θɨ̞
tystlythyr	təsdləθɨ̞r
tywod	təwɔd
tywodfaen	təu̯ɔdvaɨ̯n
tywodlys	təwɔdlɨ̞s
tywydd	təu̯ɨ̞ð
tywyll	təu̯ɨ̞ɬ
tywylled	təu̯əɬɛd
tywyllwch	twəɬʊχ
tywyllwch	təu̯əɬʊχ
tywyllwch	tʊɬʊχ
tâl	taːl
tân	taːn
tâp	taːp
têl	teːl
têr	teːr
tîm	tiːm
tôn	toːn
töwr	toːʊr
tŵr	tuːr
tŷ	tɨː
u	ɨː
uch	ɨːχ
uchaf	əχa
uchaf	ɨ̞χav
uchafu	ɨ̞χavɨ̞
uchanianaeth	ɨ̞χanjanaɨ̯θ
uchanianaeth	ɨ̞χanjanaθ
uchanianaeth	ɨ̞χanjanɛθ
uchanianaeth	ɪχanjaːnɛθ
uchanianeg	ɨ̞χanjanɛɡ
uchawdur	ɨ̞χau̯dɨ̞r
uchawdurol	ɨ̞χau̯dɨ̞rɔl
uchder	ɨ̞χdɛr
uchderau	ɨ̞χdɛra
uchderau	ɨ̞χdɛraɨ̯
uchderau	ɨ̞χdɛrɛ
uchel	əχal
uchel	əχɛl
uchel	ɨ̞χɛl
ucheldir	ɨ̞χɛldɪr
uchelu	ɨ̞χɛlɨ̞
uchelwr	ɨ̞χɛlʊr
uchelwydd	ɨ̞χɛlwɨ̞ð
uchelwydd	ɪχɛlwɪð
udd	ɨːð
ufelai	ɨ̞vɛlai̯
uffarn	ɨ̞farn
uffern	ɨ̞fɛrn
ufudd	ɨ̞vɨ̞ð
ugain	ɪɡai̯n
ugain	ɪɡjan
ugeinfed	ɪɡei̯nvɛd
ugeiniau	ɪɡei̯nja
ugeiniau	ɪɡei̯njaɨ̯
ugeiniau	ɪɡei̯njɛ
ulai	ɨ̞lai̯
ulyfai	ɨ̞ləvai̯
un	ɨːn
una	ɨ̞na
unai	ɨ̞nai̯
unais	ɨ̞nai̯s
unais	ɨ̞nɛs
unais	ɨ̞nɛʃ
unais	ɨ̞nɪʃ
unan	ɨ̞nan
unawd	ɨ̞nau̯d
uncoes	ɨ̞ŋkɔɨ̯s
undeb	ɨ̞ndab
undeb	ɨ̞ndɛb
undebau	ɨ̞ndɛba
undebau	ɨ̞ndɛbaɨ̯
undebau	ɨ̞ndɛbɛ
undeboli	ɨ̞ndɛbɔlɨ̞
undeg	ɨ̞ndɛɡ
undydd	ɨ̞ndɨ̞ð
uned	ɨ̞nɛd
unedau	ɨ̞nɛda
unedau	ɨ̞nɛdaɨ̯
unedau	ɨ̞nɛdɛ
unedig	ɨ̞nɛdɪɡ
unem	ɨ̞nɛm
unen	ɨ̞nɛn
unes	ɨ̞nɛs
unet	ɨ̞nɛt
unfed	ɨ̞nvɛd
ungoes	ɨ̞ŋɡɔɨ̯s
uni	ɨ̞ni
uniad	ɨnjad
uniawn	ɨ̞njau̯n
unid	ɨ̞nɪd
unig	ɨ̞nɪɡ
unigol	ɨ̞nɪɡɔl
unigolyn	ɨ̞nɪɡɔlɨ̞n
unigryw	ɨ̞nɪɡrɨu̯
unigryw	ɨ̞nɪɡrɪu̯
unigrywiaeth	ɨ̞nɪɡrɨ̞u̯jaɨ̯θ
unigrywiaeth	ɨ̞nɪɡrɨ̞u̯jɛθ
unigrywiaeth	ɨ̞nɪɡrɪu̯jaɨ̯θ
unigrywiaeth	ɨ̞nɪɡrɪu̯jɛθ
union	ɪ
union	ɪnjɔn
uniongyrchol	ɨ̞njɔŋɡərχɔl
unioni	ɨ̞njɔni
unir	ɨ̞nɪr
unit	ɨ̞nɪt
unllygeidiog	ɨːnɬəɡei̯djɔɡ
unllygeidiog	ɨ̞nɬəɡei̯djɔɡ
unman	ɨ̞nman
unnos	ɨ̞nɔs
uno	ɨ̞nɔ
unol	ɨ̞nɔl
unrhyw	ɨ̞nr̥ɨ̞u̯
unsain	ɨ̞nsai̯n
unsain	ɪnsai̯n
unset	ɨ̞nsɛt
untrew	ɨ̞ntrɛu̯
unwaith	ɨ̞nwai̯θ
unwaith	ɨ̞nwɛθ
urdd	ɨ̞rð
urddau	ɨ̞rða
urddau	ɨ̞rðaɨ̯
urddau	ɨ̞rðɛ
ustus	ɨ̞sdɨ̞s
utganaf	ɨ̞tɡanav
utganu	ɨ̞tɡanɨ
utgorn	ɨ̞tɡɔrn
utgyrn	ɨ̞tɡɨ̞rn
uwch	ɨ̞u̯χ
uwchalaw	ɨ̞u̯χalau̯
uwchamserol	ɨ̞u̯χamsɛrɔl
uwchben	ɨ̞u̯χbɛn
uwchiaith	ɨ̞u̯χjai̯θ
uwchlaw	ɨ̞u̯χlaːu̯
uwchradd	ɨu̯χrað
uwchraddiad	ɨ̞u̯χraðjad
uwchraddio	ɨ̞u̯χraðjɔ
uwd	ɨ̞u̯d
uwdfys	ɨ̞u̯dvɨ̞s
uwtffon	ɨ̞u̯tfɔn
w	uː
w	w
w	ʊ
wab	wab
wael	waːɨ̯l
wag	waːɡ
wagen	waɡɛn
wahanol	wahanɔl
wahân	wahaːn
wain	wai̯n
wair	wai̯r
wal	wal
waliau	walja
waliau	waljaɨ̯
waliau	waljɛ
wallt	waːɬd
wanwyn	wanwɨ̞n
warden	wardɛn
wario	warjɔ
warws	warʊs
warysau	warəsa
warysau	warəsaɨ̯
warysau	warəsɛ
was	waːs
wastad	wastad
wawr	wau̯r
wddf	ʊðu
wddf	ʊðv
wddf	ʊðʊv
wddw	ʊðu
wddwg	ʊðʊɡ
we	weː
wedd	weːð
weddi	wɛði
weddïo	wɛðɪɔ
wedi	di
wedi	wɛdi
wedyn	wɛdɨ̞n
wefan	wɛvan
weilch	wei̯lχ
weinidog	wei̯nɪdɔɡ
weinidogion	wei̯nɪdɔɡjɔn
weithiau	wei̯θja
weithiau	wei̯θjaɨ̯
weithiau	wei̯θjɛ
weithio	wei̯θjɔ
weithiwr	wei̯θjʊr
weithred	wei̯θrɛd
wel	wɛl
weladwy	wɛladʊɨ̯
welaist	wɛlai̯st
welaist	wɛlɛst
weld	wɛld
wele	wɛlɛ
weled	wɛlɛd
weledig	wɛlɛdɪɡ
weler	wɛlɛr
well	wɛɬ
wella	wɛɬa
wely	wɛlɨ
welydd	wɛlɨ̞ð
wenen	wɛnɛn
wenith	wɛnɪθ
wennol	wɛnɔl
wenoliaid	wɛnɔljai̯d
wenoliaid	wɛnɔljɛd
werdd	wɛrð
weriniaeth	wɛrɪnjaɨ̯θ
weriniaeth	wɛrɪnjɛθ
weriniaethau	ɡwɛrɪnjeɨ̯θa
weriniaethau	ɡwɛrɪnjeɨ̯θaɨ̯
weriniaethau	ɡwɛrɪnjeɨ̯θɛ
werinwr	wɛrɪnʊr
werinwyr	wɛrɪnwɨ̞r
werthu	wɛrθɨ
wfft	ʊfd
win	wiːn
winoedd	wɪnɔɨ̯ð
winwns	wɪnʊns
wiwer	wɪu̯ar
wiwer	wɪu̯ɛr
wiwerod	wɪu̯ɛrɔd
wlad	wlaːd
wladfa	wladva
wladgar	wladɡar
wladgarol	wladɡarɔl
wlanog	wlanɔɡ
wledydd	wlɛdɨ̞ð
wlyb	wlɨːb
wlypach	wləpaχ
wn	ʊn
wna	wnaː
wnaeth	naːθ
wnaeth	wnaːɨ̯θ
wnaethoch	wneɨ̯θɔχ
wnaethon	wneɨ̯θɔn
wnc	ʊŋk
wnei	wnei̯
wnes	wneːs
wnest	wnɛsd
wneud	neɨ̯d
wneud	wneɨ̯d
wng	ʊŋ
wnsach	ʊnsaχ
woc	wɔk
wociau	wɔkja
wociau	wɔkjaɨ̯
wociau	wɔkjɛ
wragedd	wraɡað
wragedd	wraɡɛð
wrando	wrandɔ
wraniwm	ʊranjʊm
wreiddiol	wrei̯ðjɔl
wres	wreːs
wresogi	wrɛsɔɡɪ
wrth	ʊrθ
wrth	ʊθ
wrthat	ʊrθat
wrthi	ʊrθɪ
wrtho	ʊrθɔ
wrthoch	ʊrθɔχ
wrthon	ʊrθɔn
wrthyn	ʊrθɨ̞n
wryw	ʊrɨ̞u̯
wrywaidd	ʊrəu̯ai̯ð
wrywaidd	ʊrəu̯ɛð
wstid	ʊsdɪd
wy	uːɨ̯
wyau	ʊi̯a
wyau	ʊi̯ɛ
wyau	ʊɨ̯aɨ̯
wybedog	wəbɛdɔɡ
wybedogion	wəbɛdɔɡjɔn
wybod	wɨ̞bɔd
wybod	ʊbɔd
wybodaeth	wəbɔdaɨ̯θ
wybodaeth	wəbɔdɛθ
wybodaeth	wɨ̞bɔdaɨ̯θ
wybodaeth	wɨ̞bɔdɛθ
wybr	ʊɨ̯br
wych	wɨːχ
wychach	wəχaχ
wyched	wəχɛd
wyddbwyll	wɨ̞ðbʊɨ̯ɬ
wyddion	wəðjɔn
wydraid	wədrai̯d
wyf	uːɨ̯v
wylan	ʊɨ̯lan
wylanod	ʊɨ̯lanɔd
wyliau	wɨ̞lja
wyliau	wɨ̞ljaɨ̯
wyliau	wɨ̞ljɛ
wylio	wɨ̞ljɔ
wylio	wɪljɔ
wyll	wɨ̞ɬ
wylo	ʊɨ̯lɔ
wylofus	ʊɨ̯lɔvɨ̞s
wylys	ʊɨ̯lɨ̞s
wyn	wɨ̞n
wyneb	wɨnab
wyneb	wɨnɛb
wynion	wənjɔn
wynt	wɨ̞nt
wynwyn	ʊɨ̯nwɨ̞n
wyres	ʊɨ̯ras
wyres	ʊɨ̯rɛs
wyrion	ʊɨ̯rjɔn
wys	wɨːs
wystl	wɨ̞sdl
wyt	uːt
wyt	uːɨ̯t
wyth	uːɨ̯θ
wythawd	ʊɨ̯θau̯d
wythdegau	uɨ̯θdɛɡa
wythdegau	uɨ̯θdɛɡaɨ̯
wythfed	ʊɨ̯θvad
wythfed	ʊɨ̯θvɛd
wythnos	ʊsnɔs
wythnos	ʊsɔs
wythnos	ʊɨ̯θnɔs
wythnos	ʊθnɔs
wythongl	ʊɨ̯θɔŋl
wŷdd	wɨːð
wŷn	wɨːn
wŷr	wɨːr
y	ə
ych	əχ
ych	ɨːχ
ychen	əχɛn
ychwaneg	əχwanɛɡ
ychwanegiad	əχwanɛɡjad
ychwanegol	əχwanɛɡɔl
ychwanegu	əχwanɛɡɨ
ydau	əda
ydau	ədaɨ̯
ydau	ədɛ
yddfgoch	əðvɡɔχ
ydfrain	ədvrai̯n
ydfran	ədvran
ydw	ndu
ydw	ədu
ydw	əndu
ydy	ndɪ
ydy	ədɪ
ydy	əndɪ
ydych	ədɨ̞χ
yf	ɨːv
yfed	əvad
yfed	əvɛd
yffach	əfaχ
yfory	vɔrɨ̞
yfory	əvɔrɨ̞
yma	əma
ymadael	əmadal
ymadael	əmadaɨ̯l
ymadael	əmadɛl
ymaelodi	əmeɨ̯lɔdɪ
ymaflyd	əmavlɨ̞d
ymarfer	əmarvar
ymarfer	əmarvɛr
ymasiad	əmaʃad
ymateb	əmatab
ymateb	əmatɛb
ymbaratoi	əmbaratɔi̯
ymbarél	əmbarɛl
ymbelydredd	əmbɛlədrɛð
ymddangos	əmðaŋɔs
ymddengys	əmðɛŋɨ̞s
ymddeol	əmðeːɔl
ymddiddan	əmðɪðan
ymddiddori	əmðɪðɔrɪ
ymddiheuro	əmðɪheɨ̯rɔ
ymddiried	əmðɪrjɛd
ymddwyn	əmðʊɨ̯n
ymdecáu	əmdɛkaɨ̯
ymdeimlad	əmdei̯mlad
ymdeimlo	əmdei̯mlɔ
ymdoddbwynt	əmdɔðbʊɨ̯nt
ymdoddi	əmdɔðɪ
ymdopi	əmdɔpi
ymdrafferthu	əmdrafɛrθɨ
ymdraidd	əmdrai̯ð
ymdrech	əmdrɛχ
ymdreiddio	əmdreiðjɔ
ymedy	əmɛdɨ
ymeifl	əmei̯vl
ymennydd	əmɛnɨ̞ð
ymenyn	mɛnɨ̞n
ymerodraeth	əmɛrɔdraɨ̯θ
ymerodraethau	əmɛrɔdreɨ̯θa
ymerodraethau	əmɛrɔdreɨ̯θaɨ̯
ymerodraethau	əmɛrɔdreɨ̯θɛ
ymestyn	əmɛsdɨ̞n
ymesyd	əmɛsɨ̞d
ymffrostio	əmfrɔsdjɔ
ymfudiad	əmvɨ̞djad
ymfudo	əmvɨ̞dɔ
ymfudwr	əmvɨ̞dʊr
ymgais	əmɡai̯s
ymgecru	əmɡɛkrɨ
ymgeisio	əmɡei̯ʃɔ
ymgeiswyr	əmɡei̯swɨ̞r
ymgeisydd	əmɡei̯sɨ̞ð
ymgloi	əmɡlɔi̯
ymgolli	əmɡɔɬɪ
ymgorffori	əmɡɔrfɔrɪ
ymgyfnewid	əmɡəvnɛu̯ɪd
ymgynnull	əmɡənɪɬ
ymgyrch	əmɡɨ̞rχ
ymgyrchu	əmɡərχɨ̞
ymgyrchwr	əmɡərχʊr
ymgyrchydd	əmɡərχɨ̞ð
ymherodr	əmhɛrɔdr
ymhlith	əmhliːθ
ymhongar	əmhɔŋɡar
ymlacio	əmlakjɔ
ymladd	əmlað
ymladdfa	əmlaðva
ymladdfeydd	əmlaðveɨ̯ð
ymladdgar	əmlaðɡar
ymladdodd	əmlaðɔð
ymladdwr	əmlaðʊr
ymladdwyr	əmlaðwɨ̞r
ymlaen	laːɨ̯n
ymlaen	mlaːɨ̯n
ymlaen	əmlaːɨ̯n
ymlusgiad	əmlɨ̞sɡjad
ymlusgo	əmlɨ̞sɡɔ
ymlynu	əmlənɨ̞
ymlâdd	əmlaːð
ymlŷn	əmlɨːn
ymnesáu	əmnɛsaɨ̯
ymollwng	əmɔɬʊŋ
ymollwng	əmʊɬʊn
ymollwng	əmʊɬʊŋ
ymosod	əmɔsɔd
ymosodedd	əmɔsɔdað
ymosodedd	əmɔsɔdɛð
ymosodiad	əmɔsɔdjad
ymosodol	əmɔsɔdɔl
ymosodwr	əmɔsɔdʊr
ymrafael	əmravaɨ̯l
ymrafael	əmravɛl
ymrafaelgar	əmraveɨ̯lɡar
ymrafaelion	əmraveɨ̯ljɔn
ymrwymiad	əmrʊɨ̯mjad
ymrwymo	əmrʊɨ̯mɔ
ymryson	əmrəsɔn
ymrysongar	əmrəsɔŋɡar
ymrysonwr	əmrəsɔnʊr
ymrysonwyr	əmrəsɔnwɨ̞r
ymrysonydd	əmrəsɔnɨ̞ð
ymuno	əmɨ̞nɔ
ymwacáu	əmwakaɨ̯
ymweld	əmwɛld
ymwelwr	əmwɛlʊr
ymwelydd	əmwɛlɨ̞ð
ymwneud	əmneɨ̯d
ymwneud	əmwneɨ̯d
ymyl	əmɨ̞l
ymyrryd	əmərɨd
ymysg	əmɨːsɡ
yn	ən
yna	əna
ynad	ənad
ynddo	ənðɔ
yng	əŋ
ynganiad	əŋanjad
ynganu	əŋanɨ̞
ynghlwm	əŋhlʊm
ynghylch	əŋhɨ̞lχ
ynglŷn	əŋlɨːn
ynn	ɨ̞n
ynni	ənɪ
yno	ənɔ
yntau	ənta
yntau	əntaɨ̯
ynys	ənɨ̞s
ynysoedd	ənəsɔɨ̯ð
yr	ər
yrru	ərɨ
ysaf	əsav
ysbaddu	əsbaðɨ̞
ysboncio	əsbɔŋkjɔ
ysbryd	əsbrɨ̞d
ysbrydion	əsbrədjɔn
ysbrydol	əsbrədɔl
ysbrydoli	əsbrədɔli
ysbrydolrwydd	əsbrədɔlruɨ̯ð
ysbyty	sbətɨ̞
ysbyty	əsbətɨ̞
ysbïo	əsbiːɔ
ysbïwedd	əsbiːwɛð
ysgadan	əsɡadan
ysgadenyn	əsɡadɛnɨ̞n
ysgafnder	əsɡavndɛr
ysgafnhad	əsɡavnhaːd
ysgafnhau	əsɡavnhaɨ̯
ysgall	əsɡaɬ
ysgallen	sɡaɬan
ysgariad	əsɡarjad
ysgaru	əsɡarɨ̞
ysgaw	əsɡau̯
ysgawen	əsɡau̯an
ysgawen	əsɡau̯ɛn
ysglodyn	sɡlɔdɨ̞n
ysglodyn	əsɡlɔdɨ̞n
ysgol	əsɡɔl
ysgrif	əsɡrɪv
ysgrifbin	əsɡrɪvbɪn
ysgrifen	sɡrɪvan
ysgrifen	sɡrɪvɛn
ysgrifen	əsɡrɪvɛn
ysgrifennodd	sɡwɛnɔð
ysgrifennodd	əsɡrɪvɛnɔð
ysgrifennu	sɡrɪvɛnɨ
ysgrifennu	sɡwɛnɨ
ysgrifennu	əsɡrɪvɛnɨ
ysgrifennydd	əsɡrɪvɛnɨ̞ð
ysgrifenyddes	əsɡrɪvɛnəðɛs
ysgrythur	əsɡrəθɨ̞r
ysgub	əsɡɨ̞b
ysgubell	əsɡɨ̞bɛɬ
ysgubo	əsɡɨ̞bɔ
ysgubor	əsɡɨ̞bɔr
ysguthan	sɡɨ̞θan
ysguthan	əsɡɨ̞θan
ysgwyd	əsɡwɨ̞d
ysgwydd	əsɡwɨ̞ð
ysi	əsɪ
ysit	əsɪt
ysmygoch	əsməɡɔχ
ysmygodd	əsməɡɔð
ysmygon	əsməɡɔn
ysmygu	əsməɡɨ
ysmygwr	əsməɡʊr
ysmygwyr	əsməɡwɨ̞r
ysol	əsɔl
ystad	əsdad
ystaenwydr	əstaɨ̯nwɨ̞dr
ystaenwydr	əstaɨ̯nwɨ̞dɨ̞r
ystafell	sdavaɬ
ystafell	sdavɛɬ
ystafell	əsdavɛɬ
ystifflog	əsdɪflɔɡ
ystiflogod	əsdɪflɔɡɔd
ystlum	əsdlɨ̞m
ystlys	əsdlɨ̞s
ystod	əsdɔd
ystrad	əsdrad
ystum	əstɨm
ystyr	əsdɨ̞r
ystyried	əsdərjɛd
ysu	əsɨ̞
yswain	əswai̯n
yswigen	əswɪɡɛn
ysywaeth	əsəu̯aɨ̯θ
yta	əta
yterbiwm	ɨ̞tɛrbjʊm
ytriwm	ɨ̞trjʊm
yw	ɨ̞u̯
yw	ɪu̯
ywen	əwɛn
ywen	ɨ̞u̯ɛn
ywen	ɪu̯ɛn

