မႄႈ	meː
ပႃႈ	paː
ၼၢမ်း	naːm
ၵႂၢမ်း	kwaːm
ႁႅင်း	heŋ
ၵူၼ်း	kuːn
ၶၢဝ်း	kʰaːw
မႆႉ	maːi
မိုဝ်း	mui
တႅင်	teŋ
မႆႉ	maːi
မိုဝ်း	mui
တႅင်	teŋ
လႅင်	leŋ
ပႅင်	peŋ
မႅင်	meŋ
ယႅင်	jeŋ
ဝႅင်	weŋ
သႅင်	seŋ
ၶႅင်	kʰeŋ
ငႅင်	ŋeŋ
တူဝ်ႈ	tuː
မႃႈ	maː
လႃႈ	laː
ပႃႈ	paː
ယႃႈ	jaː
ဝႃႈ	waː
သႃႈ	saː
ၶႃႈ	kʰaː
ငႃႈ	ŋaː
မိူဝ်ႈ	mɤː
လိူဝ်ႈ	lɤː
ပိူဝ်ႈ	pɤː
ယိူဝ်ႈ	jɤː
ဝိူဝ်ႈ	wɤː
သိူဝ်ႈ	sɤː
ၶိူဝ်ႈ	kʰɤː
ငိူဝ်ႈ	ŋɤː
တႆႈ	taɪ
မႆႈ	maɪ
လႆႈ	laɪ
ပႆႈ	paɪ
ယႆႈ	jaɪ
ဝႆႈ	waɪ
သႆႈ	saɪ
ၶႆႈ	kʰaɪ
ငႆႈ	ŋaɪ
