a	a˧˧
á	a˨˦
à	a˧˨
ả	a˧˩˨
ạ	a˨ˀ˩ʔ
ác	ak˦˥
ắc	ăk˦˥
ặc	ăk˨ˀ˩
ác-bít	ak˦˥-bit˦˥
ắc-coóc	ăk˦˥-kɔkp˦˥
ách	ɛk˦˥
ạch	ɛk˨ˀ˩
ác-ten	ak˦˥-tɛn˧˧
a-di-đà	a˧˧-zi˧˧-da˧˨
â	ɤ̆˧˧
ai	aj˧˧
ái	aj˨˦
ải	aj˧˩˨
a-lê	a˧˧-le˧˧
am	am˧˧
ám	am˨˦
ăm	ăm˧˧
ảm	am˧˩˨
ẵm	ăm˧ˀ˥
âm	ɤ̆m˧˧
ấm	ɤ̆m˨˦
ấm	ɤ̆m˨˦
ầm	ɤ̆m˧˨
ẩm	ɤ̆m˧˩˨
ẫm	ɤ̆m˧ˀ˥
ậm	ɤ̆m˨ˀ˩ʔ
a-mi-nô	a˧˧-mi˧˧-no˧˧
am-pe	am˧˧-pɛ˧˧
an	an˧˧
án	an˨˦
ăn	ăn˧˧
ăn	ăn˧˧
ăn;	ăn˧˧
ân	ɤ̆n˧˧
ấn	ɤ̆n˨˦
ẩn	ɤ̆n˧˩˨
ang	aŋ˧˧
áng	aŋ˨˦
ăng	ăŋ˧˧
ắng	ăŋ˨˦
ằng	ăŋ˧˨
ẳng	ăŋ˧˩˨
(anh)	ɛŋ˧˧
anh	ɛŋ˧˧
anh	ɛŋ˧˧
ánh	ɛŋ˨˦
ành	ɛŋ˧˨
ảnh	ɛŋ˧˩˨
ao	aw˧˧
ao	aw˧˧
áo	aw˨˦
Áo	aw˨˦
áo	aw˨˦
áo	aw˨˦
ào	aw˧˨
ảo	aw˧˩˨
ạo	aw˨ˀ˩ʔ
áp	ap˦˥
ấp	ɤ̆p˦˥
ập	ɤ̆p˨ˀ˩
a-rập	a˧˧-zɤ̆p˨ˀ˩
át	at˦˥
ắt	ăt˦˥
ất	ɤ̆t˦˥
au	ăw˧˧
âu	ɤ̆w˧˧
Âu	ɤ̆w˧˧
âu	ɤ̆w˧˧
Âu	ɤ̆w˧˧
âu	ɤ̆w˧˧
Âu	ɤ̆w˧˧
âu	ɤ̆w˧˧
ấu	ɤ̆w˨˦
ầu	ɤ̆w˧˨
ẩu	ɤ̆w˧˩˨
a-xê-ti-len	a˧˧-se˧˧-ti˧˧-lɛn˧˧
a-xít	a˧˧-sit˦˥
ay	ăj˧˧
áy	ăj˨˦
ấy	ɤ̆j˨˦
ba	ba˧˧
ba	ba˧˧
bá	ba˨˦
bà	ba˧˨
bả	ba˧˩˨
bã	ba˧ˀ˥
bạ	ba˨ˀ˩ʔ
bác	bak˦˥
bác	bak˦˥
bắc	băk˦˥
bạc	bak˨ˀ˩
bặc	băk˨ˀ˩
bấc	bɤ̆k˦˥
bậc	bɤ̆k˨ˀ˩
bách	bɛk˦˥
bạch	bɛk˨ˀ˩
bai	baj˧˧
bái	baj˨˦
bài	baj˧˨
bài	baj˧˨
bải	baj˧˩˨
bãi	baj˧ˀ˥
bại	baj˨ˀ˩ʔ
bam	bam˧˧
bám	bam˨˦
bàm	bam˧˨
băm	băm˧˧
bặm	băm˨ˀ˩ʔ
bấm	bɤ̆m˨˦
bầm	bɤ̆m˧˨
bẩm	bɤ̆m˧˩˨
bẫm	bɤ̆m˧ˀ˥
bậm	bɤ̆m˨ˀ˩ʔ
ban	ban˧˧
bán	ban˨˦
bán	ban˨˦
bàn	ban˧˨
băn	băn˧˧
bắn	băn˨˦
bằn	băn˧˨
bẳn	băn˧˩˨
bản	ban˧˩˨
bạn	ban˨ˀ˩ʔ
bạn	ban˨ˀ˩ʔ
bân	bɤ̆n˧˧
bấn	bɤ̆n˨˦
bần	bɤ̆n˧˨
bẩn	bɤ̆n˧˩˨
bận	bɤ̆n˨ˀ˩ʔ
bang	baŋ˧˧
báng	baŋ˨˦
bàng	baŋ˧˨
băng	băŋ˧˧
bắng	băŋ˨˦
bằng	băŋ˧˨
bảng	baŋ˧˩˨
bẵng	băŋ˧ˀ˥
bạng	baŋ˨ˀ˩ʔ
bặng	băŋ˨ˀ˩ʔ
bâng	bɤ̆ŋ˧˧
bầng	bɤ̆ŋ˧˨
băng-giô	băŋ˧˧-zo˧˧
bánh	bɛŋ˨˦
bành	bɛŋ˧˨
bành	bɛŋ˧˨
bảnh	bɛŋ˧˩˨
bạnh	bɛŋ˨ˀ˩ʔ
bao	baw˧˧
báo	baw˨˦
bào	baw˧˨
bảo	baw˧˩˨
bão	baw˧ˀ˥
bạo	baw˨ˀ˩ʔ
bắp	băp˦˥
bấp	bɤ̆p˦˥
bập	bɤ̆p˨ˀ˩
bát	bat˦˥
bát	bat˦˥
bắt	băt˦˥
bạt	bat˨ˀ˩
bặt	băt˨ˀ˩
bất	bɤ̆t˦˥
bật	bɤ̆t˨ˀ˩
ba-trui	ba˧˧-cuj˧˧
bát-tràng	bat˦˥-caŋ˧˨
báu	băw˨˦
bàu	băw˧˨
bảu	băw˧˩˨
bạu	băw˨ˀ˩ʔ
bâu	bɤ̆w˧˧
bấu	bɤ̆w˨˦
bầu	bɤ̆w˧˨
bậu	bɤ̆w˨ˀ˩ʔ
ba-xí	ba˧˧-si˨˦
bay	băj˧˧
bày	băj˧˨
bảy	băj˧˩˨
bảy	băj˧˩˨
bây	bɤ̆j˧˧
bấy	bɤ̆j˨˦
bầy	bɤ̆j˧˨
bẩy	bɤ̆j˧˩˨
bẫy	bɤ̆j˧ˀ˥
bậy	bɤ̆j˨ˀ˩ʔ
bê	be˧˧
bế	be˨˦
bề	be˧˨
bể	be˧˩˨
bệ	be˨ˀ˩ʔ
be	bɛ˧˧
be	bɛ˧˧
bé	bɛ˨˦
bè	bɛ˧˨
bẻ	bɛ˧˩˨
bẽ	bɛ˧ˀ˥
bẹ	bɛ˨ˀ˩ʔ
béc	bɛk˦˥
bệch	bek˨ˀ˩
bem	bɛm˧˧
bèm	bɛm˧˨
bẻm	bɛm˧˩˨
bên	ben˧˧
bến	ben˨˦
bền	ben˧˨
bện	ben˨ˀ˩ʔ
bén	bɛn˨˦
bèn	bɛn˧˨
bẽn	bɛn˧ˀ˥
beng	bɛŋ˧˧
bênh	beŋ˧˧
bềnh	beŋ˧˨
bệnh	beŋ˨ˀ˩ʔ
beo	beo˧˧
béo	beo˨˦
bèo	beo˧˨
bèo	beo˧˨
bẻo	beo˧˩˨
bếp	bep˦˥
bép	bɛp˦˥
bẹp	bɛp˨ˀ˩
bết	bet˦˥
bệt	bet˨ˀ˩
bét	bɛt˦˥
bẹt	bɛt˨ˀ˩
bê-tông	be˧˧-toŋm˧˧
bêu	bɛu˧˧
bều	bɛu˧˨
bệu	bɛu˨ˀ˩ʔ
bia	biə˧˧
bìa	biə˧˨
bịa	biə˨ˀ˩ʔ
bi	bi˧˧
bí	bi˨˦
bì	bi˧˨
bỉ	bi˧˩˨
bĩ	bi˧ˀ˥
bị	bi˨ˀ˩ʔ
bích	bik˦˥
bích-câu	bik˦˥-kɤ̆w˧˧
biếc	biək˦˥
biếm	biəm˨˦
biên	biən˧˧
biến	biən˨˦
biền	biən˧˨
biển	biən˧˩˨
biển	biən˧˩˨
biện	biən˨ˀ˩ʔ
biêng	biəŋ˧˧
biếng	biəŋ˨˦
biết	biət˦˥
biết	biət˦˥
biệt	biət˨ˀ˩
biếu	biəw˨˦
biểu	biəw˧˩˨
bìm	bim˧˨
bỉm	bim˧˩˨
bin	bin˧˧
bín	bin˨˦
bịn	bin˨ˀ˩ʔ
binh	biŋ˧˧
bính	biŋ˨˦
bình	biŋ˧˨
bỉnh	biŋ˧˩˨
bĩnh	biŋ˧ˀ˥
bíp	bip˦˥
bịp	bip˨ˀ˩
bít	bit˦˥
bịt	bit˨ˀ˩
bịt;	bit˨ˀ˩
bíu	biw˨˦
bìu	biw˧˨
bĩu	biw˧ˀ˥
bơ	bɤ˧˧
bớ	bɤ˨˦
bờ	bɤ˧˨
bờ	bɤ˧˨
bở	bɤ˧˩˨
bở	bɤ˧˩˨
bỡ	bɤ˧ˀ˥
bợ	bɤ˨ˀ˩ʔ
bô	bo˧˧
bố	bo˨˦
bồ	bo˧˨
bổ	bo˧˩˨
bỗ	bo˧ˀ˥
bộ	bo˨ˀ˩ʔ
bo	bɔ˧˧
bo	bɔ˧˧
bó	bɔ˨˦
(bò)	bɔ˧˨
bò	bɔ˧˨
bò;	bɔ˧˨
bỏ	bɔ˧˩˨
bõ	bɔ˧ˀ˥
bọ	bɔ˨ˀ˩ʔ
bốc	bokp˦˥
bộc	bokp˨ˀ˩
bóc	bɔkp˦˥
bọc	bɔkp˨ˀ˩
bơi	bɤj˧˧
bới	bɤj˨˦
bời	bɤj˧˨
bởi	bɤj˧˩˨
bôi	boj˧˧
bối	boj˨˦
bồi	boj˧˨
bổi	boj˧˩˨
bội	boj˨ˀ˩ʔ
bói	bɔj˨˦
bói	bɔj˨˦
bòi	bɔj˧˨
bơm	bɤm˧˧
bờm	bɤm˧˨
bợm	bɤm˨ˀ˩ʔ
bôm	bom˧˧
bồm	bom˧˨
bom	bɔm˧˧
bòm	bɔm˧˨
bỏm	bɔm˧˩˨
bơn	bɤn˧˧
bờn	bɤn˧˨
bỡn	bɤn˧ˀ˥
bợn	bɤn˨ˀ˩ʔ
bôn	bon˧˧
bốn	bon˨˦
bồn	bon˧˨
bổn	bon˧˩˨
bộn	bon˨ˀ˩ʔ
bon	bɔn˧˧
bón	bɔn˨˦
bòn	bɔn˧˨
bỏn	bɔn˧˩˨
bọn	bɔn˨ˀ˩ʔ
bông	boŋm˧˧
bống	boŋm˨˦
bống	boŋm˨˦
bồng	boŋm˧˨
bổng	boŋm˧˩˨
bổng	boŋm˧˩˨
bỗng	boŋm˧ˀ˥
bộng	boŋm˨ˀ˩ʔ
bong	bɔŋm˧˧
bóng	bɔŋm˨˦
bòng	bɔŋm˧˨
bỏng	bɔŋm˧˩˨
bọng	bɔŋm˨ˀ˩ʔ
bôn-sê-vích	bon˧˧-se˧˧-vik˦˥
boóc	bɔkp˦˥
boong	bɔŋm˧˧
bớp	bɤp˦˥
bợp	bɤp˨ˀ˩
bốp	bop˦˥
bộp	bop˨ˀ˩
bóp	bɔp˦˥
bọp	bɔp˨ˀ˩
bớt	bɤt˦˥
bợt	bɤt˨ˀ˩
bột	bot˨ˀ˩
bọt	bɔt˨ˀ˩
búa	buə˨˦
bùa	buə˧˨
bủa	buə˧˩˨
bừa	bɯə˧˨
bữa	bɯə˧ˀ˥
bữa	bɯə˧ˀ˥
bu	bu˧˧
bú	bu˨˦
bù	bu˧˨
bủ	bu˧˩˨
bụ	bu˨ˀ˩ʔ
bư	bɯ˧˧
bứ	bɯ˨˦
bự	bɯ˨ˀ˩ʔ
bức	bɯk˦˥
bực	bɯk˨ˀ˩
bui	buj˧˧
búi	buj˨˦
bùi	buj˧˨
bụi	buj˨ˀ˩ʔ
bum	bum˧˧
bùm	bum˧˨
bun	bun˧˧
bún	bun˨˦
bùn	bun˧˨
bủn	bun˧˩˨
bung	buŋm˧˧
búng	buŋm˨˦
bùng	buŋm˧˨
bủng	buŋm˧˩˨
bụng	buŋm˨ˀ˩ʔ
bụng	buŋm˨ˀ˩ʔ
bưng	bɯŋ˧˧
bưng;	bɯŋ˧˧
bừng	bɯŋ˧˨
bửng	bɯŋ˧˩˨
buộc	buək˨ˀ˩
bước	bɯək˦˥
buổi	buəj˧˩˨
bưởi	bɯəj˧˩˨
buồm	buəm˧˨
bươm	bɯəm˧˧
bướm	bɯəm˨˦
buôn	buən˧˧
buồn	buən˧˨
bươn	bɯən˧˧
buông	buəŋ˧˧
buồng	buəŋ˧˨
bương	bɯəŋ˧˧
bướng	bɯəŋ˨˦
buốt	buət˦˥
buột	buət˨ˀ˩
bươu	bɯəw˧˧
bướu	bɯəw˨˦
búp	bup˦˥
bút	but˦˥
bụt	but˨ˀ˩
bụt	but˨ˀ˩
bứt	bɯt˦˥
bưu	bɯw˧˧
bửu	bɯw˧˩˨
cách	kɛk˦˥
cạch	kɛk˨ˀ˩
các	kak˦˥
cắc	kăk˦˥
cạc	kak˨ˀ˩
cặc	kăk˨ˀ˩
cấc	kɤ̆k˦˥
các-tông	kak˦˥-toŋm˧˧
cai	kaj˧˧
cái	kaj˨˦
cái	kaj˨˦
cài	kaj˧˨
cải	kaj˧˩˨
cãi	kaj˧ˀ˥
ca	ka˧˧
cá	ka˨˦
cá	ka˨˦
cà	ka˧˨
cả	ka˧˩˨
cả	ka˧˩˨
cả;	ka˧˩˨
cam	kam˧˧
cám	kam˨˦
cám	kam˨˦
căm	kăm˧˧
cắm	kăm˨˦
cằm	kăm˧˨
cảm	kam˧˩˨
cạm	kam˨ˀ˩ʔ
cặm	kăm˨ˀ˩ʔ
câm	kɤ̆m˧˧
cấm	kɤ̆m˨˦
cầm	kɤ̆m˧˨
cầm	kɤ̆m˧˨
cẩm	kɤ̆m˧˩˨
cậm	kɤ̆m˨ˀ˩ʔ
cang	kaŋ˧˧
cáng	kaŋ˨˦
càng	kaŋ˧˨
càng	kaŋ˧˨
căng	kăŋ˧˧
cẳng	kăŋ˧˩˨
cảng	kaŋ˧˩˨
câng	kɤ̆ŋ˧˧
canh	kɛŋ˧˧
cánh	kɛŋ˨˦
cành	kɛŋ˧˨
cảnh	kɛŋ˧˩˨
cạnh	kɛŋ˨ˀ˩ʔ
can	kan˧˧
cán	kan˨˦
càn	kan˧˨
căn	kăn˧˧
cắn	kăn˨˦
cằn	kăn˧˨
cẳn	kăn˧˩˨
cản	kan˧˩˨
cạn	kan˨ˀ˩ʔ
cặn	kăn˨ˀ˩ʔ
cân	kɤ̆n˧˧
cân	kɤ̆n˧˧
cấn	kɤ̆n˨˦
cần	kɤ̆n˧˨
cần	kɤ̆n˧˨
cẩn	kɤ̆n˧˩˨
cận	kɤ̆n˨ˀ˩ʔ
cao	kaw˧˧
cao	kaw˧˧
cáo	kaw˨˦
cáo	kaw˨˦
cào	kaw˧˨
cảo	kaw˧˩˨
cạo	kaw˨ˀ˩ʔ
cà-phê	ka˧˨-fe˧˧
cáp	kap˦˥
cắp	kăp˦˥
cắp	kăp˦˥
cạp	kap˨ˀ˩
cặp	kăp˨ˀ˩
cấp	kɤ̆p˦˥
cập	kɤ̆p˨ˀ˩
cát	kat˦˥
cắt	kăt˦˥
cất	kɤ̆t˦˥
cật	kɤ̆t˨ˀ˩
cau	kăw˧˧
cáu	kăw˨˦
càu	kăw˧˨
cảu	kăw˧˩˨
câu	kɤ̆w˧˧
câu	kɤ̆w˧˧
cấu	kɤ̆w˨˦
cầu	kɤ̆w˧˨
cẩu	kɤ̆w˧˩˨
cậu	kɤ̆w˨ˀ˩ʔ
cay	kăj˧˧
cáy	kăj˨˦
cày	kăj˧˨
cày	kăj˧˨
cảy	kăj˧˩˨
cạy	kăj˨ˀ˩ʔ
cây	kɤ̆j˧˧
cấy	kɤ̆j˨˦
cầy	kɤ̆j˧˨
cầy;	kɤ̆j˧˨
cậy	kɤ̆j˨ˀ˩ʔ
cha	ca˧˧
cha	ca˧˧
chà	ca˧˨
chả	ca˧˩˨
chạ	ca˨ˀ˩ʔ
chác	cak˦˥
chắc	căk˦˥
chạc	cak˨ˀ˩
chặc	căk˨ˀ˩
chậc	cɤ̆k˨ˀ˩
chạch	cɛk˨ˀ˩
chai	caj˧˧
chài	caj˧˨
chài	caj˧˨
chải	caj˧˩˨
cham	cam˧˧
chàm	cam˧˨
chăm	căm˧˧
chằm	căm˧˨
chạm	cam˨ˀ˩ʔ
châm	cɤ̆m˧˧
chấm	cɤ̆m˨˦
chầm	cɤ̆m˧˨
chẩm	cɤ̆m˧˩˨
chậm	cɤ̆m˨ˀ˩ʔ
chan	can˧˧
chán	can˨˦
chăn	căn˧˧
chắn	căn˨˦
chằn	căn˧˨
chẵn	căn˧ˀ˥
chặn	căn˨ˀ˩ʔ
chân	cɤ̆n˧˧
chân	cɤ̆n˧˧
chấn	cɤ̆n˨˦
chần	cɤ̆n˧˨
chẩn	cɤ̆n˧˩˨
chận	cɤ̆n˨ˀ˩ʔ
chang	caŋ˧˧
chàng	caŋ˧˨
chàng	caŋ˧˨
chăng	căŋ˧˧
chằng	căŋ˧˨
chằng	căŋ˧˨
chẳng	căŋ˧˩˨
chảng	caŋ˧˩˨
chạng	caŋ˨ˀ˩ʔ
chặng	căŋ˨ˀ˩ʔ
châng	cɤ̆ŋ˧˧
chanh	cɛŋ˧˧
chánh	cɛŋ˨˦
chành	cɛŋ˧˨
chảnh	cɛŋ˧˩˨
chạnh	cɛŋ˨ˀ˩ʔ
chao	caw˧˧
cháo	caw˨˦
chào	caw˧˨
chảo	caw˧˩˨
chão	caw˧ˀ˥
chạo	caw˨ˀ˩ʔ
chắp	căp˦˥
chạp	cap˨ˀ˩
chạp	cap˨ˀ˩
chặp	căp˨ˀ˩
chấp	cɤ̆p˦˥
chập	cɤ̆p˨ˀ˩
chát	cat˦˥
chắt	căt˦˥
chặt	căt˨ˀ˩
chất	cɤ̆t˦˥
chật	cɤ̆t˨ˀ˩
chau	căw˧˧
cháu	căw˨˦
chàu	căw˧˨
chảu	căw˧˩˨
châu	cɤ̆w˧˧
chấu	cɤ̆w˨˦
chầu	cɤ̆w˧˨
chầu	cɤ̆w˧˨
chẫu	cɤ̆w˧ˀ˥
chậu	cɤ̆w˨ˀ˩ʔ
chậu	cɤ̆w˨ˀ˩ʔ
chay	căj˧˧
chay	căj˧˧
cháy	căj˨˦
cháy	căj˨˦
chày	căj˧˨
chày	căj˧˨
chảy	căj˧˩˨
chạy	căj˨ˀ˩ʔ
chây	cɤ̆j˧˧
chấy	cɤ̆j˨˦
chầy	cɤ̆j˧˨
chê	ce˧˧
chê	ce˧˧
chế	ce˨˦
chề	ce˧˨
che	cɛ˧˧
chè	cɛ˧˨
chẻ	cɛ˧˩˨
chếch	cek˦˥
chệch	cek˨ˀ˩
chêm	cem˧˧
chềm	cem˧˨
chễm	cem˧ˀ˥
chem	cɛm˧˧
chém	cɛm˨˦
chèm	cɛm˧˨
chẻm	cɛm˧˩˨
chen	cɛn˧˧
chén	cɛn˨˦
chèn	cɛn˧˨
chẻn	cɛn˧˩˨
chẹn	cɛn˨ˀ˩ʔ
cheng	cɛŋ˧˧
chênh	ceŋ˧˧
chếnh	ceŋ˨˦
chềnh	ceŋ˧˨
chểnh	ceŋ˧˩˨
chễnh	ceŋ˧ˀ˥
chệnh	ceŋ˨ˀ˩ʔ
cheo	ceo˧˧
chéo	ceo˨˦
chèo	ceo˧˨
chẻo	ceo˧˩˨
chép	cɛp˦˥
chẹp	cɛp˨ˀ˩
chết	cet˦˥
chết	cet˦˥
chét	cɛt˦˥
chẹt	cɛt˨ˀ˩
chêu	cɛu˧˧
chia	ciə˧˧
chìa	ciə˧˨
chĩa	ciə˧ˀ˥
chích	cik˦˥
chi	ci˧˧
chí	ci˨˦
chí	ci˨˦
chì	ci˧˨
chỉ	ci˧˩˨
chị	ci˨ˀ˩ʔ
chiếc	ciək˦˥
chiêm	ciəm˧˧
chiếm	ciəm˨˦
chiên	ciən˧˧
chiến	ciən˨˦
chiền	ciən˧˨
chiêng	ciəŋ˧˧
chiếng	ciəŋ˨˦
chiềng	ciəŋ˧˨
chiếp	ciəp˦˥
chiết	ciət˦˥
chiêu	ciəw˧˧
chiếu	ciəw˨˦
chiều	ciəw˧˨
chiều;	ciəw˧˨
chiểu	ciəw˧˩˨
chim	cim˧˧
chìm	cim˧˨
chin	cin˧˧
chín	cin˨˦
chỉn	cin˧˩˨
chinh	ciŋ˧˧
chính	ciŋ˨˦
chính	ciŋ˨˦
chình	ciŋ˧˨
chỉnh	ciŋ˧˩˨
chĩnh	ciŋ˧ˀ˥
chíp	cip˦˥
chít	cit˦˥
chiu	ciw˧˧
chíu	ciw˨˦
chịu	ciw˨ˀ˩ʔ
choác	cwak˦˥
choạc	cwak˨ˀ˩
choá	cwa˨˦
choai	cwaj˧˧
choàm	cwam˧˨
choăn	cwăn˧˧
choang	cwaŋ˧˧
choáng	cwaŋ˨˦
choàng	cwaŋ˧˨
choạng	cwaŋ˨ˀ˩ʔ
choắt	cwăt˦˥
chốc	cokp˦˥
chóc	cɔkp˦˥
chọc	cɔkp˨ˀ˩
chơ	cɤ˧˧
chớ	cɤ˨˦
chờ	cɤ˧˨
chở	cɤ˧˩˨
chợ	cɤ˨ˀ˩ʔ
chợ	cɤ˨ˀ˩ʔ
chô	co˧˧
chỗ	co˧ˀ˥
chỗ	co˧ˀ˥
cho	cɔ˧˧
cho	cɔ˧˧
chó	cɔ˨˦
chò	cɔ˧˨
chõ	cɔ˧ˀ˥
choe	cwe˧˧
choen	cwen˧˧
choèn	cwen˧˨
chơi	cɤj˧˧
chới	cɤj˨˦
chối	coj˨˦
chồi	coj˧˨
chổi	coj˧˩˨
choi	cɔj˧˧
chói	cɔj˨˦
chòi	cɔj˧˨
chọi	cɔj˨ˀ˩ʔ
chơm	cɤm˧˧
chớm	cɤm˨˦
chờm	cɤm˧˨
chôm	com˧˧
chồm	com˧˨
chòm	cɔm˧˨
chỏm	cɔm˧˩˨
chõm	cɔm˧ˀ˥
chơn	cɤn˧˧
chờn	cɤn˧˨
chôn	con˧˧
chốn	con˨˦
chồn	con˧˨
chộn	con˨ˀ˩ʔ
chon	cɔn˧˧
chỏn	cɔn˧˩˨
chọn	cɔn˨ˀ˩ʔ
chông	coŋm˧˧
chống	coŋm˨˦
chồng	coŋm˧˨
chổng	coŋm˧˩˨
chong	cɔŋm˧˧
chóng	cɔŋm˨˦
chóng	cɔŋm˨˦
chòng	cɔŋm˧˨
chỏng	cɔŋm˧˩˨
chớp	cɤp˦˥
chợp	cɤp˨ˀ˩
chộp	cop˨ˀ˩
chóp	cɔp˦˥
chớt	cɤt˦˥
chốt	cot˦˥
chột	cot˨ˀ˩
chót	cɔt˦˥
chua	cuə˧˧
chúa	cuə˨˦
chúa	cuə˨˦
chúa;	cuə˨˦
chùa	cuə˧˨
chưa	cɯə˧˧
chứa	cɯə˨˦
chừa	cɯə˧˨
chửa	cɯə˧˩˨
chữa	cɯə˧ˀ˥
chuẩn	cwɤ̆n˧˩˨
chúc	cukp˦˥
chục	cukp˨ˀ˩
chức	cɯk˦˥
chực	cɯk˨ˀ˩
chực	cɯk˨ˀ˩
chu	cu˧˧
chú	cu˨˦
chù	cu˧˨
(chủ	cu˧˩˨
chủ	cu˧˩˨
chủ	cu˧˩˨
chư	cɯ˧˧
chứ	cɯ˨˦
chừ	cɯ˧˨
chữ	cɯ˧ˀ˥
chuếch	cwek˦˥
chuệch	cwek˨ˀ˩
chuế	cwe˨˦
chuếnh	cweŋ˨˦
chuểnh	cweŋ˧˩˨
chuệnh	cweŋ˨ˀ˩ʔ
chui	cuj˧˧
chúi	cuj˨˦
chùi	cuj˧˨
chửi	cɯj˧˩˨
chum	cum˧˧
chúm	cum˨˦
chùm	cum˧˨
chũm	cum˧ˀ˥
chụm	cum˨ˀ˩ʔ
chun	cun˧˧
chùn	cun˧˨
chủn	cun˧˩˨
chũn	cun˧ˀ˥
chung	cuŋm˧˧
chúng	cuŋm˨˦
chùng	cuŋm˧˨
chùng	cuŋm˧˨
chủng	cuŋm˧˩˨
chưng	cɯŋ˧˧
chứng	cɯŋ˨˦
chừng	cɯŋ˧˨
chừng	cɯŋ˧˨
chững	cɯŋ˧ˀ˥
chuốc	cuək˦˥
chuộc	cuək˨ˀ˩
chước	cɯək˦˥
chuôi	cuəj˧˧
chuôi;	cuəj˧˧
chuối	cuəj˨˦
chuồi	cuəj˧˨
chuỗi	cuəj˧ˀ˥
chuội	cuəj˨ˀ˩ʔ
chuôm	cuəm˧˧
chuồn	cuən˧˨
chuông	cuəŋ˧˧
chuồng	cuəŋ˧˨
chuộng	cuəŋ˨ˀ˩ʔ
chương	cɯəŋ˧˧
chướng	cɯəŋ˨˦
chưởng	cɯəŋ˧˩˨
chuốt	cuət˦˥
chuột	cuət˨ˀ˩
chụp	cup˨ˀ˩
chút	cut˦˥
chụt	cut˨ˀ˩
chuyên	cwiən˧˧
chuyến	cwiən˨˦
chuyền	cwiən˧˨
chuyển	cwiən˧˩˨
chuyện	cwiən˨ˀ˩ʔ
cốc	kokp˦˥
cốc;	kokp˦˥
cộc	kokp˨ˀ˩
cóc	kɔkp˦˥
cóc	kɔkp˦˥
cọc	kɔkp˨ˀ˩
cô-đê	ko˧˧-de˧˧
cơi	kɤj˧˧
cời	kɤj˧˨
cởi	kɤj˧˩˨
côi	koj˧˧
cối	koj˨˦
cổi	koj˧˩˨
cỗi	koj˧ˀ˥
cội	koj˨ˀ˩ʔ
cội	koj˨ˀ˩ʔ
coi	kɔj˧˧
cói	kɔj˨˦
còi	kɔj˧˨
cõi	kɔj˧ˀ˥
cơ	kɤ˧˧
cớ	kɤ˨˦
cờ	kɤ˧˨
cờ	kɤ˧˨
cô	ko˧˧
cố	ko˨˦
cồ	ko˧˨
cổ	ko˧˩˨
cổ	ko˧˩˨
cổ;	ko˧˩˨
cỗ	ko˧ˀ˥
co	kɔ˧˧
có	kɔ˨˦
có	kɔ˨˦
cò	kɔ˧˨
cò	kɔ˧˨
cỏ	kɔ˧˩˨
cọ	kɔ˨ˀ˩ʔ
cơm	kɤm˧˧
cơm	kɤm˧˧
côm	kom˧˧
cốm	kom˨˦
cồm	kom˧˨
com	kɔm˧˧
cóm	kɔm˨˦
còm	kɔm˧˨
cỏm	kɔm˧˩˨
cọm	kɔm˨ˀ˩ʔ
công	koŋm˧˧
cống	koŋm˨˦
cồng	koŋm˧˨
cổng	koŋm˧˩˨
cộng	koŋm˨ˀ˩ʔ
cong	kɔŋm˧˧
cong	kɔŋm˧˧
cóng	kɔŋm˨˦
còng	kɔŋm˧˨
cỏng	kɔŋm˧˩˨
cõng	kɔŋm˧ˀ˥
công-xinh	koŋm˧˧-siŋ˧˧
cơn	kɤn˧˧
cớn	kɤn˨˦
cờn	kɤn˧˨
cỡn	kɤn˧ˀ˥
côn	kon˧˧
cồn	kon˧˨
cổn	kon˧˩˨
con	kɔn˧˧
con	kɔn˧˧
còn	kɔn˧˨
cỏn	kɔn˧˩˨
coóc	kɔkp˦˥
cốp	kop˦˥
cóp	kɔp˦˥
cọp	kɔp˨ˀ˩
cớt	kɤt˦˥
cợt	kɤt˨ˀ˩
cốt	kot˦˥
cột	kot˨ˀ˩
cót	kɔt˦˥
cọt	kɔt˨ˀ˩
cua	kuə˧˧
của	kuə˧˩˨
của;	kuə˧˩˨
cưa	kɯə˧˧
cưa	kɯə˧˧
cứa	kɯə˨˦
cửa	kɯə˧˩˨
cựa	kɯə˨ˀ˩ʔ
cúc	kukp˦˥
cục	kukp˨ˀ˩
cức	kɯk˦˥
cực	kɯk˨ˀ˩
cui	kuj˧˧
cúi	kuj˨˦
cùi	kuj˧˨
củi	kuj˧˩˨
cũi	kuj˧ˀ˥
cụi	kuj˨ˀ˩ʔ
cửi	kɯj˧˩˨
cu	ku˧˧
cú	ku˨˦
cù	ku˧˨
củ	ku˧˩˨
cũ	ku˧ˀ˥
cũ	ku˧ˀ˥
cụ	ku˨ˀ˩ʔ
cư	kɯ˧˧
cứ	kɯ˨˦
cừ	kɯ˧˨
cử	kɯ˧˩˨
cự	kɯ˨ˀ˩ʔ
cum	kum˧˧
cúm	kum˨˦
cùm	kum˧˨
cụm	kum˨ˀ˩ʔ
cung	kuŋm˧˧
cúng	kuŋm˨˦
cùng	kuŋm˧˨
củng	kuŋm˧˩˨
cũng	kuŋm˧ˀ˥
cụng	kuŋm˨ˀ˩ʔ
cưng	kɯŋ˧˧
cứng	kɯŋ˨˦
cun	kun˧˧
cùn	kun˧˨
cũn	kun˧ˀ˥
cuốc	kuək˦˥
cuộc	kuək˨ˀ˩
cước	kɯək˦˥
cuối	kuəj˨˦
cuội	kuəj˨ˀ˩ʔ
cưới	kɯəj˨˦
cười	kɯəj˧˨
cưỡi	kɯəj˧ˀ˥
cườm	kɯəm˧˨
cuống	kuəŋ˨˦
cuồng	kuəŋ˧˨
cuộng	kuəŋ˨ˀ˩ʔ
cương	kɯəŋ˧˧
cường	kɯəŋ˧˨
cưỡng	kɯəŋ˧ˀ˥
cuốn	kuən˨˦
cuồn	kuən˧˨
cuộn	kuən˨ˀ˩ʔ
cướp	kɯəp˦˥
cúp	kup˦˥
cụp	kup˨ˀ˩
cút	kut˦˥
cụt	kut˨ˀ˩
cứt	kɯt˦˥
cưu	kɯw˧˧
cứu	kɯw˨˦
cừu	kɯw˧˨
cửu	kɯw˧˩˨
cựu	kɯw˨ˀ˩ʔ
đắc	dăk˦˥
Đắc	dăk˦˥
đắc	dăk˦˥
đạc	dak˨ˀ˩
đặc	dăk˨ˀ˩
đách	dɛk˦˥
dạc	zak˨ˀ˩
dặc	zăk˨ˀ˩
Đa	da˧˧
đa	da˧˧
đá	da˨˦
đá	da˨˦
Đà	da˧˨
đà	da˧˨
Đà	da˧˨
đà	da˧˨
đả	da˧˩˨
đã	da˧ˀ˥
đai	daj˧˧
đái	daj˨˦
đài	daj˧˨
đãi	daj˧ˀ˥
đại	daj˨ˀ˩ʔ
Đại	daj˨ˀ˩ʔ
đại	daj˨ˀ˩ʔ
Đại	daj˨ˀ˩ʔ
đại	daj˨ˀ˩ʔ
Đại	daj˨ˀ˩ʔ
đại	daj˨ˀ˩ʔ
Đại	daj˨ˀ˩ʔ
đại	daj˨ˀ˩ʔ
đại	daj˨ˀ˩ʔ
dai	zaj˧˧
dái	zaj˨˦
dài	zaj˧˨
dài	zaj˧˨
dải	zaj˧˩˨
dãi	zaj˧ˀ˥
dại	zaj˨ˀ˩ʔ
dại	zaj˨ˀ˩ʔ
đam	dam˧˧
đám	dam˨˦
đàm	dam˧˨
đăm	dăm˧˧
đắm	dăm˨˦
đằm	dăm˧˨
đảm	dam˧˩˨
đẵm	dăm˧ˀ˥
đạm	dam˨ˀ˩ʔ
đặm	dăm˨ˀ˩ʔ
đâm	dɤ̆m˧˧
đấm	dɤ̆m˨˦
đầm	dɤ̆m˧˨
đẫm	dɤ̆m˧ˀ˥
đậm	dɤ̆m˨ˀ˩ʔ
dám	zam˨˦
dăm	zăm˧˧
dắm	zăm˨˦
dạm	zam˨ˀ˩ʔ
dặm	zăm˨ˀ˩ʔ
dâm	zɤ̆m˧˧
dấm	zɤ̆m˨˦
dầm	zɤ̆m˧˨
dẫm	zɤ̆m˧ˀ˥
dậm	zɤ̆m˨ˀ˩ʔ
đan	dan˧˧
Đan	dan˧˧
đan	dan˧˧
đàn	dan˧˨
đàn	dan˧˨
đắn	dăn˨˦
đản	dan˧˩˨
đạn	dan˨ˀ˩ʔ
đần	dɤ̆n˧˨
đẫn	dɤ̆n˧ˀ˥
đận	dɤ̆n˨ˀ˩ʔ
đang	daŋ˧˧
đáng	daŋ˨˦
đàng	daŋ˧˨
đăng	dăŋ˧˧
Đăng	dăŋ˧˧
đắng	dăŋ˨˦
đằng	dăŋ˧˨
đẳng	dăŋ˧˩˨
đảng	daŋ˧˩˨
Đảng	daŋ˧˩˨
đảng	daŋ˧˩˨
đãng	daŋ˧ˀ˥
đấng	dɤ̆ŋ˨˦
đấng	dɤ̆ŋ˨˦
dang	zaŋ˧˧
dáng	zaŋ˨˦
dàng	zaŋ˧˨
dăng	zăŋ˧˧
dằng	zăŋ˧˨
dằng;	zăŋ˧˨
dẳng	zăŋ˧˩˨
dạng	zaŋ˨ˀ˩ʔ
dặng	zăŋ˨ˀ˩ʔ
dâng	zɤ̆ŋ˧˧
đanh	dɛŋ˧˧
đánh	dɛŋ˨˦
Đánh	dɛŋ˨˦
đánh	dɛŋ˨˦
đành	dɛŋ˧˨
danh	zɛŋ˧˧
dành	zɛŋ˧˨
dan	zan˧˧
dán	zan˨˦
dàn	zan˧˨
dăn	zăn˧˧
dằn	zăn˧˨
dẳn	zăn˧˩˨
dãn	zan˧ˀ˥
dạn	zan˨ˀ˩ʔ
dặn	zăn˨ˀ˩ʔ
(dân	zɤ̆n˧˧
dân	zɤ̆n˧˧
dấn	zɤ̆n˨˦
dần	zɤ̆n˧˨
dẫn	zɤ̆n˧ˀ˥
dận	zɤ̆n˨ˀ˩ʔ
đao	daw˧˧
đáo	daw˨˦
đào	daw˧˨
đảo	daw˧˩˨
đảo;	daw˧˩˨
đạo	daw˨ˀ˩ʔ
Đạo	daw˨ˀ˩ʔ
đạo	daw˨ˀ˩ʔ
dao	zaw˧˧
dáo	zaw˨˦
dào	zaw˧˨
dạo	zaw˨ˀ˩ʔ
đáp	dap˦˥
đắp	dăp˦˥
đạp	dap˨ˀ˩
đập	dɤ̆p˨ˀ˩
dấp	zɤ̆p˦˥
dập	zɤ̆p˨ˀ˩
đắt	dăt˦˥
đạt	dat˨ˀ˩
đặt	dăt˨ˀ˩
đất	dɤ̆t˦˥
Đất	dɤ̆t˦˥
đất	dɤ̆t˦˥
đất	dɤ̆t˦˥
đạt-lai	dat˨ˀ˩-laj˧˧
dát	zat˦˥
dắt	zăt˦˥
dạt	zat˨ˀ˩
dặt	zăt˨ˀ˩
dật	zɤ̆t˨ˀ˩
đau	dăw˧˧
đau	dăw˧˧
đâu	dɤ̆w˧˧
đâu	dɤ̆w˧˧
đấu	dɤ̆w˨˦
đầu	dɤ̆w˧˨
đầu	dɤ̆w˧˨
đẩu	dɤ̆w˧˩˨
đậu	dɤ̆w˨ˀ˩ʔ
đậu	dɤ̆w˨ˀ˩ʔ
dáu	zăw˨˦
dàu	zăw˧˨
dâu	zɤ̆w˧˧
dấu	zɤ̆w˨˦
dầu	zɤ̆w˧˨
dẫu	zɤ̆w˧ˀ˥
dậu	zɤ̆w˨ˀ˩ʔ
đay	dăj˧˧
đáy	dăj˨˦
đày	dăj˧˨
đây	dɤ̆j˧˧
đấy	dɤ̆j˨˦
đầy	dɤ̆j˧˨
đẩy	dɤ̆j˧˩˨
đẫy	dɤ̆j˧ˀ˥
đậy	dɤ̆j˨ˀ˩ʔ
day	zăj˧˧
dày	zăj˧˨
dảy	zăj˧˩˨
dãy	zăj˧ˀ˥
dạy	zăj˨ˀ˩ʔ
dây	zɤ̆j˧˧
dây	zɤ̆j˧˧
dấy	zɤ̆j˨˦
dẫy	zɤ̆j˧ˀ˥
dậy	zɤ̆j˨ˀ˩ʔ
da	za˧˧
da	za˧˧
dà	za˧˨
dã	za˧ˀ˥
dạ	za˨ˀ˩ʔ
dạ	za˨ˀ˩ʔ
dạ;	za˨ˀ˩ʔ
đếch	dek˦˥
đê	de˧˧
đế	de˨˦
Đế	de˨˦
đế	de˨˦
đề	de˧˨
để	de˧˩˨
để	de˧˩˨
đệ	de˨ˀ˩ʔ
đệ;	de˨ˀ˩ʔ
đe	dɛ˧˧
đè	dɛ˧˨
đẻ	dɛ˧˩˨
đẻ	dɛ˧˩˨
đêm	dem˧˧
đếm	dem˨˦
đệm	dem˨ˀ˩ʔ
đem	dɛm˧˧
đèm	dɛm˧˨
đến	den˨˦
đền	den˧˨
Đền	den˧˨
đền	den˧˨
đen	dɛn˧˧
đèn	dɛn˧˨
Đèn	dɛn˧˨
đèn	dɛn˧˨
đèn	dɛn˧˨
đẹn	dɛn˨ˀ˩ʔ
đềnh	deŋ˧˨
đểnh	deŋ˧˩˨
đễnh	deŋ˧ˀ˥
dềnh	zeŋ˧˨
dệnh	zeŋ˨ˀ˩ʔ
dền	zen˧˨
dèn	zɛn˧˨
đeo	deo˧˧
đéo	deo˨˦
đèo	deo˧˨
đẽo	deo˧ˀ˥
deo	zeo˧˧
dẻo	zeo˧˩˨
dẻo	zeo˧˩˨
đẹp	dɛp˨ˀ˩
dép	zɛp˦˥
dẹp	zɛp˨ˀ˩
đẹt	dɛt˨ˀ˩
dệt	zet˨ˀ˩
dẹt	zɛt˨ˀ˩
đều	dɛu˧˨
đều	dɛu˧˨
đểu	dɛu˧˩˨
dê	ze˧˧
dế	ze˨˦
dề	ze˧˨
dể	ze˧˩˨
dễ	ze˧ˀ˥
de	zɛ˧˧
dé	zɛ˨˦
dè	zɛ˧˨
dẻ	zɛ˧˩˨
dẽ	zɛ˧ˀ˥
đỉa	diə˧˩˨
đỉa;	diə˧˩˨
đĩa	diə˧ˀ˥
đĩa	diə˧ˀ˥
địa	diə˨ˀ˩ʔ
Địa	diə˨ˀ˩ʔ
địa	diə˨ˀ˩ʔ
đích	dik˦˥
địch	dik˨ˀ˩
dích	zik˦˥
dịch	zik˨ˀ˩
đi	di˧˧
đi	di˧˧
đí	di˨˦
đì	di˧˨
đĩ	di˧ˀ˥
điếc	diək˦˥
diếc	ziək˦˥
diệc	ziək˨ˀ˩
điếm	diəm˨˦
điềm	diəm˧˨
điểm	diəm˧˩˨
diêm	ziəm˧˧
diềm	ziəm˧˨
diễm	ziəm˧ˀ˥
diệm	ziəm˨ˀ˩ʔ
điên	diən˧˧
điền	diən˧˨
điển	diən˧˩˨
điện	diən˨ˀ˩ʔ
diên	ziən˧˧
diễn	ziən˧ˀ˥
diện	ziən˨ˀ˩ʔ
điệp	diəp˨ˀ˩
diếp	ziəp˦˥
diệp	ziəp˨ˀ˩
diệt	ziət˨ˀ˩
điêu	diəw˧˧
Điêu	diəw˧˧
điêu	diəw˧˧
Điêu	diəw˧˧
điêu	diəw˧˧
điếu	diəw˨˦
điều	diəw˧˨
điều	diəw˧˨
điểu	diəw˧˩˨
điệu	diəw˨ˀ˩ʔ
diều	ziəw˧˨
diễu	ziəw˧ˀ˥
diệu	ziəw˨ˀ˩ʔ
đinh	diŋ˧˧
đính	diŋ˨˦
đình	diŋ˧˨
Đình	diŋ˧˨
đình	diŋ˧˨
Đình	diŋ˧˨
đình	diŋ˧˨
Đình	diŋ˧˨
đình	diŋ˧˨
Đình	diŋ˧˨
đình	diŋ˧˨
đỉnh	diŋ˧˩˨
đĩnh	diŋ˧ˀ˥
Định	diŋ˨ˀ˩ʔ
định	diŋ˨ˀ˩ʔ
Định	diŋ˨ˀ˩ʔ
định	diŋ˨ˀ˩ʔ
dinh	ziŋ˧˧
dính	ziŋ˨˦
dĩnh	ziŋ˧ˀ˥
díp	zip˦˥
dịp	zip˨ˀ˩
đít	dit˦˥
địt	dit˨ˀ˩
đìu	diw˧˨
díu;	ziw˨˦
dìu	ziw˧˨
dịu	ziw˨ˀ˩ʔ
di	zi˧˧
dí	zi˨˦
dì	zi˧˨
dỉ	zi˧˩˨
dĩ	zi˧ˀ˥
dị	zi˨ˀ˩ʔ
đoạ	dwa˨ˀ˩ʔ
đọa	dwa˨ˀ˩ʔ
đoái	dwaj˨˦
đoan	dwan˧˧
Đoan	dwan˧˧
đoan	dwan˧˧
Đoan	dwan˧˧
đoan	dwan˧˧
Đoan	dwan˧˧
đoan	dwan˧˧
đoán	dwan˨˦
(đoàn)	dwan˧˨
đoàn	dwan˧˨
đoản	dwan˧˩˨
đoạn	dwan˨ˀ˩ʔ
đoàng	dwaŋ˧˨
đoàng;	dwaŋ˧˨
đoảng	dwaŋ˧˩˨
đoảng	dwaŋ˧˩˨
đoành	dwɛŋ˧˨
doanh	zwɛŋ˧˧
đoạt	dwat˨ˀ˩
doạ	zwa˨ˀ˩ʔ
dọa	zwa˨ˀ˩ʔ
đốc	dokp˦˥
Đốc	dokp˦˥
đốc	dokp˦˥
độc	dokp˨ˀ˩
đọc	dɔkp˨ˀ˩
đốc-tơ;	dokp˦˥-tɤ˧˧
dốc	zokp˦˥
dóc	zɔkp˦˥
dọc	zɔkp˨ˀ˩
đớ	dɤ˨˦
đờ	dɤ˧˨
đỡ	dɤ˧ˀ˥
đợ	dɤ˨ˀ˩ʔ
đô	do˧˧
đố	do˨˦
đồ	do˧˨
đổ	do˧˩˨
đỗ	do˧ˀ˥
"độ	do˨ˀ˩ʔ
độ	do˨ˀ˩ʔ
Độ	do˨ˀ˩ʔ
độ	do˨ˀ˩ʔ
Độ	do˨ˀ˩ʔ
độ	do˨ˀ˩ʔ
đo	dɔ˧˧
đó	dɔ˨˦
đó	dɔ˨˦
đò	dɔ˧˨
đỏ	dɔ˧˩˨
đọ	dɔ˨ˀ˩ʔ
đới	dɤj˨˦
đời	dɤj˧˨
đời;	dɤj˧˨
đợi	dɤj˨ˀ˩ʔ
đôi	doj˧˧
Đôi	doj˧˧
đôi	doj˧˧
đối	doj˨˦
đồi	doj˧˨
đổi	doj˧˩˨
đội	doj˨ˀ˩ʔ
đoi	dɔj˧˧
đói	dɔj˨˦
đói	dɔj˨˦
đòi	dɔj˧˨
đòi	dɔj˧˨
đọi	dɔj˨ˀ˩ʔ
đọi	dɔj˨ˀ˩ʔ
dơi	zɤj˧˧
dời	zɤj˧˨
dôi	zoj˧˧
dối	zoj˨˦
dồi	zoj˧˨
dội	zoj˨ˀ˩ʔ
doi	zɔj˧˧
dòi	zɔj˧˨
dõi	zɔj˧ˀ˥
đơm	dɤm˧˧
đởm	dɤm˧˩˨
đôm	dom˧˧
đốm	dom˨˦
đồm	dom˧˨
đom	dɔm˧˧
đóm	dɔm˨˦
đòm	dɔm˧˨
đỏm	dɔm˧˩˨
đờ-mi	dɤ˧˨-mi˧˧
dòm	zɔm˧˨
đơn	dɤn˧˧
đớn	dɤn˨˦
đờn	dɤn˧˨
Đôn	don˧˧
đôn	don˧˧
đốn	don˨˦
đồn	don˧˨
độn	don˨ˀ˩ʔ
đon	dɔn˧˧
đón	dɔn˨˦
đòn	dɔn˧˨
đông	doŋm˧˧
Đông	doŋm˧˧
đông	doŋm˧˧
Đông	doŋm˧˧
đông	doŋm˧˧
đông	doŋm˧˧
đống	doŋm˨˦
đồng	doŋm˧˨
đồng	doŋm˧˨
Đổng	doŋm˧˩˨
đổng	doŋm˧˩˨
động	doŋm˨ˀ˩ʔ
đong	dɔŋm˧˧
đóng	dɔŋm˨˦
đòng	dɔŋm˧˨
đỏng	dɔŋm˧˩˨
đọng	dɔŋm˨ˀ˩ʔ
Đông-nam	doŋm˧˧-nam˧˧
dông	zoŋm˧˧
dồng	zoŋm˧˨
dộng	zoŋm˨ˀ˩ʔ
dong	zɔŋm˧˧
dong;	zɔŋm˧˧
dóng	zɔŋm˨˦
dòng	zɔŋm˧˨
dõng	zɔŋm˧ˀ˥
dớn	zɤn˨˦
dờn	zɤn˧˨
dồn	zon˧˨
dọn	zɔn˨ˀ˩ʔ
đớp	dɤp˦˥
đốp	dop˦˥
độp	dop˨ˀ˩
đốt	dot˦˥
đột	dot˨ˀ˩
dốt	zot˦˥
dột	zot˨ˀ˩
dơ	zɤ˧˧
dớ	zɤ˨˦
dở	zɤ˧˩˨
dỡ	zɤ˧ˀ˥
dô	zo˧˧
dỗ	zo˧ˀ˥
do	zɔ˧˧
dó	zɔ˨˦
dò	zɔ˧˨
dò	zɔ˧˨
dọ	zɔ˨ˀ˩ʔ
đua	duə˧˧
đùa	duə˧˨
đũa	duə˧ˀ˥
đũa;	duə˧ˀ˥
đưa	dɯə˧˧
đứa	dɯə˨˦
duật	zwɤ̆t˨ˀ˩
dua	zuə˧˧
dưa	zɯə˧˧
dưa	zɯə˧˧
dứa	zɯə˨˦
dừa	zɯə˧˨
dựa	zɯə˨ˀ˩ʔ
đúc	dukp˦˥
đục	dukp˨ˀ˩
đục	dukp˨ˀ˩
Đức	dɯk˦˥
đức	dɯk˦˥
Đức	dɯk˦˥
đức	dɯk˦˥
Đức	dɯk˦˥
đực	dɯk˨ˀ˩
dục	zukp˨ˀ˩
dức	zɯk˦˥
đu	du˧˧
đú	du˨˦
đú	du˨˦
đù	du˧˨
đủ	du˧˩˨
đụ	du˨ˀ˩ʔ
đứ	dɯ˨˦
đử	dɯ˧˩˨
đuềnh	dweŋ˧˨
đuểnh	dweŋ˧˩˨
đuễnh	dweŋ˧ˀ˥
duềnh	zweŋ˧˨
đui	duj˧˧
đùi	duj˧˨
dúi	zuj˨˦
dùi	zuj˧˨
đum	dum˧˧
đùm	dum˧˨
dúm	zum˨˦
dụm	zum˨ˀ˩ʔ
đun	dun˧˧
đún	dun˨˦
đùn	dun˧˨
đụn	dun˨ˀ˩ʔ
đung	duŋm˧˧
đúng	duŋm˨˦
đùng	duŋm˧˨
đủng	duŋm˧˩˨
đũng	duŋm˧ˀ˥
đụng	duŋm˨ˀ˩ʔ
đứng	dɯŋ˨˦
đừng	dɯŋ˧˨
đựng	dɯŋ˨ˀ˩ʔ
dung	zuŋm˧˧
dúng	zuŋm˨˦
dùng	zuŋm˧˨
dũng	zuŋm˧ˀ˥
dụng	zuŋm˨ˀ˩ʔ
dưng	zɯŋ˧˧
dừng	zɯŋ˧˨
dửng	zɯŋ˧˩˨
dựng	zɯŋ˨ˀ˩ʔ
dun	zun˧˧
dún	zun˨˦
đuốc	duək˦˥
được	dɯək˨ˀ˩
được	dɯək˨ˀ˩
duốc	zuək˦˥
dược	zɯək˨ˀ˩
đuôi	duəj˧˧
đuối	duəj˨˦
đuổi	duəj˧˩˨
đười	dɯəj˧˨
duỗi	zuəj˧ˀ˥
dưới	zɯəj˨˦
đượm	dɯəm˨ˀ˩ʔ
đuồn	duən˧˨
đườn	dɯən˧˨
đương	dɯəŋ˧˧
đường	dɯəŋ˧˨
Đường	dɯəŋ˧˨
đường	dɯəŋ˧˨
Đường	dɯəŋ˧˨
đường	dɯəŋ˧˨
Đường	dɯəŋ˧˨
đường	dɯəŋ˧˨
Đường	dɯəŋ˧˨
đường	dɯəŋ˧˨
đường	dɯəŋ˧˨
dương	zɯəŋ˧˧
dường	zɯəŋ˧˨
dưỡng	zɯəŋ˧ˀ˥
đút	dut˦˥
đứt	dɯt˦˥
dút	zut˦˥
dứt	zɯt˦˥
duyên	zwiən˧˧
duyệt	zwiət˨ˀ˩
duy	zwi˧˧
du	zu˧˧
dù	zu˧˨
dũ	zu˧ˀ˥
dụ	zu˨ˀ˩ʔ
dư	zɯ˧˧
dừ	zɯ˧˨
dừ;	zɯ˧˨
dử	zɯ˧˩˨
dữ	zɯ˧ˀ˥
dự	zɯ˨ˀ˩ʔ
éc	ɛk˦˥
ẹc	ɛk˨ˀ˩
ếch	ek˦˥
ê	e˧˧
ê	e˧˧
ế	e˨˦
ề	e˧˨
e	ɛ˧˧
é	ɛ˨˦
è	ɛ˧˨
ẹ	ɛ˨ˀ˩ʔ
êm	em˧˧
Êm	em˧˧
êm	em˧˧
em	ɛm˧˧
ém	ɛm˨˦
en	ɛn˧˧
én	ɛn˨˦
ễng	eŋ˧ˀ˥
eng	ɛŋ˧˧
èng	ɛŋ˧˨
ềnh	eŋ˧˨
ễnh	eŋ˧ˀ˥
eo	eo˧˧
éo	eo˨˦
èo	eo˧˨
ẻo	eo˧˩˨
ẽo	eo˧ˀ˥
ẹo	eo˨ˀ˩ʔ
ép	ɛp˦˥
ét	ɛt˦˥
êu	ɛu˧˧
gác	ɣak˦˥
gạc	ɣak˨ˀ˩
gặc	ɣăk˨ˀ˩
gạch	ɣɛk˨ˀ˩
ga	ɣa˧˧
gá	ɣa˨˦
gà	ɣa˧˨
gà	ɣa˧˨
gả	ɣa˧˩˨
gạ	ɣa˨ˀ˩ʔ
gai	ɣaj˧˧
gái	ɣaj˨˦
gái	ɣaj˨˦
gài	ɣaj˧˨
gãi	ɣaj˧ˀ˥
gãi	ɣaj˧ˀ˥
găm	ɣăm˧˧
gắm	ɣăm˨˦
gằm	ɣăm˧˨
gặm	ɣăm˨ˀ˩ʔ
gâm	ɣɤ̆m˧˧
gấm	ɣɤ̆m˨˦
gầm	ɣɤ̆m˧˨
gậm	ɣɤ̆m˨ˀ˩ʔ
gang	ɣaŋ˧˧
găng	ɣăŋ˧˧
gắng	ɣăŋ˨˦
gặng	ɣăŋ˨ˀ˩ʔ
gan	ɣan˧˧
gan	ɣan˧˧
gán	ɣan˨˦
gàn	ɣan˧˨
găn	ɣăn˧˧
gắn	ɣăn˨˦
gằn	ɣăn˧˨
gạn	ɣan˨ˀ˩ʔ
gân	ɣɤ̆n˧˧
gần	ɣɤ̆n˧˨
ganh	ɣɛŋ˧˧
gánh	ɣɛŋ˨˦
gáo	ɣaw˨˦
gáo	ɣaw˨˦
gào	ɣaw˧˨
gạo	ɣaw˨ˀ˩ʔ
gạo	ɣaw˨ˀ˩ʔ
gắp	ɣăp˦˥
gặp	ɣăp˨ˀ˩
gấp	ɣɤ̆p˦˥
gập	ɣɤ̆p˨ˀ˩
gắt	ɣăt˦˥
gạt	ɣat˨ˀ˩
gặt	ɣăt˨ˀ˩
gật	ɣɤ̆t˨ˀ˩
gau	ɣăw˧˧
gàu	ɣăw˧˨
gâu	ɣɤ̆w˧˧
gấu	ɣɤ̆w˨˦
gầu	ɣɤ̆w˧˨
gẫu	ɣɤ̆w˧ˀ˥
gay	ɣăj˧˧
gáy	ɣăj˨˦
gày	ɣăj˧˨
gảy	ɣăj˧˩˨
gãy	ɣăj˧ˀ˥
gây	ɣɤ̆j˧˧
gấy	ɣɤ̆j˨˦
gầy	ɣɤ̆j˧˨
gẩy	ɣɤ̆j˧˩˨
gẫy	ɣɤ̆j˧ˀ˥
gậy	ɣɤ̆j˨ˀ˩ʔ
ghê	ɣe˧˧
ghế	ɣe˨˦
ghe	ɣɛ˧˧
ghé	ɣɛ˨˦
ghè	ɣɛ˧˨
ghẻ	ɣɛ˧˩˨
ghẹ	ɣɛ˨ˀ˩ʔ
ghen	ɣɛn˧˧
ghèn	ɣɛn˧˨
ghểnh	ɣeŋ˧˩˨
ghẹo	ɣeo˨ˀ˩ʔ
ghép	ɣɛp˦˥
ghét	ɣɛt˦˥
ghiền	ɣiən˧˨
ghi	ɣi˧˧
ghim	ɣim˧˧
giác	zak˦˥
giạc	zak˨ˀ˩
giặc	zăk˨ˀ˩
giặc	zăk˨ˀ˩
giấc	zɤ̆k˦˥
giai	zaj˧˧
giải	zaj˧˩˨
giãi	zaj˧ˀ˥
giam	zam˧˧
giám	zam˨˦
giăm	zăm˧˧
giắm	zăm˨˦
giảm	zam˧˩˨
giấm	zɤ̆m˨˦
giầm	zɤ̆m˧˨
giẫm	zɤ̆m˧ˀ˥
giậm	zɤ̆m˨ˀ˩ʔ
giang	zaŋ˧˧
giáng	zaŋ˨˦
giàng	zaŋ˧˨
giăng	zăŋ˧˧
giắng	zăŋ˨˦
giằng	zăŋ˧˨
giảng	zaŋ˧˩˨
giạng	zaŋ˨ˀ˩ʔ
giành	zɛŋ˧˨
gian	zan˧˧
gián	zan˨˦
giàn	zan˧˨
giằn	zăn˧˨
giản	zan˧˩˨
giãn	zan˧ˀ˥
giấn	zɤ̆n˨˦
giần	zɤ̆n˧˨
giận	zɤ̆n˨ˀ˩ʔ
giao	zaw˧˧
giáo	zaw˨˦
giảo	zaw˧˩˨
giáp	zap˦˥
giấp	zɤ̆p˦˥
giập	zɤ̆p˨ˀ˩
giát	zat˦˥
giắt	zăt˦˥
giạt	zat˨ˀ˩
giặt	zăt˨ˀ˩
giật	zɤ̆t˨ˀ˩
giau	zăw˧˧
giàu	zăw˧˨
giàu	zăw˧˨
giảu	zăw˧˩˨
giâu	zɤ̆w˧˧
giấu	zɤ̆w˨˦
giầu	zɤ̆w˧˨
giậu	zɤ̆w˨ˀ˩ʔ
giày	zăj˧˨
giãy	zăj˧ˀ˥
giây	zɤ̆j˧˧
giấy	zɤ̆j˨˦
giầy	zɤ̆j˧˨
giẫy	zɤ̆j˧ˀ˥
gia	za˧˧
giá	za˨˦
già	za˧˨
già	za˧˨
(giả)	za˧˩˨
giả	za˧˩˨
giả	za˧˩˨
giã	za˧ˀ˥
giếc	zek˦˥
gièm	zɛm˧˨
giêng	zeŋ˧˧
giếng	zeŋ˨˦
giếng	zeŋ˨˦
giềng	zeŋ˧˨
giền	zen˧˨
gieo	zeo˧˧
giéo	zeo˨˦
giẹo	zeo˨ˀ˩ʔ
giẹp	zɛp˨ˀ˩
giết	zet˦˥
giễu	zɛu˧ˀ˥
giẻ	zɛ˧˩˨
giẻ	zɛ˧˩˨
gì	ɣi˧˨
gỉ	ɣi˧˩˨
gìn	zin˧˨
giới	zɤj˨˦
giời	zɤj˧˨
giối	zoj˨˦
giồi	zoj˧˨
giội	zoj˨ˀ˩ʔ
giòi	zɔj˧˨
giỏi	zɔj˧˩˨
giông	zoŋm˧˧
giống	zoŋm˨˦
giồng	zoŋm˧˨
giong	zɔŋm˧˧
gióng	zɔŋm˨˦
giỏng	zɔŋm˧˩˨
giọng	zɔŋm˨ˀ˩ʔ
giôn	zon˧˧
gion	zɔn˧˧
giòn	zɔn˧˨
giọt	zɔt˨ˀ˩
giơ	zɤ˧˧
giờ	zɤ˧˨
giở	zɤ˧˩˨
giỗ	zo˧ˀ˥
gio	zɔ˧˧
gió	zɔ˨˦
gió	zɔ˨˦
gió;	zɔ˨˦
giò	zɔ˧˨
giò	zɔ˧˨
giỏ	zɔ˧˩˨
giũa	zuə˧ˀ˥
giữa	zɯə˧ˀ˥
giục	zukp˨ˀ˩
giúi	zuj˨˦
giùi	zuj˧˨
giùm	zum˧˨
giun	zun˧˧
giương	zɯəŋ˧˧
giường	zɯəŋ˧˨
giường	zɯəŋ˧˨
giúp	zup˦˥
giu	zu˧˧
giũ	zu˧ˀ˥
giữ	zɯ˧ˀ˥
gi	zi˧˧
goá	ɣwa˨˦
góa	ɣwa˨˦
gốc	ɣokp˦˥
gốc	ɣokp˦˥
góc	ɣɔkp˦˥
gờ	ɣɤ˧˨
gở	ɣɤ˧˩˨
gỡ	ɣɤ˧ˀ˥
gô	ɣo˧˧
gồ	ɣo˧˨
gỗ	ɣo˧ˀ˥
gò	ɣɔ˧˨
gõ	ɣɔ˧ˀ˥
gọ	ɣɔ˨ˀ˩ʔ
gởi	ɣɤj˧˩˨
gợi	ɣɤj˨ˀ˩ʔ
gối	ɣoj˨˦
gội	ɣoj˨ˀ˩ʔ
gói	ɣɔj˨˦
gỏi	ɣɔj˧˩˨
gọi	ɣɔj˨ˀ˩ʔ
gớm	ɣɤm˨˦
gờm	ɣɤm˧˨
gôm	ɣom˧˧
gom	ɣɔm˧˧
gông	ɣoŋm˧˧
gồng	ɣoŋm˧˨
gọng	ɣɔŋm˨ˀ˩ʔ
gòn-gia	ɣɔn˧˨-za˧˧
gờn	ɣɤn˧˨
gợn	ɣɤn˨ˀ˩ʔ
gòn	ɣɔn˧˨
gọn	ɣɔn˨ˀ˩ʔ
goòng	ɣɔŋm˧˨
gộp	ɣop˨ˀ˩
góp	ɣɔp˦˥
gột	ɣot˨ˀ˩
gót	ɣɔt˦˥
gọt	ɣɔt˨ˀ˩
gục	ɣukp˨ˀ˩
gừ	ɣɯ˧˨
gửi	ɣɯj˧˩˨
gừng	ɣɯŋ˧˨
gùn	ɣun˧˨
guốc	ɣuək˦˥
guốc	ɣuək˦˥
gươm	ɣɯəm˧˧
gườm	ɣɯəm˧˨
guồng	ɣuəŋ˧˨
gương	ɣɯəŋ˧˧
gường	ɣɯəŋ˧˨
gượng	ɣɯəŋ˨ˀ˩ʔ
guột	ɣuət˨ˀ˩
gút	ɣut˦˥
hắc	hăk˦˥
hạc	hak˨ˀ˩
hặc	hăk˨ˀ˩
hách	hɛk˦˥
hạch	hɛk˨ˀ˩
hà-đông	ha˧˨-doŋm˧˧
ha	ha˧˧
há	ha˨˦
hà	ha˧˨
hả	ha˧˩˨
hạ	ha˨ˀ˩ʔ
hai	haj˧˧
hai	haj˧˧
hái	haj˨˦
hài	haj˧˨
hải	haj˧˩˨
hãi	haj˧ˀ˥
hại	haj˨ˀ˩ʔ
ham	ham˧˧
hám	ham˨˦
hàm	ham˧˨
hăm	hăm˧˧
hằm	hăm˧˨
hãm	ham˧ˀ˥
hạm	ham˨ˀ˩ʔ
hặm	hăm˨ˀ˩ʔ
hâm	hɤ̆m˧˧
hấm	hɤ̆m˨˦
hầm	hɤ̆m˧˨
hẩm	hɤ̆m˧˩˨
hậm	hɤ̆m˨ˀ˩ʔ
hang	haŋ˧˧
hàng	haŋ˧˨
hăng	hăŋ˧˧
hắng	hăŋ˨˦
hằng	hăŋ˧˨
hãng	haŋ˧ˀ˥
hạng	haŋ˨ˀ˩ʔ
hẫng	hɤ̆ŋ˧ˀ˥
han	han˧˧
hán	han˨˦
hàn	han˧˨
hắn	hăn˨˦
hằn	hăn˧˨
hẳn	hăn˧˩˨
hãn	han˧ˀ˥
hạn	han˨ˀ˩ʔ
hân	hɤ̆n˧˧
hấn	hɤ̆n˨˦
hận	hɤ̆n˨ˀ˩ʔ
hanh	hɛŋ˧˧
hánh	hɛŋ˨˦
hành	hɛŋ˧˨
hãnh	hɛŋ˧ˀ˥
hạnh	hɛŋ˨ˀ˩ʔ
hao	haw˧˧
háo	haw˨˦
hào	haw˧˨
hảo	haw˧˩˨
hão	haw˧ˀ˥
hạo	haw˨ˀ˩ʔ
hạp	hap˨ˀ˩
hấp	hɤ̆p˦˥
hát	hat˦˥
hắt	hăt˦˥
hạt	hat˨ˀ˩
hất	hɤ̆t˦˥
hau	hăw˧˧
háu	hăw˨˦
hầu	hɤ̆w˧˨
hẩu	hɤ̆w˧˩˨
hậu	hɤ̆w˨ˀ˩ʔ
hậu	hɤ̆w˨ˀ˩ʔ
hay	hăj˧˧
háy	hăj˨˦
hãy	hăj˧ˀ˥
hây	hɤ̆j˧˧
héc	hɛk˦˥
hếch	hek˦˥
hệch	hek˨ˀ˩
hề	he˧˨
hể	he˧˩˨
hệ	he˨ˀ˩ʔ
hé	hɛ˨˦
hè	hɛ˧˨
hèm	hɛm˧˨
hẻm	hɛm˧˩˨
hên	hen˧˧
hen	hɛn˧˧
hèn	hɛn˧˨
hẹn	hɛn˨ˀ˩ʔ
hênh	heŋ˧˧
hềnh	heŋ˧˨
hểnh	heŋ˧˩˨
heo	heo˧˧
héo	heo˨˦
hèo	heo˧˨
hẻo	heo˧˩˨
hẹp	hɛp˨ˀ˩
hết	het˦˥
hét	hɛt˦˥
hểu	hɛu˧˩˨
hịch	hik˨ˀ˩
hiếm	hiəm˨˦
hiềm	hiəm˧˨
hiểm	hiəm˧˩˨
hiêng	hiəŋ˧˧
hiên	hiən˧˧
hiến	hiən˨˦
hiền	hiən˧˨
hiển	hiən˧˩˨
hiện	hiən˨ˀ˩ʔ
hiếp	hiəp˦˥
hiệp	hiəp˨ˀ˩
hiếu	hiəw˨˦
hiểu	hiəw˧˩˨
hiệu	hiəw˨ˀ˩ʔ
hi	hi˧˧
hí	hi˨˦
hì	hi˧˨
hỉ	hi˧˩˨
him	him˧˧
hinh	hiŋ˧˧
hình	hiŋ˧˨
hình	hiŋ˧˨
hỉnh	hiŋ˧˩˨
híp	hip˦˥
hít	hit˦˥
hiu	hiw˧˧
hoạch	hwɛk˨ˀ˩
hoác	hwak˦˥
hoắc	hwăk˦˥
hoặc	hwăk˨ˀ˩
hoa	hwa˧˧
hoa	hwa˧˧
hoá	hwa˨˦
hoà	hwa˧˨
hoả	hwa˧˩˨
hóa	hwa˨˦
hòa	hwa˧˨
hỏa	hwa˧˩˨
hoạ	hwa˨ˀ˩ʔ
họa	hwa˨ˀ˩ʔ
hoài	hwaj˧˨
hoải	hwaj˧˩˨
hoại	hwaj˨ˀ˩ʔ
hoăm	hwăm˧˧
hoắm	hwăm˨˦
hoang	hwaŋ˧˧
hoàng	hwaŋ˧˨
hoăng	hwăŋ˧˧
hoảng	hwaŋ˧˩˨
hoành	hwɛŋ˧˨
hoạnh	hwɛŋ˨ˀ˩ʔ
hoan	hwan˧˧
hoán	hwan˨˦
hoàn	hwan˧˨
hoãn	hwan˧ˀ˥
hoạn	hwan˨ˀ˩ʔ
hoặn	hwăn˨ˀ˩ʔ
hoạt	hwat˨ˀ˩
hoay	hwăj˧˧
hốc	hokp˦˥
hộc	hokp˨ˀ˩
hóc	hɔkp˦˥
học	hɔkp˨ˀ˩
hoe	hwe˧˧
hoè	hwe˧˨
hoen	hwen˧˧
hơ	hɤ˧˧
hớ	hɤ˨˦
hờ	hɤ˧˨
hở	hɤ˧˩˨
hô	ho˧˧
hố	ho˨˦
hồ	ho˧˨
hồ	ho˧˨
hổ	ho˧˩˨
hỗ	ho˧ˀ˥
hộ	ho˨ˀ˩ʔ
ho	hɔ˧˧
hó	hɔ˨˦
hò	hɔ˧˨
họ	hɔ˨ˀ˩ʔ
họ	hɔ˨ˀ˩ʔ
hơi	hɤj˧˧
hời	hɤj˧˨
hởi	hɤj˧˩˨
hỡi	hɤj˧ˀ˥
hôi	hoj˧˧
hối	hoj˨˦
hồi	hoj˧˨
hổi	hoj˧˩˨
hội	hoj˨ˀ˩ʔ
hoi	hɔj˧˧
hói	hɔj˨˦
hỏi	hɔj˧˩˨
hợm	hɤm˨ˀ˩ʔ
hôm	hom˧˧
hôm	hom˧˧
hổm	hom˧˩˨
hom	hɔm˧˧
hóm	hɔm˨˦
hòm	hɔm˧˨
hỏm	hɔm˧˩˨
hông	hoŋm˧˧
hống	hoŋm˨˦
hồng	hoŋm˧˨
hổng	hoŋm˧˩˨
hỗng	hoŋm˧ˀ˥
hong	hɔŋm˧˧
hóng	hɔŋm˨˦
hòng	hɔŋm˧˨
hỏng	hɔŋm˧˩˨
hỏng	hɔŋm˧˩˨
họng	hɔŋm˨ˀ˩ʔ
hơn	hɤn˧˧
hớn	hɤn˨˦
hờn	hɤn˧˨
hôn	hon˧˧
hồn	hon˧˨
hổn	hon˧˩˨
hỗn	hon˧ˀ˥
hộn	hon˨ˀ˩ʔ
hon	hɔn˧˧
hòn	hɔn˧˨
hỏn	hɔn˧˩˨
hớp	hɤp˦˥
hợp	hɤp˨ˀ˩
hộp	hop˨ˀ˩
hóp	hɔp˦˥
họp	hɔp˨ˀ˩
hớt	hɤt˦˥
hốt	hot˦˥
hột	hot˨ˀ˩
hót	hɔt˦˥
hứa	hɯə˨˦
huân	hwɤ̆n˧˧
huấn	hwɤ̆n˨˦
húc	hukp˦˥
hục	hukp˨ˀ˩
hực	hɯk˨ˀ˩
huếch	hwek˦˥
huê	hwe˧˧
huề	hwe˧˨
huệ	hwe˨ˀ˩ʔ
huênh	hweŋ˧˧
hu	hu˧˧
hú	hu˨˦
hù	hu˧˨
hủ	hu˧˩˨
hũ	hu˧ˀ˥
hư	hɯ˧˧
hừ	hɯ˧˨
hui	huj˧˧
hùi	huj˧˨
hum	hum˧˧
hùm	hum˧˨
hung	huŋm˧˧
húng	huŋm˨˦
hùng	huŋm˧˨
hùng	huŋm˧˨
hủng	huŋm˧˩˨
hưng	hɯŋ˧˧
hứng	hɯŋ˨˦
hừng	hɯŋ˧˨
hửng	hɯŋ˧˩˨
hững	hɯŋ˧ˀ˥
hun	hun˧˧
hùn	hun˧˨
hủn	hun˧˩˨
huơ	huə˧˧
huống	huəŋ˨˦
hương	hɯəŋ˧˧
hương;	hɯəŋ˧˧
hướng	hɯəŋ˨˦
hưởng	hɯəŋ˧˩˨
hươu	hɯəw˧˧
húp	hup˦˥
hụp	hup˨ˀ˩
hút	hut˦˥
hụt	hut˨ˀ˩
hưu	hɯw˧˧
hữu	hɯw˧ˀ˥
hữu	hɯw˧ˀ˥
huých	hwik˦˥
huỵch	hwik˨ˀ˩
huyên	hwiən˧˧
huyền	hwiən˧˨
huyễn	hwiən˧ˀ˥
huyện	hwiən˨ˀ˩ʔ
huyết	hwiət˦˥
huyệt	hwiət˨ˀ˩
húy	huj˨˦
hủy	huj˧˩˨
huy	hwi˧˧
huý	hwi˨˦
huỷ	hwi˧˩˨
huynh	hwiŋ˧˧
huỳnh	hwiŋ˧˨
huýt	hwit˦˥
hy	hi˧˧
ỉa	iə˧˩˨
ích	ik˦˥
ic	ik˧˧
i	i˧˧
í	i˨˦
ì	i˧˨
ỉ	i˧˩˨
ị	i˨ˀ˩ʔ
im	im˧˧
ỉm	im˧˩˨
inh	iŋ˧˧
ình	iŋ˧˨
ĩnh	iŋ˧ˀ˥
in	in˧˧
ìn	in˧˨
i-ôn	i˧˧-on˧˧
ít	it˦˥
ít	it˦˥
ịt	it˨ˀ˩
iu	iw˧˧
ỉu	iw˧˩˨
ka	ka˧˧
ka-li	ka˧˧-li˧˧
kếch	kek˦˥
kệch	kek˨ˀ˩
kê	ke˧˧
kế	ke˨˦
kề	ke˧˨
kể	ke˧˩˨
kệ	ke˨ˀ˩ʔ
ke	kɛ˧˧
ké	kɛ˨˦
kè	kɛ˧˨
kẻ	kɛ˧˩˨
kẽ	kɛ˧ˀ˥
kềm	kem˧˨
kem	kɛm˧˧
kém	kɛm˨˦
kèm	kɛm˧˨
kẻm	kɛm˧˩˨
kẽm	kɛm˧ˀ˥
keng	kɛŋ˧˧
kênh	keŋ˧˧
kềnh	keŋ˧˨
kễnh	keŋ˧ˀ˥
kên	ken˧˧
kền	ken˧˨
ken	kɛn˧˧
kén	kɛn˨˦
kèn	kɛn˧˨
kẹn	kɛn˨ˀ˩ʔ
keo	keo˧˧
keo	keo˧˧
kéo	keo˨˦
kèo	keo˧˨
kẻo	keo˧˩˨
kẽo	keo˧ˀ˥
kẹo	keo˨ˀ˩ʔ
kép	kɛp˦˥
kẹp	kɛp˨ˀ˩
kết	ket˦˥
két	kɛt˦˥
két	kɛt˦˥
kẹt	kɛt˨ˀ˩
kêu	kɛu˧˧
khách	xɛk˦˥
khảch	xɛk˧˩˨
khác	xak˦˥
khắc	xăk˦˥
khạc	xak˨ˀ˩
khặc	xăk˨ˀ˩
khai	xaj˧˧
khái	xaj˨˦
khải	xaj˧˩˨
kham	xam˧˧
khám	xam˨˦
khăm	xăm˧˧
khắm	xăm˨˦
khảm	xam˧˩˨
khâm	xɤ̆m˧˧
khấm	xɤ̆m˨˦
khậm	xɤ̆m˨ˀ˩ʔ
khang	xaŋ˧˧
kháng	xaŋ˨˦
khăng	xăŋ˧˧
khắng	xăŋ˨˦
khằng	xăŋ˧˨
khẳng	xăŋ˧˩˨
khảng	xaŋ˧˩˨
khảng;	xaŋ˧˩˨
khạng	xaŋ˨ˀ˩ʔ
khâng	xɤ̆ŋ˧˧
khầng	xɤ̆ŋ˧˨
khánh-hạ	xɛŋ˨˦-ha˨ˀ˩ʔ
khanh	xɛŋ˧˧
khánh	xɛŋ˨˦
khành	xɛŋ˧˨
khảnh	xɛŋ˧˩˨
khan	xan˧˧
khán	xan˨˦
khàn	xan˧˨
khăn	xăn˧˧
khắn	xăn˨˦
khẳn	xăn˧˩˨
khản	xan˧˩˨
khấn	xɤ̆n˨˦
khẩn	xɤ̆n˧˩˨
khao	xaw˧˧
khảo	xaw˧˩˨
khắp	xăp˦˥
khấp	xɤ̆p˦˥
khập	xɤ̆p˨ˀ˩
khát	xat˦˥
khắt	xăt˦˥
khất	xɤ̆t˦˥
khật	xɤ̆t˨ˀ˩
kháu	xăw˨˦
khâu	xɤ̆w˧˧
khấu	xɤ̆w˨˦
khẩu	xɤ̆w˧˩˨
kha	xa˧˧
khá	xa˨˦
khà	xa˧˨
khả	xa˧˩˨
khạ	xa˨ˀ˩ʔ
khay	xăj˧˧
khem	xɛm˧˧
khèng	xɛŋ˧˨
khềnh	xeŋ˧˨
khểnh	xeŋ˧˩˨
khễnh;	xeŋ˧ˀ˥
khệnh	xeŋ˨ˀ˩ʔ
khen	xɛn˧˧
khèn	xɛn˧˨
kheo	xeo˧˧
kheo;	xeo˧˧
khéo	xeo˨˦
khép	xɛp˦˥
khét	xɛt˦˥
khêu	xɛu˧˧
khều	xɛu˧˨
khê	xe˧˧
khế	xe˨˦
khề	xe˧˨
khệ	xe˨ˀ˩ʔ
khe	xɛ˧˧
khé	xɛ˨˦
khè	xɛ˧˨
khẻ	xɛ˧˩˨
khẽ	xɛ˧ˀ˥
khía	xiə˨˦
khích	xik˦˥
khiêm	xiəm˧˧
khiếm	xiəm˨˦
khiêng	xiəŋ˧˧
khiên	xiən˧˧
khiển	xiən˧˩˨
khiếp	xiəp˦˥
khiêu	xiəw˧˧
khiếu	xiəw˨˦
khinh	xiŋ˧˧
khin	xin˧˧
khìn	xin˧˨
khít	xit˦˥
khịt	xit˨ˀ˩
khi	xi˧˧
khí	xi˨˦
khì	xi˧˨
khỉ	xi˧˩˨
khoác	xwak˦˥
khoai	xwaj˧˧
khoái	xwaj˨˦
khoăm	xwăm˧˧
khoằm	xwăm˧˨
khoang	xwaŋ˧˧
khoáng	xwaŋ˨˦
khoảng	xwaŋ˧˩˨
khoanh	xwɛŋ˧˧
khoành	xwɛŋ˧˨
khoảnh	xwɛŋ˧˩˨
khoan	xwan˧˧
khoán	xwan˨˦
khoản	xwan˧˩˨
khoát	xwat˦˥
khoa	xwa˧˧
khoá	xwa˨˦
khoả	xwa˧˩˨
khóa	xwa˨˦
khỏa	xwa˧˩˨
khốc	xokp˦˥
khóc	xɔkp˦˥
khóc	xɔkp˦˥
khoen	xwen˧˧
khoeo	xwew˧˧
khoèo	xwew˧˨
khoét	xwet˦˥
khoe	xwe˧˧
khoé	xwe˨˦
khoẻ	xwe˧˩˨
khóe	xwe˨˦
khòe	xwe˧˨
khỏe	xwe˧˩˨
khơi	xɤj˧˧
khởi	xɤj˧˩˨
khôi	xoj˧˧
khối	xoj˨˦
khói	xɔj˨˦
khỏi	xɔj˧˩˨
khơ-me	xɤ˧˧-mɛ˧˧
khơ-mú	xɤ˧˧-mu˨˦
khom	xɔm˧˧
khòm	xɔm˧˨
khọm	xɔm˨ˀ˩ʔ
không	xoŋm˧˧
không	xoŋm˧˧
khống	xoŋm˨˦
khổng	xoŋm˧˩˨
khòng	xɔŋm˧˨
khôn	xon˧˧
khốn	xon˨˦
khổn	xon˧˩˨
khớp	xɤp˦˥
khơ	xɤ˧˧
khờ	xɤ˧˨
khô	xo˧˧
khố	xo˨˦
khổ	xo˧˩˨
kho	xɔ˧˧
khó	xɔ˨˦
khó	xɔ˨˦
khò	xɔ˧˨
khuân	xwɤ̆n˧˧
khuẩn	xwɤ̆n˧˩˨
khuất	xwɤ̆t˦˥
khua	xuə˧˧
khuây	xwɤ̆j˧˧
khuấy	xwɤ̆j˨˦
khúc	xukp˦˥
khúc	xukp˦˥
khục	xukp˨ˀ˩
khuếch	xwek˦˥
khuê	xwe˧˧
khum	xum˧˧
khúm	xum˨˦
khung	xuŋm˧˧
khúng	xuŋm˨˦
khùng	xuŋm˧˨
khủng	xuŋm˧˩˨
khụng	xuŋm˨ˀ˩ʔ
khước	xɯək˦˥
khươm	xɯəm˧˧
khuông	xuəŋ˧˧
khuôn	xuən˧˧
khướt	xɯət˦˥
khướu	xɯəw˨˦
khuờ	xuə˧˨
khụt	xut˨ˀ˩
khứu	xɯw˨˦
khu	xu˧˧
khú	xu˨˦
khù	xu˧˨
khủ	xu˧˩˨
khụ	xu˨ˀ˩ʔ
khư	xɯ˧˧
khứ	xɯ˨˦
khừ	xɯ˧˨
khử	xɯ˧˩˨
khự	xɯ˨ˀ˩ʔ
khuya	xwiə˧˧
khuyên	xwiən˧˧
khuyến	xwiən˨˦
khuyển	xwiən˧˩˨
khuyết	xwiət˦˥
khuynh	xwiŋ˧˧
khuỳnh	xwiŋ˧˨
khuy	xwi˧˧
khyển	xiɛn˧˩˨
kia	kiə˧˧
kìa	kiə˧˨
kích	kik˦˥
kịch	kik˨ˀ˩
kiêm	kiəm˧˧
kiếm	kiəm˨˦
kiềm	kiəm˧˨
kiểm	kiəm˧˩˨
kiệm	kiəm˨ˀ˩ʔ
kiêng	kiəŋ˧˧
kiềng	kiəŋ˧˨
kiên	kiən˧˧
kiến	kiən˨˦
kiền	kiən˧˨
kiện	kiən˨ˀ˩ʔ
kiếp	kiəp˦˥
kiết	kiət˦˥
kiệt	kiət˨ˀ˩
kiệt;	kiət˨ˀ˩
kiêu	kiəw˧˧
kiếu	kiəw˨˦
kiều	kiəw˧˨
kiểu	kiəw˧˩˨
kiệu	kiəw˨ˀ˩ʔ
ki	ki˧˧
kí	ki˨˦
kì	ki˧˨
kì	ki˧˨
kỉ	ki˧˩˨
kỉ	ki˧˩˨
kĩ	ki˧ˀ˥
kị	ki˨ˀ˩ʔ
ki-lô	ki˧˧-lo˧˧
ki-lô-oát	ki˧˧-lo˧˧-wat˦˥
kim	kim˧˧
kìm	kim˧˨
kinh	kiŋ˧˧
kính	kiŋ˨˦
kính	kiŋ˨˦
kình	kiŋ˧˨
kin	kin˧˧
kín	kin˨˦
kín	kin˨˦
kìn	kin˧˨
kíp	kip˦˥
kịp	kip˨ˀ˩
ki-tô	ki˧˧-to˧˧
kíu	kiw˨˦
kĩu	kiw˧ˀ˥
ky	ki˧˧
ký	ki˨˦
kỳ	ki˧˨
kỷ	ki˧˩˨
kỹ	ki˧ˀ˥
kỵ	ki˨ˀ˩ʔ
lách	lɛk˦˥
lạch	lɛk˨ˀ˩
lác	lak˦˥
lác;	lak˦˥
lắc	lăk˦˥
lạc	lak˨ˀ˩
lặc	lăk˨ˀ˩
lấc	lɤ̆k˦˥
lai-Đa	laj˧˧-da˧˧
lai	laj˧˧
lai	laj˧˧
lái	laj˨˦
lái	laj˨˦
lài	laj˧˨
lải	laj˧˩˨
lãi	laj˧ˀ˥
lại	laj˨ˀ˩ʔ
lại	laj˨ˀ˩ʔ
lai-ly	laj˧˧-li˧˧
la	la˧˧
lá	la˨˦
lá	la˨˦
là	la˧˨
lả	la˧˩˨
lã	la˧ˀ˥
lạ	la˨ˀ˩ʔ
lạ	la˨ˀ˩ʔ
la-mã	la˧˧-ma˧ˀ˥
lam	lam˧˧
làm	lam˧˨
làm	lam˧˨
lăm	lăm˧˧
(lắm)	lăm˨˦
lắm	lăm˨˦
lắm	lăm˨˦
lằm	lăm˧˨
lảm	lam˧˩˨
lãm	lam˧ˀ˥
lạm	lam˨ˀ˩ʔ
lâm	lɤ̆m˧˧
lấm	lɤ̆m˨˦
lầm	lɤ̆m˧˨
lẩm	lɤ̆m˧˩˨
lẫm	lɤ̆m˧ˀ˥
lang	laŋ˧˧
láng	laŋ˨˦
làng	laŋ˧˨
lăng	lăŋ˧˧
lắng	lăŋ˨˦
lằng	lăŋ˧˨
lẳng	lăŋ˧˩˨
lảng	laŋ˧˩˨
lẵng	lăŋ˧ˀ˥
lãng	laŋ˧ˀ˥
lạng	laŋ˨ˀ˩ʔ
lạng	laŋ˨ˀ˩ʔ
lặng	lăŋ˨ˀ˩ʔ
lặng	lăŋ˨ˀ˩ʔ
lâng	lɤ̆ŋ˧˧
lanh	lɛŋ˧˧
lánh	lɛŋ˨˦
lành	lɛŋ˧˨
lành	lɛŋ˧˨
lảnh	lɛŋ˧˩˨
lãnh	lɛŋ˧ˀ˥
lạnh	lɛŋ˨ˀ˩ʔ
lan	lan˧˧
lan;	lan˧˧
lán	lan˨˦
làn	lan˧˨
lăn	lăn˧˧
lằn	lăn˧˨
lẳn	lăn˧˩˨
lãn	lan˧ˀ˥
lặn	lăn˨ˀ˩ʔ
lân	lɤ̆n˧˧
lấn	lɤ̆n˨˦
lần	lɤ̆n˧˨
lẩn	lɤ̆n˧˩˨
lẫn	lɤ̆n˧ˀ˥
lận	lɤ̆n˨ˀ˩ʔ
lao	law˧˧
lao	law˧˧
láo	law˨˦
lào	law˧˨
lảo	law˧˩˨
lão	law˧ˀ˥
lạo	law˨ˀ˩ʔ
láp	lap˦˥
lắp	lăp˦˥
lạp	lap˨ˀ˩
lặp	lăp˨ˀ˩
lâp	lɤ̆p˧˧
lấp	lɤ̆p˦˥
lập	lɤ̆p˨ˀ˩
la-tê-rít	la˧˧-te˧˧-zit˦˥
la-tinh	la˧˧-tiŋ˧˧
lát	lat˦˥
lắt	lăt˦˥
lạt	lat˨ˀ˩
lạt	lat˨ˀ˩
lặt	lăt˨ˀ˩
lất	lɤ̆t˦˥
lật	lɤ̆t˨ˀ˩
lau	lăw˧˧
láu	lăw˨˦
làu	lăw˧˨
lảu	lăw˧˩˨
lạu	lăw˨ˀ˩ʔ
lâu	lɤ̆w˧˧
lấu	lɤ̆w˨˦
lầu	lɤ̆w˧˨
lẩu	lɤ̆w˧˩˨
lậu	lɤ̆w˨ˀ˩ʔ
lay	lăj˧˧
láy	lăj˨˦
lày	lăj˧˨
lảy	lăj˧˩˨
lạy	lăj˨ˀ˩ʔ
lây	lɤ̆j˧˧
lấy	lɤ̆j˨˦
lầy	lɤ̆j˧˨
lẩy	lɤ̆j˧˩˨
lẫy	lɤ̆j˧ˀ˥
lậy	lɤ̆j˨ˀ˩ʔ
lếch	lek˦˥
lệch	lek˨ˀ˩
lê	le˧˧
lê	le˧˧
lề	le˧˨
lề	le˧˨
lể	le˧˩˨
lễ	le˧ˀ˥
lễ	le˧ˀ˥
lệ	le˨ˀ˩ʔ
le	lɛ˧˧
lé	lɛ˨˦
lè	lɛ˧˨
lẻ	lɛ˧˩˨
lẽ	lɛ˧ˀ˥
lẽ	lɛ˧ˀ˥
lẹ	lɛ˨ˀ˩ʔ
lem	lɛm˧˧
lém	lɛm˨˦
lèm	lɛm˧˨
lẹm	lɛm˨ˀ˩ʔ
leng	lɛŋ˧˧
léng	lɛŋ˨˦
lẻng	lɛŋ˧˩˨
lênh	leŋ˧˧
lềnh	leŋ˧˨
lệnh	leŋ˨ˀ˩ʔ
lệnh	leŋ˨ˀ˩ʔ
lên	len˧˧
len	lɛn˧˧
lén	lɛn˨˦
lèn	lɛn˧˨
lẻn	lɛn˧˩˨
leo	leo˧˧
leo	leo˧˧
léo	leo˨˦
lèo	leo˧˨
lẻo	leo˧˩˨
lẽo	leo˧ˀ˥
lẹo	leo˨ˀ˩ʔ
lép	lɛp˦˥
lẹp	lɛp˨ˀ˩
lết	let˦˥
lệt	let˨ˀ˩
lét	lɛt˦˥
lẹt	lɛt˨ˀ˩
lêu	lɛu˧˧
lếu	lɛu˨˦
lều	lɛu˧˨
lểu	lɛu˧˩˨
lễu	lɛu˧ˀ˥
lia	liə˧˧
lìa	liə˧˨
lích	lik˦˥
lịch	lik˨ˀ˩
liếc	liək˦˥
liêm	liəm˧˧
liếm	liəm˨˦
liềm	liəm˧˨
liệm	liəm˨ˀ˩ʔ
liêng	liəŋ˧˧
liểng	liəŋ˧˩˨
liên	liən˧˧
liến	liən˨˦
liền	liən˧˨
liếp	liəp˦˥
liệt	liət˨ˀ˩
liêu	liəw˧˧
liếu	liəw˨˦
liều	liəw˧˨
liễu	liəw˧ˀ˥
liệu	liəw˨ˀ˩ʔ
li	li˧˧
lí	li˨˦
lì	li˧˨
lị	li˨ˀ˩ʔ
lị	li˨ˀ˩ʔ
lim	lim˧˧
lìm	lim˧˨
linh	liŋ˧˧
lính	liŋ˨˦
lình	liŋ˧˨
lỉnh	liŋ˧˩˨
lĩnh	liŋ˧ˀ˥
líp	lip˦˥
lít	lit˦˥
liu	liw˧˧
líu	liw˨˦
lịu	liw˨ˀ˩ʔ
loạch	lwɛk˨ˀ˩
loạc	lwak˨ˀ˩
loai	lwaj˧˧
loài	lwaj˧˨
loại	lwaj˨ˀ˩ʔ
loại;	lwaj˨ˀ˩ʔ
loa	lwa˧˧
loá	lwa˨˦
loà	lwa˧˨
loả	lwa˧˩˨
lòa	lwa˧˨
lỏa	lwa˧˩˨
loã	lwa˧ˀ˥
lõa	lwa˧ˀ˥
loang	lwaŋ˧˧
loáng	lwaŋ˨˦
loàng	lwaŋ˧˨
loăng	lwăŋ˧˧
loằng	lwăŋ˧˨
loảng	lwaŋ˧˩˨
loãng	lwaŋ˧ˀ˥
loạng	lwaŋ˨ˀ˩ʔ
loanh	lwɛŋ˧˧
loan	lwan˧˧
loăn	lwăn˧˧
loắn	lwăn˨˦
loằn	lwăn˧˨
loạn	lwan˨ˀ˩ʔ
loạn	lwan˨ˀ˩ʔ
loáo	lwaw˨˦
loát	lwat˦˥
loắt	lwăt˦˥
loạt	lwat˨ˀ˩
loay	lwăj˧˧
loáy	lwăj˨˦
lốc	lokp˦˥
lộc	lokp˨ˀ˩
lóc	lɔkp˦˥
lọc	lɔkp˨ˀ˩
loe	lwe˧˧
loé	lwe˨˦
loè	lwe˧˨
lòe	lwe˧˨
loẻng	lweŋ˧˩˨
loen	lwen˧˧
loẻo	lwew˧˩˨
loét	lwet˦˥
loẹt	lwet˨ˀ˩
lô-gích	lo˧˧-ɣik˦˥
lơi	lɤj˧˧
lời	lɤj˧˨
lợi	lɤj˨ˀ˩ʔ
lôi	loj˧˧
lối	loj˨˦
lối	loj˨˦
lồi	loj˧˨
lỗi	loj˧ˀ˥
lội	loj˨ˀ˩ʔ
loi	lɔj˧˧
lòi	lɔj˧˨
lõi	lɔj˧ˀ˥
lọi	lɔj˨ˀ˩ʔ
lơ	lɤ˧˧
lớ	lɤ˨˦
lờ	lɤ˧˨
lở	lɤ˧˩˨
lỡ	lɤ˧ˀ˥
lợ	lɤ˨ˀ˩ʔ
lô	lo˧˧
lố	lo˨˦
lồ	lo˧˨
lổ	lo˧˩˨
lỗ	lo˧ˀ˥
lỗ	lo˧ˀ˥
lộ	lo˨ˀ˩ʔ
lo	lɔ˧˧
lo	lɔ˧˧
ló	lɔ˨˦
lò	lɔ˧˨
lõ	lɔ˧ˀ˥
lọ	lɔ˨ˀ˩ʔ
lờm	lɤm˧˨
lởm	lɤm˧˩˨
lợm	lɤm˨ˀ˩ʔ
lôm	lom˧˧
lốm	lom˨˦
lồm	lom˧˨
lổm	lom˧˩˨
lỗm	lom˧ˀ˥
lộm	lom˨ˀ˩ʔ
lom	lɔm˧˧
lóm	lɔm˨˦
lòm	lɔm˧˨
lỏm	lɔm˧˩˨
lõm	lɔm˧ˀ˥
lọm	lɔm˨ˀ˩ʔ
lông	loŋm˧˧
lồng	loŋm˧˨
lồng	loŋm˧˨
lổng	loŋm˧˩˨
lộng	loŋm˨ˀ˩ʔ
long	lɔŋm˧˧
lóng	lɔŋm˨˦
lòng	lɔŋm˧˨
lòng	lɔŋm˧˨
lỏng	lɔŋm˧˩˨
lõng	lɔŋm˧ˀ˥
lọng	lɔŋm˨ˀ˩ʔ
lơn	lɤn˧˧
lớn	lɤn˨˦
lờn	lɤn˧˨
lởn	lɤn˧˩˨
lợn	lɤn˨ˀ˩ʔ
lốn	lon˨˦
lồn	lon˧˨
lổn	lon˧˩˨
lộn	lon˨ˀ˩ʔ
lon	lɔn˧˧
lòn	lɔn˧˨
lỏn	lɔn˧˩˨
lọn	lɔn˨ˀ˩ʔ
loong	lɔŋm˧˧
lớp	lɤp˦˥
lợp	lɤp˨ˀ˩
lốp	lop˦˥
lộp	lop˨ˀ˩
lóp	lɔp˦˥
lọp	lɔp˨ˀ˩
lớt	lɤt˦˥
lợt	lɤt˨ˀ˩
lốt	lot˦˥
lột	lot˨ˀ˩
lột	lot˨ˀ˩
lót	lɔt˦˥
lọt	lɔt˨ˀ˩
lua	luə˧˧
lúa	luə˨˦
lủa	luə˧˩˨
lụa	luə˨ˀ˩ʔ
lụa	luə˨ˀ˩ʔ
lưa	lɯə˧˧
lứa	lɯə˨˦
lừa	lɯə˧˨
lửa	lɯə˧˩˨
lửa	lɯə˧˩˨
lựa	lɯə˨ˀ˩ʔ
luân	lwɤ̆n˧˧
luấn	lwɤ̆n˨˦
luẩn	lwɤ̆n˧˩˨
luận	lwɤ̆n˨ˀ˩ʔ
luật	lwɤ̆t˨ˀ˩
lúc	lukp˦˥
lục	lukp˨ˀ˩
lực	lɯk˨ˀ˩
lui	luj˧˧
lúi	luj˨˦
lùi	luj˧˨
lủi	luj˧˩˨
lụi	luj˨ˀ˩ʔ
lu	lu˧˧
lú	lu˨˦
lú	lu˨˦
lù	lu˧˨
lủ	lu˧˩˨
lũ	lu˧ˀ˥
lụ	lu˨ˀ˩ʔ
lư	lɯ˧˧
lừ	lɯ˧˨
lử	lɯ˧˩˨
lữ	lɯ˧ˀ˥
lự;	lɯ˨ˀ˩ʔ
lum	lum˧˧
lúm	lum˨˦
lùm	lum˧˨
lủm	lum˧˩˨
lũm	lum˧ˀ˥
lụm	lum˨ˀ˩ʔ
lung	luŋm˧˧
lúng	luŋm˨˦
lùng	luŋm˧˨
lủng	luŋm˧˩˨
lũng	luŋm˧ˀ˥
lụng	luŋm˨ˀ˩ʔ
lưng	lɯŋ˧˧
lưng;	lɯŋ˧˧
lừng	lɯŋ˧˨
lửng	lɯŋ˧˩˨
lững	lɯŋ˧ˀ˥
lựng	lɯŋ˨ˀ˩ʔ
lún	lun˨˦
lùn	lun˧˨
lủn	lun˧˩˨
lũn	lun˧ˀ˥
lụn	lun˨ˀ˩ʔ
lược	lɯək˨ˀ˩
lưới	lɯəj˨˦
lưới	lɯəj˨˦
lười	lɯəj˧˨
lười	lɯəj˧˨
lưởi	lɯəj˧˩˨
lưỡi	lɯəj˧ˀ˥
luôm	luəm˧˧
luộm	luəm˨ˀ˩ʔ
lươm	lɯəm˧˧
lườm	lɯəm˧˨
lượm	lɯəm˨ˀ˩ʔ
luông	luəŋ˧˧
luống	luəŋ˨˦
luồng	luəŋ˧˨
lương	lɯəŋ˧˧
lướng	lɯəŋ˨˦
lường	lɯəŋ˧˨
lưỡng	lɯəŋ˧ˀ˥
lượng	lɯəŋ˨ˀ˩ʔ
luôn	luən˧˧
luồn	luən˧˨
lươn	lɯən˧˧
lượn	lɯən˨ˀ˩ʔ
lướp	lɯəp˦˥
luốt	luət˦˥
lướt	lɯət˦˥
lượt	lɯət˨ˀ˩
lướu	lɯəw˨˦
lúp	lup˦˥
lụp	lup˨ˀ˩
lút	lut˦˥
lụt	lut˨ˀ˩
lưu	lɯw˧˧
lựu	lɯw˨ˀ˩ʔ
lựu	lɯw˨ˀ˩ʔ
luyên	lwiən˧˧
luyến	lwiən˨˦
luyện	lwiən˨ˀ˩ʔ
lũy	luj˧ˀ˥
lũy	luj˧ˀ˥
lụy	luj˨ˀ˩ʔ
luy	lwi˧˧
luỹ	lwi˧ˀ˥
luỵ	lwi˨ˀ˩ʔ
luýnh	lwiŋ˨˦
ly	li˧˧
lý	li˨˦
lỵ	li˨ˀ˩ʔ
ma-cà-bông	ma˧˧-ka˧˨-boŋm˧˧
mách	mɛk˦˥
mạch	mɛk˨ˀ˩
mạch	mɛk˨ˀ˩
mác	mak˦˥
mắc	măk˦˥
mạc	mak˨ˀ˩
mặc	măk˨ˀ˩
mạc-sê	mak˨ˀ˩-se˧˧
mác-xít	mak˦˥-sit˦˥
mai	maj˧˧
mai	maj˧˧
mái	maj˨˦
mài	maj˧˨
mải	maj˧˩˨
mãi	maj˧ˀ˥
mãi;	maj˧ˀ˥
mại	maj˨ˀ˩ʔ
mại	maj˨ˀ˩ʔ
ma	ma˧˧
ma	ma˧˧
má	ma˨˦
mà	ma˧˨
mả	ma˧˩˨
mả	ma˧˩˨
mả;	ma˧˩˨
mã	ma˧ˀ˥
mạ	ma˨ˀ˩ʔ
mạ	ma˨ˀ˩ʔ
măm	măm˧˧
mắm	măm˨˦
mẵm	măm˧ˀ˥
mâm	mɤ̆m˧˧
mâm	mɤ̆m˧˧
mầm	mɤ̆m˧˨
mẩm	mɤ̆m˧˩˨
mẫm	mɤ̆m˧ˀ˥
mang	maŋ˧˧
mang	maŋ˧˧
máng	maŋ˨˦
màng	maŋ˧˨
măng	măŋ˧˧
mắng	măŋ˨˦
mảng	maŋ˧˩˨
mãng	maŋ˧ˀ˥
mạng	maŋ˨ˀ˩ʔ
mâng	mɤ̆ŋ˧˧
manh	mɛŋ˧˧
mánh	mɛŋ˨˦
mành	mɛŋ˧˨
mảnh	mɛŋ˧˩˨
mãnh	mɛŋ˧ˀ˥
mạnh	mɛŋ˨ˀ˩ʔ
man	man˧˧
mán	man˨˦
màn	man˧˨
măn	măn˧˧
mắn	măn˨˦
mằn	măn˧˨
mãn	man˧ˀ˥
mạn	man˨ˀ˩ʔ
mặn	măn˨ˀ˩ʔ
mân	mɤ̆n˧˧
mấn	mɤ̆n˨˦
mần	mɤ̆n˧˨
mẩn	mɤ̆n˧˩˨
mẫn	mɤ̆n˧ˀ˥
mận	mɤ̆n˨ˀ˩ʔ
mao	maw˧˧
mào	maw˧˨
mạo	maw˨ˀ˩ʔ
mấp	mɤ̆p˦˥
mập	mɤ̆p˨ˀ˩
mát	mat˦˥
mắt	măt˦˥
mắt	măt˦˥
mạt	mat˨ˀ˩
mặt	măt˨ˀ˩
mặt	măt˨ˀ˩
mất	mɤ̆t˦˥
mật	mɤ̆t˨ˀ˩
mau	măw˧˧
máu	măw˨˦
màu	măw˧˨
mâu	mɤ̆w˧˧
mấu	mɤ̆w˨˦
mầu	mɤ̆w˧˨
mẫu	mɤ̆w˧ˀ˥
mậu	mɤ̆w˨ˀ˩ʔ
may	măj˧˧
máy	măj˨˦
máy;	măj˨˦
mày	măj˧˨
mảy	măj˧˩˨
mạy	măj˨ˀ˩ʔ
mây	mɤ̆j˧˧
mấy	mɤ̆j˨˦
mầy	mɤ̆j˧˨
mẩy	mɤ̆j˧˩˨
mếch	mek˦˥
mê	me˧˧
mề	me˧˨
mễ	me˧ˀ˥
me	mɛ˧˧
mè	mɛ˧˨
mẻ	mɛ˧˩˨
mẽ	mɛ˧ˀ˥
mẹ	mɛ˨ˀ˩ʔ
mềm	mem˧˨
mênh	meŋ˧˧
mệnh	meŋ˨ˀ˩ʔ
mên	men˧˧
mến	men˨˦
mền	men˧˨
men	mɛn˧˧
meo	meo˧˧
méo	meo˨˦
mèo	meo˧˨
mèo	meo˧˨
mẹo	meo˨ˀ˩ʔ
mép	mɛp˦˥
mệt	met˨ˀ˩
mét	mɛt˦˥
mếu	mɛu˨˦
mía	miə˨˦
mỉa	miə˧˩˨
mích	mik˦˥
miếng	miəŋ˨˦
miệng	miəŋ˨ˀ˩ʔ
miên	miən˧˧
miền	miən˧˨
miễn	miən˧ˀ˥
miệt	miət˨ˀ˩
miêu	miəw˧˧
miếu	miəw˨˦
miều	miəw˧˨
mi	mi˧˧
mì	mi˧˨
mỉ	mi˧˩˨
mĩ	mi˧ˀ˥
mị	mi˨ˀ˩ʔ
mim	mim˧˧
mỉm	mim˧˩˨
minh	miŋ˧˧
mình	miŋ˧˨
mình	miŋ˧˨
mìn	min˧˨
mịn	min˨ˀ˩ʔ
mít	mit˦˥
mít	mit˦˥
mịt	mit˨ˀ˩
mỉu	miw˧˩˨
moay	mwăj˧˧
mô-bin	mo˧˧-bin˧˧
mốc	mokp˦˥
mộc	mokp˨ˀ˩
móc	mɔkp˦˥
mọc	mɔkp˨ˀ˩
mọc	mɔkp˨ˀ˩
mới	mɤj˨˦
mới	mɤj˨˦
mời	mɤj˧˨
mời	mɤj˧˨
môi	moj˧˧
mối	moj˨˦
mồi	moj˧˨
mỗi	moj˧ˀ˥
moi	mɔj˧˧
mòi	mɔj˧˨
mỏi	mɔj˧˩˨
mọi	mɔj˨ˀ˩ʔ
mô-men	mo˧˧-mɛn˧˧
mơ	mɤ˧˧
mớ	mɤ˨˦
mờ	mɤ˧˨
mở	mɤ˧˩˨
mỡ	mɤ˧ˀ˥
mớm	mɤm˨˦
mồm	mom˧˨
móm	mɔm˨˦
mòm	mɔm˧˨
mỏm	mɔm˧˩˨
mõm	mɔm˧ˀ˥
mô	mo˧˧
mố	mo˨˦
mồ	mo˧˨
mổ	mo˧˩˨
mộ	mo˨ˀ˩ʔ
mo	mɔ˧˧
mó	mɔ˨˦
mò	mɔ˧˨
mỏ	mɔ˧˩˨
mõ	mɔ˧ˀ˥
mông	moŋm˧˧
mống	moŋm˨˦
mồng	moŋm˧˨
mộng	moŋm˨ˀ˩ʔ
mong	mɔŋm˧˧
móng	mɔŋm˨˦
mòng	mɔŋm˧˨
mỏng	mɔŋm˧˩˨
mọng	mɔŋm˨ˀ˩ʔ
mơn	mɤn˧˧
mớn	mɤn˨˦
mởn	mɤn˧˩˨
môn	mon˧˧
mồn	mon˧˨
mon	mɔn˧˧
món	mɔn˨˦
mòn	mɔn˧˨
moóc	mɔkp˦˥
móp	mɔp˦˥
mốt	mot˦˥
mốt	mot˦˥
(một)	mot˨ˀ˩
một	mot˨ˀ˩
một	mot˨ˀ˩
mót	mɔt˦˥
mọt	mɔt˨ˀ˩
mô-tô	mo˧˧-to˧˧
mua	muə˧˧
múa	muə˨˦
mùa	muə˧˨
mưa	mɯə˧˧
mưa	mɯə˧˧
mưa;	mɯə˧˧
mửa	mɯə˧˩˨
mục	mukp˨ˀ˩
mức	mɯk˦˥
mực	mɯk˨ˀ˩
mui	muj˧˧
múi	muj˨˦
mùi	muj˧˨
mủi	muj˧˩˨
mũi	muj˧ˀ˥
mum	mum˧˧
múm	mum˨˦
mủm	mum˧˩˨
mũm	mum˧ˀ˥
mú	mu˨˦
mù	mu˧˨
mủ	mu˧˩˨
mũ	mu˧ˀ˥
mụ	mu˨ˀ˩ʔ
mung	muŋm˧˧
mùng	muŋm˧˨
mủng	muŋm˧˩˨
mưng	mɯŋ˧˧
mừng	mɯŋ˧˨
mun	mun˧˧
mùn	mun˧˨
mụn	mun˨ˀ˩ʔ
mứn	mɯn˨˦
muối	muəj˨˦
muối	muəj˨˦
muỗi	muəj˧ˀ˥
muội	muəj˨ˀ˩ʔ
mươi	mɯəj˧˧
mười	mɯəj˧˨
mười	mɯəj˧˨
muồm	muəm˧˨
muông	muəŋ˧˧
muống	muəŋ˨˦
mương	mɯəŋ˧˧
mường	mɯəŋ˧˨
muôn	muən˧˧
muốn	muən˨˦
muộn	muən˨ˀ˩ʔ
mươn	mɯən˧˧
mướn	mɯən˨˦
mườn	mɯən˧˨
mượn	mɯən˨ˀ˩ʔ
mướp	mɯəp˦˥
mướt	mɯət˦˥
mượt	mɯət˨ˀ˩
múp	mup˦˥
mút	mut˦˥
mụt	mut˨ˀ˩
mứt	mɯt˦˥
mưu	mɯw˧˧
mỹ	mi˧ˀ˥
nách	nɛk˦˥
nắc	năk˦˥
nạc	nak˨ˀ˩
nặc	năk˨ˀ˩
nấc	nɤ̆k˦˥
nai	naj˧˧
nái	naj˨˦
nái	naj˨˦
nài	naj˧˨
nại	naj˨ˀ˩ʔ
nam-Đà	nam˧˧-da˧˨
nam-hạ	nam˧˧-ha˨ˀ˩ʔ
nam	nam˧˧
năm	năm˧˧
năm	năm˧˧
nắm	năm˨˦
nằm	năm˧˨
nằm	năm˧˨
nạm	nam˨ˀ˩ʔ
nấm	nɤ̆m˨˦
nầm	nɤ̆m˧˨
nam-sang	nam˧˧-saŋ˧˧
na	na˧˧
ná	na˨˦
ná	na˨˦
nà	na˧˨
nạ	na˨ˀ˩ʔ
nạ	na˨ˀ˩ʔ
nang	naŋ˧˧
nàng	naŋ˧˨
năng	năŋ˧˧
nắng	năŋ˨˦
nắng	năŋ˨˦
nằng	năŋ˧˨
nạng	naŋ˨ˀ˩ʔ
nặng	năŋ˨ˀ˩ʔ
nâng	nɤ̆ŋ˧˧
nẫng	nɤ̆ŋ˧ˀ˥
nanh	nɛŋ˧˧
nan	nan˧˧
nan	nan˧˧
năn	năn˧˧
nắn	năn˨˦
nằn	năn˧˨
nản	nan˧˩˨
nạn	nan˨ˀ˩ʔ
nặn	năn˨ˀ˩ʔ
nân	nɤ̆n˧˧
nấn	nɤ̆n˨˦
nần	nɤ̆n˧˨
nao	naw˧˧
náo	naw˨˦
nào	naw˧˨
nào	naw˧˨
nào	naw˧˨
nảo	naw˧˩˨
não	naw˧ˀ˥
nạo	naw˨ˀ˩ʔ
náp	nap˦˥
nắp	năp˦˥
nạp	nap˨ˀ˩
nấp	nɤ̆p˦˥
nát	nat˦˥
nát	nat˦˥
nạt	nat˨ˀ˩
náu	năw˨˦
nâu	nɤ̆w˧˧
nấu	nɤ̆w˨˦
nẫu	nɤ̆w˧ˀ˥
nay	năj˧˧
nay	năj˧˧
này	năj˧˨
nảy	năj˧˩˨
nãy	năj˧ˀ˥
nây	nɤ̆j˧˧
nấy	nɤ̆j˨˦
nẩy	nɤ̆j˧˩˨
nêm	nem˧˧
nếm	nem˨˦
nệm	nem˨ˀ˩ʔ
nem	nɛm˧˧
ném	nɛm˨˦
nê	ne˧˧
nề	ne˧˨
nể	ne˧˩˨
nệ	ne˨ˀ˩ʔ
ne	nɛ˧˧
né	nɛ˨˦
nẻ	nɛ˧˩˨
nên	nen˧˧
nến	nen˨˦
nền	nen˧˨
nen	nɛn˧˧
nén	nɛn˨˦
neo	neo˧˧
néo	neo˨˦
nẻo	neo˧˩˨
nếp	nep˦˥
nẹp	nɛp˨ˀ˩
nết	net˦˥
nết	net˦˥
nét	nɛt˦˥
nẹt	nɛt˨ˀ˩
nêu	nɛu˧˧
nếu	nɛu˨˦
ngạch	ŋɛk˨ˀ˩
ngác	ŋak˦˥
ngắc	ŋăk˦˥
ngạc	ŋak˨ˀ˩
ngấc	ŋɤ̆k˦˥
ngai	ŋaj˧˧
ngái	ŋaj˨˦
ngài	ŋaj˧˨
ngải	ŋaj˧˩˨
ngãi	ŋaj˧ˀ˥
ngãi	ŋaj˧ˀ˥
ngại	ŋaj˨ˀ˩ʔ
ngam	ŋam˧˧
ngàm	ŋam˧˨
ngăm	ŋăm˧˧
ngắm	ŋăm˨˦
ngâm	ŋɤ̆m˧˧
ngấm	ŋɤ̆m˨˦
ngầm	ŋɤ̆m˧˨
ngẩm	ŋɤ̆m˧˩˨
ngẫm	ŋɤ̆m˧ˀ˥
ngậm	ŋɤ̆m˨ˀ˩ʔ
ngang	ŋaŋ˧˧
ngáng	ŋaŋ˨˦
ngẳng	ŋăŋ˧˩˨
ngãng	ŋaŋ˧ˀ˥
ngẩng	ŋɤ̆ŋ˧˩˨
ngành	ŋɛŋ˧˨
ngảnh	ŋɛŋ˧˩˨
ngan	ŋan˧˧
ngán	ŋan˨˦
ngàn	ŋan˧˨
ngàn;	ŋan˧˨
ngăn	ŋăn˧˧
ngắn	ŋăn˨˦
ngằn	ŋăn˧˨
ngạn	ŋan˨ˀ˩ʔ
ngân	ŋɤ̆n˧˧
ngấn	ŋɤ̆n˨˦
ngần	ŋɤ̆n˧˨
ngẩn	ŋɤ̆n˧˩˨
ngận	ŋɤ̆n˨ˀ˩ʔ
nga	ŋa˧˧
ngà	ŋa˧˨
ngà	ŋa˧˨
ngả	ŋa˧˩˨
ngã	ŋa˧ˀ˥
ngao	ŋaw˧˧
ngáo	ŋaw˨˦
ngào	ŋaw˧˨
ngạo	ŋaw˨ˀ˩ʔ
ngáp	ŋap˦˥
ngấp	ŋɤ̆p˦˥
ngập	ŋɤ̆p˨ˀ˩
ngát	ŋat˦˥
ngắt	ŋăt˦˥
ngạt	ŋat˨ˀ˩
ngặt	ŋăt˨ˀ˩
ngất	ŋɤ̆t˦˥
ngật	ŋɤ̆t˨ˀ˩
ngau	ŋăw˧˧
ngàu	ŋăw˧˨
ngâu	ŋɤ̆w˧˧
ngấu	ŋɤ̆w˨˦
ngầu	ŋɤ̆w˧˨
ngẫu	ŋɤ̆w˧ˀ˥
ngậu	ŋɤ̆w˨ˀ˩ʔ
ngay	ŋăj˧˧
ngáy	ŋăj˨˦
(ngày)	ŋăj˧˨
ngày	ŋăj˧˨
ngày	ŋăj˧˨
ngây	ŋɤ̆j˧˧
ngấy	ŋɤ̆j˨˦
ngầy	ŋɤ̆j˧˨
nghếch	ŋek˦˥
nghệch	ŋek˨ˀ˩
nghênh	ŋeŋ˧˧
nghềnh	ŋeŋ˧˨
nghễnh	ŋeŋ˧ˀ˥
nghền	ŋen˧˨
nghển	ŋen˧˩˨
nghèn	ŋɛn˧˨
nghẽn	ŋɛn˧ˀ˥
nghẹn	ŋɛn˨ˀ˩ʔ
nghê	ŋe˧˧
nghề	ŋe˧˨
nghể	ŋe˧˩˨
nghệ	ŋe˨ˀ˩ʔ
nghe	ŋɛ˧˧
nghé	ŋɛ˨˦
nghè	ŋɛ˧˨
nghèo	ŋeo˧˨
nghệt	ŋet˨ˀ˩
nghẹt	ŋɛt˨ˀ˩
nghêu	ŋɛu˧˧
nghều	ŋɛu˧˨
nghễu	ŋɛu˧ˀ˥
nghĩa	ŋiə˧ˀ˥
nghĩa	ŋiə˧ˀ˥
nghịch	ŋik˨ˀ˩
nghiêm	ŋiəm˧˧
nghiễm	ŋiəm˧ˀ˥
nghiệm	ŋiəm˨ˀ˩ʔ
nghiêng	ŋiəŋ˧˧
nghiên	ŋiən˧˧
nghiến	ŋiən˨˦
nghiền	ŋiən˧˨
nghiện	ŋiən˨ˀ˩ʔ
nghiệp	ŋiəp˨ˀ˩
nghiệt	ŋiət˨ˀ˩
nghiêu	ŋiəw˧˧
nghim	ŋim˧˧
nghinh	ŋiŋ˧˧
nghìn	ŋin˧˨
nghi	ŋi˧˧
nghí	ŋi˨˦
nghì	ŋi˧˨
nghỉ	ŋi˧˩˨
nghĩ	ŋi˧ˀ˥
nghị	ŋi˨ˀ˩ʔ
nghỉu	ŋiw˧˩˨
ngoạch	ŋwɛk˨ˀ˩
ngoắc	ŋwăk˦˥
ngoặc	ŋwăk˨ˀ˩
ngoai	ŋwaj˧˧
ngoái	ŋwaj˨˦
ngoài	ŋwaj˧˨
ngoài	ŋwaj˧˨
ngoại	ŋwaj˨ˀ˩ʔ
ngoam	ŋwam˧˧
ngoang	ŋwaŋ˧˧
ngoằng	ŋwăŋ˧˨
ngoảnh	ŋwɛŋ˧˩˨
ngoan	ŋwan˧˧
ngoan	ŋwan˧˧
ngoăn	ŋwăn˧˧
ngoằn	ŋwăn˧˨
ngoạn	ŋwan˨ˀ˩ʔ
ngoa	ŋwa˧˧
ngoã	ŋwa˧ˀ˥
ngoạ	ŋwa˨ˀ˩ʔ
ngoao	ŋwaw˧˧
ngoáo	ŋwaw˨˦
ngoắt	ŋwăt˦˥
ngoặt	ŋwăt˨ˀ˩
ngoay	ŋwăj˧˧
ngốc	ŋokp˦˥
ngộc	ŋokp˨ˀ˩
ngóc	ŋɔkp˦˥
ngọc	ŋɔkp˨ˀ˩
ngọc	ŋɔkp˨ˀ˩
ngoem	ŋwem˧˧
ngoen	ŋwen˧˧
ngoe	ŋwe˧˧
ngoeo	ŋwew˧˧
ngoéo	ŋwew˨˦
ngoèo	ŋwew˧˨
ngoẻo	ŋwew˧˩˨
ngóeo	ŋwew˨˦
ngơi	ŋɤj˧˧
ngời	ŋɤj˧˨
ngợi	ŋɤj˨ˀ˩ʔ
ngôi	ŋoj˧˧
ngồi	ŋoj˧˨
ngoi	ŋɔj˧˧
ngói	ŋɔj˨˦
ngòi	ŋɔj˧˨
ngơm	ŋɤm˧˧
ngờm	ŋɤm˧˨
ngợm	ŋɤm˨ˀ˩ʔ
ngồm	ŋom˧˨
ngổm	ŋom˧˩˨
ngòm	ŋɔm˧˨
ngỏm	ŋɔm˧˩˨
ngông	ŋoŋm˧˧
ngồng	ŋoŋm˧˨
ngổng	ŋoŋm˧˩˨
ngỗng	ŋoŋm˧ˀ˥
ngong	ŋɔŋm˧˧
ngóng	ŋɔŋm˨˦
ngòng	ŋɔŋm˧˨
ngỏng	ŋɔŋm˧˩˨
ngỏng	ŋɔŋm˧˩˨
ngọng	ŋɔŋm˨ˀ˩ʔ
ngơn	ŋɤn˧˧
ngôn	ŋon˧˧
ngốn	ŋon˨˦
ngồn	ŋon˧˨
ngổn	ŋon˧˩˨
ngon	ŋɔn˧˧
ngon	ŋɔn˧˧
ngón	ŋɔn˨˦
ngòn	ŋɔn˧˨
ngỏn	ŋɔn˧˩˨
ngọn	ŋɔn˨ˀ˩ʔ
ngơ	ŋɤ˧˧
ngớ	ŋɤ˨˦
ngờ	ŋɤ˧˨
ngỡ	ŋɤ˧ˀ˥
ngô	ŋo˧˧
ngồ	ŋo˧˨
ngổ	ŋo˧˩˨
ngỗ	ŋo˧ˀ˥
ngộ	ŋo˨ˀ˩ʔ
ngo	ŋɔ˧˧
ngó	ŋɔ˨˦
ngò	ŋɔ˧˨
ngỏ	ŋɔ˧˩˨
ngõ	ŋɔ˧ˀ˥
ngọ	ŋɔ˨ˀ˩ʔ
ngợp	ŋɤp˨ˀ˩
ngớt	ŋɤt˦˥
ngốt	ŋot˦˥
ngột	ŋot˨ˀ˩
ngót	ŋɔt˦˥
ngọt	ŋɔt˨ˀ˩
ngọt	ŋɔt˨ˀ˩
ngưa	ŋɯə˧˧
ngứa	ŋɯə˨˦
ngửa	ŋɯə˧˩˨
ngựa	ŋɯə˨ˀ˩ʔ
nguây	ŋwɤ̆j˧˧
nguầy	ŋwɤ̆j˧˨
nguẩy	ŋwɤ̆j˧˩˨
ngúc	ŋukp˦˥
ngục	ŋukp˨ˀ˩
ngực	ŋɯk˨ˀ˩
nguếch	ŋwek˦˥
nguệch	ŋwek˨ˀ˩
ngùi	ŋuj˧˨
ngửi	ŋɯj˧˩˨
ngúng	ŋuŋm˨˦
ngủng	ŋuŋm˧˩˨
ngũng	ŋuŋm˧ˀ˥
ngưng	ŋɯŋ˧˧
ngừng	ŋɯŋ˧˨
ngửng	ŋɯŋ˧˩˨
ngun	ŋun˧˧
ngùn	ŋun˧˨
ngủn	ŋun˧˩˨
ngũn	ŋun˧ˀ˥
ngu	ŋu˧˧
ngú	ŋu˨˦
ngù	ŋu˧˨
ngủ	ŋu˧˩˨
ngũ	ŋu˧ˀ˥
ngụ	ŋu˨ˀ˩ʔ
ngư	ŋɯ˧˧
ngữ	ŋɯ˧ˀ˥
ngự	ŋɯ˨ˀ˩ʔ
ngước	ŋɯək˦˥
ngược	ŋɯək˨ˀ˩
nguôi	ŋuəj˧˧
nguồi	ŋuəj˧˨
nguội	ŋuəj˨ˀ˩ʔ
nguội	ŋuəj˨ˀ˩ʔ
ngươi	ŋɯəj˧˧
người	ŋɯəj˧˨
người	ŋɯəj˧˨
ngường	ŋɯəŋ˧˨
ngưỡng	ŋɯəŋ˧ˀ˥
ngượng	ŋɯəŋ˨ˀ˩ʔ
nguồn	ŋuən˧˨
ngườ	ŋɯə˧˨
ngụp	ŋup˨ˀ˩
ngút	ŋut˦˥
ngưu	ŋɯw˧˧
ngưu	ŋɯw˧˧
nguých	ŋwik˦˥
nguyên	ŋwiən˧˧
nguyền	ŋwiən˧˨
nguyện	ŋwiən˨ˀ˩ʔ
nguyệt	ŋwiət˨ˀ˩
ngụy	ŋuj˨ˀ˩ʔ
nguy	ŋwi˧˧
nguỵ	ŋwi˨ˀ˩ʔ
nguýt	ŋwit˦˥
nhác	ɲak˦˥
nhắc	ɲăk˦˥
nhạc	ɲak˨ˀ˩
nhấc	ɲɤ̆k˦˥
nhai	ɲaj˧˧
nhai	ɲaj˧˧
nhai;	ɲaj˧˧
nhái	ɲaj˨˦
nhái	ɲaj˨˦
nhài	ɲaj˧˨
nhãi	ɲaj˧ˀ˥
nham	ɲam˧˧
nhám	ɲam˨˦
nhàm	ɲam˧˨
nhăm	ɲăm˧˧
nhắm	ɲăm˨˦
nhằm	ɲăm˧˨
nhảm	ɲam˧˩˨
nhặm	ɲăm˨ˀ˩ʔ
nhâm	ɲɤ̆m˧˧
nhấm	ɲɤ̆m˨˦
nhầm	ɲɤ̆m˧˨
nhậm	ɲɤ̆m˨ˀ˩ʔ
nhậm	ɲɤ̆m˨ˀ˩ʔ
nhang	ɲaŋ˧˧
nhàng	ɲaŋ˧˨
nhăng	ɲăŋ˧˧
nhắng	ɲăŋ˨˦
nhằng	ɲăŋ˧˨
nhẳng	ɲăŋ˧˩˨
nhãng	ɲaŋ˧ˀ˥
nhặng	ɲăŋ˨ˀ˩ʔ
nhâng	ɲɤ̆ŋ˧˧
nhanh	ɲɛŋ˧˧
nhan	ɲan˧˧
nhàn	ɲan˧˨
nhăn	ɲăn˧˧
nhắn	ɲăn˨˦
nhẳn	ɲăn˧˩˨
nhẵn	ɲăn˧ˀ˥
nhãn	ɲan˧ˀ˥
nhạn	ɲan˨ˀ˩ʔ
nhân	ɲɤ̆n˧˧
nhân	ɲɤ̆n˧˧
nhấn	ɲɤ̆n˨˦
nhần	ɲɤ̆n˧˨
nhẩn	ɲɤ̆n˧˩˨
nhẫn	ɲɤ̆n˧ˀ˥
nhận	ɲɤ̆n˨ˀ˩ʔ
nha	ɲa˧˧
nhá	ɲa˨˦
nhà	ɲa˧˨
nhà	ɲa˧˨
nhả	ɲa˧˩˨
nhã	ɲa˧ˀ˥
nhao	ɲaw˧˧
nháo	ɲaw˨˦
nhào	ɲaw˧˨
nhão	ɲaw˧ˀ˥
nhạo	ɲaw˨ˀ˩ʔ
nhắp	ɲăp˦˥
nhấp	ɲɤ̆p˦˥
nhập	ɲɤ̆p˨ˀ˩
nhát	ɲat˦˥
nhạt	ɲat˨ˀ˩
nhặt	ɲăt˨ˀ˩
nhất	ɲɤ̆t˦˥
nhật	ɲɤ̆t˨ˀ˩
nhau	ɲăw˧˧
nhàu	ɲăw˧˨
nhảu	ɲăw˧˩˨
nhâu	ɲɤ̆w˧˧
nhầu	ɲɤ̆w˧˨
nhậu	ɲɤ̆w˨ˀ˩ʔ
nhay	ɲăj˧˧
nháy	ɲăj˨˦
nhày	ɲăj˧˨
nhảy	ɲăj˧˩˨
nhạy	ɲăj˨ˀ˩ʔ
nhây	ɲɤ̆j˧˧
nhầy	ɲɤ̆j˧˨
nhẩy	ɲɤ̆j˧˩˨
nhếch	ɲek˦˥
nhem	ɲɛm˧˧
nhèm	ɲɛm˧˨
nhẻm	ɲɛm˧˩˨
nhênh	ɲeŋ˧˧
nhện	ɲen˨ˀ˩ʔ
nhen	ɲɛn˧˧
nhèn	ɲɛn˧˨
nhễ	ɲe˧ˀ˥
nhe	ɲɛ˧˧
(nhè)	ɲɛ˧˨
nhè	ɲɛ˧˨
nhẻ	ɲɛ˧˩˨
nhẽ	ɲɛ˧ˀ˥
nhẹ	ɲɛ˨ˀ˩ʔ
nheo	ɲeo˧˧
nhèo	ɲeo˧˨
nhẽo	ɲeo˧ˀ˥
nhếu	ɲɛu˨˦
nhều	ɲɛu˧˨
nhệu	ɲɛu˨ˀ˩ʔ
nhiếc	ɲiək˦˥
nhiễm	ɲiəm˧ˀ˥
nhiệm	ɲiəm˨ˀ˩ʔ
nhiên	ɲiən˧˧
nhiếp	ɲiəp˦˥
nhiệt	ɲiət˨ˀ˩
nhiêu	ɲiəw˧˧
nhiều	ɲiəw˧˨
nhiễu	ɲiəw˧ˀ˥
nhím	ɲim˨˦
nhinh	ɲiŋ˧˧
nhìn	ɲin˧˨
nhịn	ɲin˨ˀ˩ʔ
nhi	ɲi˧˧
nhí	ɲi˨˦
nhì	ɲi˧˨
nhĩ	ɲi˧ˀ˥
nhị	ɲi˨ˀ˩ʔ
nhíp	ɲip˦˥
nhịp	ɲip˨ˀ˩
nhiu	ɲiw˧˧
nhịu	ɲiw˨ˀ˩ʔ
nhoang	ɲwaŋ˧˧
nhoáng	ɲwaŋ˨˦
nhoay	ɲwăj˧˧
nhóc	ɲɔkp˦˥
nhọc	ɲɔkp˨ˀ˩
nhoen	ɲwen˧˧
nhoẻn	ɲwen˧˩˨
nhoe	ɲwe˧˧
nhoè	ɲwe˧˨
nhòe	ɲwe˧˨
nhoét	ɲwet˦˥
nhời	ɲɤj˧˨
nhồi	ɲoj˧˨
nhoi	ɲɔj˧˧
nhơm	ɲɤm˧˧
nhôm	ɲom˧˧
nhồm	ɲom˧˨
nhom	ɲɔm˧˧
nhóm	ɲɔm˨˦
nhòm	ɲɔm˧˨
nhỏm	ɲɔm˧˩˨
nhông	ɲoŋm˧˧
nhộng	ɲoŋm˨ˀ˩ʔ
nhong	ɲɔŋm˧˧
nhóng	ɲɔŋm˨˦
nhỏng	ɲɔŋm˧˩˨
nhõng	ɲɔŋm˧ˀ˥
nhơn	ɲɤn˧˧
nhớn	ɲɤn˨˦
nhờn	ɲɤn˧˨
nhởn	ɲɤn˧˩˨
nhỡn	ɲɤn˧ˀ˥
nhôn	ɲon˧˧
nhốn	ɲon˨˦
nhồn	ɲon˧˨
nhộn	ɲon˨ˀ˩ʔ
nhon	ɲɔn˧˧
nhón	ɲɔn˨˦
nhỏn	ɲɔn˧˩˨
nhọn	ɲɔn˨ˀ˩ʔ
nhọn	ɲɔn˨ˀ˩ʔ
nhơ	ɲɤ˧˧
nhớ	ɲɤ˨˦
nhờ	ɲɤ˧˨
nhỡ	ɲɤ˧ˀ˥
nhố	ɲo˨˦
nhổ	ɲo˧˩˨
nho	ɲɔ˧˧
nhỏ	ɲɔ˧˩˨
nhọ	ɲɔ˨ˀ˩ʔ
nhớp	ɲɤp˦˥
nhóp	ɲɔp˦˥
nhớt	ɲɤt˦˥
nhợt	ɲɤt˨ˀ˩
nhột	ɲot˨ˀ˩
nhót	ɲɔt˦˥
nhọt	ɲɔt˨ˀ˩
nhuần	ɲwɤ̆n˧˨
nhuận	ɲwɤ̆n˨ˀ˩ʔ
nhựa	ɲɯə˨ˀ˩ʔ
nhúc	ɲukp˦˥
nhục	ɲukp˨ˀ˩
nhức	ɲɯk˦˥
nhuế	ɲwe˨˦
nhuệ	ɲwe˨ˀ˩ʔ
nhúm	ɲum˨˦
nhung	ɲuŋm˧˧
nhúng	ɲuŋm˨˦
nhùng	ɲuŋm˧˨
nhủng	ɲuŋm˧˩˨
nhũng	ɲuŋm˧ˀ˥
nhụng	ɲuŋm˨ˀ˩ʔ
nhưng	ɲɯŋ˧˧
nhửng	ɲɯŋ˧˩˨
những	ɲɯŋ˧ˀ˥
nhun	ɲun˧˧
nhún	ɲun˨˦
nhùn	ɲun˧˨
nhủn	ɲun˧˩˨
nhũn	ɲun˧ˀ˥
nhu	ɲu˧˧
nhù	ɲu˧˨
nhủ	ɲu˧˩˨
nhũ	ɲu˧ˀ˥
như	ɲɯ˧˧
nhừ	ɲɯ˧˨
nhữ	ɲɯ˧ˀ˥
nhuốc	ɲuək˦˥
nhược	ɲɯək˨ˀ˩
nhuôm	ɲuəm˧˧
nhuốm	ɲuəm˨˦
nhuộm	ɲuəm˨ˀ˩ʔ
nhường	ɲɯəŋ˧˨
nhường;	ɲɯəŋ˧˨
nhưỡng	ɲɯəŋ˧ˀ˥
nhượng	ɲɯəŋ˨ˀ˩ʔ
nhút	ɲut˦˥
nhụt	ɲut˨ˀ˩
nhựt	ɲɯt˨ˀ˩
nhuyễn	ɲwiən˧ˀ˥
ních	nik˦˥
nịch	nik˨ˀ˩
niêm	niəm˧˧
niềm	niəm˧˨
niệm	niəm˨ˀ˩ʔ
niềng	niəŋ˧˨
niên	niən˧˧
niết	niət˦˥
niêu	niəw˧˧
niệu	niəw˨ˀ˩ʔ
ninh	niŋ˧˧
nình	niŋ˧˨
nịnh	niŋ˨ˀ˩ʔ
ni	ni˧˧
nì	ni˧˨
nỉ	ni˧˩˨
nin	nin˧˧
nín	nin˨˦
nịt	nit˨ˀ˩
niu	niw˧˧
níu	niw˨˦
noãn	nwan˧ˀ˥
nốc	nokp˦˥
nóc	nɔkp˦˥
nóc	nɔkp˦˥
nọc	nɔkp˨ˀ˩
nơi	nɤj˧˧
nơi	nɤj˧˧
nới	nɤj˨˦
nối	noj˨˦
nồi	noj˧˨
nồi	noj˧˨
nổi	noj˧˩˨
nỗi	noj˧ˀ˥
nội	noj˨ˀ˩ʔ
nội	noj˨ˀ˩ʔ
noi	nɔj˧˧
nói	nɔj˨˦
nói	nɔj˨˦
nòi	nɔj˧˨
nơm	nɤm˧˧
nờm	nɤm˧˨
nôm	nom˧˧
nơ	nɤ˧˧
nở	nɤ˧˩˨
nỡ	nɤ˧ˀ˥
nợ	nɤ˨ˀ˩ʔ
nợ	nɤ˨ˀ˩ʔ
nông	noŋm˧˧
nông	noŋm˧˧
nồng	noŋm˧˨
nong	nɔŋm˧˧
nóng	nɔŋm˨˦
nòng	nɔŋm˧˨
nôn	non˧˧
nộn	non˨ˀ˩ʔ
non	nɔn˧˧
nón	nɔn˨˦
nõn	nɔn˧ˀ˥
nô	no˧˧
nổ	no˧˩˨
nỗ	no˧ˀ˥
nộ	no˨ˀ˩ʔ
no	nɔ˧˧
no	nɔ˧˧
no;	nɔ˧˧
nó	nɔ˨˦
nỏ	nɔ˧˩˨
nõ	nɔ˧ˀ˥
nọ	nɔ˨ˀ˩ʔ
nọ	nɔ˨ˀ˩ʔ
noong	nɔŋm˧˧
nớp	nɤp˦˥
nộp	nop˨ˀ˩
nốt	not˦˥
nót	nɔt˦˥
nua	nuə˧˧
núa	nuə˨˦
nứa	nɯə˨˦
nửa	nɯə˧˩˨
nữa	nɯə˧ˀ˥
nữa;	nɯə˧ˀ˥
núc	nukp˦˥
nục	nukp˨ˀ˩
nức	nɯk˦˥
nực	nɯk˨ˀ˩
núi	nuj˨˦
num	num˧˧
núm	num˨˦
nung	nuŋm˧˧
núng	nuŋm˨˦
nùng	nuŋm˧˨
nũng	nuŋm˧ˀ˥
nưng	nɯŋ˧˧
nựng	nɯŋ˨ˀ˩ʔ
nu	nu˧˧
nụ	nu˨ˀ˩ʔ
nử	nɯ˧˩˨
nữ	nɯ˧ˀ˥
nước	nɯək˦˥
nước	nɯək˦˥
nuôi	nuəj˧˧
nuôi	nuəj˧˧
nuối	nuəj˨˦
nườm	nɯəm˧˨
nuông	nuəŋ˧˧
nương	nɯəŋ˧˧
nướng	nɯəŋ˨˦
nuốt	nuət˦˥
nuột	nuət˨ˀ˩
núp	nup˦˥
nút	nut˦˥
nứt	nɯt˦˥
oác	wak˦˥
oai	waj˧˧
oái	waj˨˦
oải	waj˧˩˨
oàm	wam˧˨
oang	waŋ˧˧
oàng	waŋ˧˨
oăng	wăŋ˧˧
oanh	wɛŋ˧˧
oành	wɛŋ˧˨
oan	wan˧˧
oán	wan˨˦
oăn	wăn˧˧
oằn	wăn˧˨
oẳn	wăn˧˩˨
oản	wan˧˩˨
oát	wat˦˥
oắt	wăt˦˥
oặt	wăt˨ˀ˩
oa	wa˧˧
ốc	okp˦˥
ốc	okp˦˥
ộc	okp˨ˀ˩
óc	ɔkp˦˥
óc	ɔkp˦˥
ọc	ɔkp˨ˀ˩
oeng	weŋ˧˧
oe	we˧˧
oé	we˨˦
oẻ	we˧˩˨
ỏe	we˧˩˨
ơ	ɤ˧˧
ớ	ɤ˨˦
ờ	ɤ˧˨
ở	ɤ˧˩˨
ở	ɤ˧˩˨
ợ	ɤ˨ˀ˩ʔ
ơi	ɤj˧˧
ời	ɤj˧˨
ôi	oj˧˧
ối	oj˨˦
ồi	oj˧˨
ổi	oj˧˩˨
oi	ɔj˧˧
ói	ɔj˨˦
òi	ɔj˧˨
ỏi	ɔj˧˩˨
ỡm	ɤm˧ˀ˥
ôm	om˧˧
ốm	om˨˦
ồm	om˧˨
ổm	om˧˩˨
om	ɔm˧˧
òm	ɔm˧˨
ỏm	ɔm˧˩˨
ơn	ɤn˧˧
ớn	ɤn˨˦
ờn	ɤn˧˨
ông	oŋm˧˧
ống	oŋm˨˦
ồng	oŋm˧˨
ong	ɔŋm˧˧
óng	ɔŋm˨˦
òng	ɔŋm˧˨
ỏng	ɔŋm˧˩˨
õng	ɔŋm˧ˀ˥
ôn	on˧˧
ồn	on˧˨
ổn	on˧˩˨
ộn	on˨ˀ˩ʔ
ỏn	ɔn˧˩˨
ô	o˧˧
ô	o˧˧
ố	o˨˦
ồ	o˧˨
ổ	o˧˩˨
oong	ɔŋm˧˧
ộ	o˨ˀ˩ʔ
o	ɔ˧˧
o	ɔ˧˧
ó	ɔ˨˦
ò	ɔ˧˨
ọ	ɔ˨ˀ˩ʔ
ốp	op˦˥
ộp	op˨ˀ˩
óp	ɔp˦˥
ọp	ɔp˨ˀ˩
ớt	ɤt˦˥
ớt	ɤt˦˥
ô-tô	o˧˧-to˧˧
ốt	ot˦˥
ót	ɔt˦˥
ọt	ɔt˨ˀ˩
o-xi	ɔ˧˧-si˧˧
o-xít	ɔ˧˧-sit˦˥
o-xy	ɔ˧˧-si˧˧
pác	pak˦˥
pa	pa˧˧
pà	pa˧˨
pát	pat˦˥
pâu	pɤ̆w˧˧
pe-man-ga-nát	pɛ˧˧-man˧˧-ɣa˧˧-nat˦˥
pen	pɛn˧˧
pê	pe˧˧
phác	fak˦˥
phắc	făk˦˥
phách	fɛk˦˥
phạch	fɛk˨ˀ˩
pha	fa˧˧
phá	fa˨˦
phà	fa˧˨
phả	fa˧˩˨
phai	faj˧˧
phái	faj˨˦
phải	faj˧˩˨
phải	faj˧˩˨
phàm	fam˧˨
phăm	făm˧˧
phạm	fam˨ˀ˩ʔ
phầm	fɤ̆m˧˨
phẩm	fɤ̆m˧˩˨
phán	fan˨˦
phàn	fan˧˨
phăn	făn˧˧
phản	fan˧˩˨
phạn	fan˨ˀ˩ʔ
phân	fɤ̆n˧˧
phân	fɤ̆n˧˧
phấn	fɤ̆n˨˦
phần	fɤ̆n˧˨
phẫn	fɤ̆n˧ˀ˥
phận	fɤ̆n˨ˀ˩ʔ
phang	faŋ˧˧
phăng	făŋ˧˧
phẳng	făŋ˧˩˨
phảng	faŋ˧˩˨
phanh	fɛŋ˧˧
phành	fɛŋ˧˨
phao	faw˧˧
pháo	faw˨˦
pháp	fap˦˥
pháp;	fap˦˥
phấp	fɤ̆p˦˥
phập	fɤ̆p˨ˀ˩
phát	fat˦˥
phát	fat˦˥
phắt	făt˦˥
phạt	fat˨ˀ˩
phất	fɤ̆t˦˥
phật	fɤ̆t˨ˀ˩
phau	făw˧˧
phẫu	fɤ̆w˧ˀ˥
phay	făj˧˧
phây	fɤ̆j˧˧
phẩy	fɤ̆j˧˩˨
phéc	fɛk˦˥
phê	fe˧˧
phế	fe˨˦
phề	fe˧˨
phệ	fe˨ˀ˩ʔ
phe	fɛ˧˧
phè	fɛ˧˨
phên	fen˧˧
phèn	fɛn˧˨
phèng	fɛŋ˧˨
phềnh	feŋ˧˨
phệnh	feŋ˨ˀ˩ʔ
phép	fɛp˦˥
phét	fɛt˦˥
phẹt	fɛt˨ˀ˩
phều	fɛu˧˨
phìa	fiə˧˨
phiếm	fiəm˨˦
phiên	fiən˧˧
phiên	fiən˧˧
phiến	fiən˨˦
phiền	fiən˧˨
phiệt	fiət˨ˀ˩
phiêu	fiəw˧˧
phiếu	fiəw˨˦
phi	fi˧˧
phí	fi˨˦
phì	fi˧˨
phỉ	fi˧˩˨
phim	fim˧˧
phím	fim˨˦
phin	fin˧˧
phìn	fin˧˨
phinh	fiŋ˧˧
phình	fiŋ˧˨
phỉnh	fiŋ˧˩˨
phĩnh	fiŋ˧ˀ˥
phịu	fiw˨ˀ˩ʔ
phốc	fokp˦˥
phơ	fɤ˧˧
phờ	fɤ˧˨
phở	fɤ˧˩˨
phô	fo˧˧
phố	fo˨˦
phổ	fo˧˩˨
pho	fɔ˧˧
phó	fɔ˨˦
phò	fɔ˧˨
phơi	fɤj˧˧
phới	fɤj˨˦
phôi	foj˧˧
phối	foj˨˦
phổi	foj˧˩˨
phòi	fɔj˧˨
phôm	fom˧˧
phồm	fom˧˨
phơn	fɤn˧˧
phớn	fɤn˨˦
phởn	fɤn˧˩˨
phồn	fon˧˨
phông	foŋm˧˧
phồng	foŋm˧˨
phổng	foŋm˧˩˨
phỗng	foŋm˧ˀ˥
phộng;	foŋm˨ˀ˩ʔ
phong	fɔŋm˧˧
phóng	fɔŋm˨˦
phòng	fɔŋm˧˨
phỏng	fɔŋm˧˩˨
phọng	fɔŋm˨ˀ˩ʔ
phoóc	fɔkp˦˥
phốp	fop˦˥
phớt	fɤt˦˥
phốt	fot˦˥
phọt	fɔt˨ˀ˩
phứa	fɯə˨˦
phúc	fukp˦˥
phúc	fukp˦˥
phục	fukp˨ˀ˩
phức	fɯk˦˥
phu	fu˧˧
phú	fu˨˦
phù	fu˧˨
phủ	fu˧˩˨
phủ;	fu˧˩˨
phũ	fu˧ˀ˥
phụ	fu˨ˀ˩ʔ
phui	fuj˧˧
phủi	fuj˧˩˨
phun	fun˧˧
phún	fun˨˦
phùn	fun˧˨
phừn	fɯn˧˨
phung	fuŋm˧˧
phúng	fuŋm˨˦
phùng	fuŋm˧˨
phụng	fuŋm˨ˀ˩ʔ
phưng	fɯŋ˧˧
phừng	fɯŋ˧˨
phước	fɯək˦˥
phướn	fɯən˨˦
phương	fɯəŋ˧˧
phường	fɯəŋ˧˨
phượng	fɯəŋ˨ˀ˩ʔ
phút	fut˦˥
pin	pin˧˧
pi	pi˧˧
pít	pit˦˥
pô-li-me	po˧˧-li˧˧-mɛ˧˧
pom	pɔm˧˧
pơ	pɤ˧˧
pô	po˧˧
puốc	puək˦˥
pu	pu˧˧
quách	kwɛk˦˥
quác	kwak˦˥
quắc	kwăk˦˥
quạc	kwak˨ˀ˩
quai	kwaj˧˧
quái	kwaj˨˦
quái	kwaj˨˦
quài	kwaj˧˨
quải	kwaj˧˩˨
qua	kwa˧˧
qua	kwa˧˧
(quá	kwa˨˦
quá	kwa˨˦
quá	kwa˨˦
quà	kwa˧˨
quả	kwa˧˩˨
quạ	kwa˨ˀ˩ʔ
quăm	kwăm˧˧
quằm	kwăm˧˨
quặm	kwăm˨ˀ˩ʔ
quang	kwaŋ˧˧
quáng	kwaŋ˨˦
quáng	kwaŋ˨˦
quàng	kwaŋ˧˨
quăng	kwăŋ˧˧
quẳng	kwăŋ˧˩˨
quảng	kwaŋ˧˩˨
quãng	kwaŋ˧ˀ˥
quầng	kwɤ̆ŋ˧˨
quẩng	kwɤ̆ŋ˧˩˨
quanh	kwɛŋ˧˧
quánh	kwɛŋ˨˦
quành	kwɛŋ˧˨
quạnh	kwɛŋ˨ˀ˩ʔ
quan	kwan˧˧
quán	kwan˨˦
quăn	kwăn˧˧
quằn	kwăn˧˨
quản	kwan˧˩˨
quặn	kwăn˨ˀ˩ʔ
quân	kwɤ̆n˧˧
quấn	kwɤ̆n˨˦
quần	kwɤ̆n˧˨
quẩn	kwɤ̆n˧˩˨
quẫn	kwɤ̆n˧ˀ˥
quận	kwɤ̆n˨ˀ˩ʔ
quắp	kwăp˦˥
quặp	kwăp˨ˀ˩
quát	kwat˦˥
quắt	kwăt˦˥
quạt	kwat˨ˀ˩
quặt	kwăt˨ˀ˩
quất	kwɤ̆t˦˥
quật	kwɤ̆t˨ˀ˩
quau	kwăw˧˧
quàu	kwăw˧˨
quạu	kwăw˨ˀ˩ʔ
quay	kwăj˧˧
quày	kwăj˧˨
quảy	kwăj˧˩˨
quây	kwɤ̆j˧˧
quấy	kwɤ̆j˨˦
quầy	kwɤ̆j˧˨
quậy	kwɤ̆j˨ˀ˩ʔ
quếch	kwek˦˥
quệch	kwek˨ˀ˩
quê	kwe˧˧
quế	kwe˨˦
quế	kwe˨˦
quề	kwe˧˨
que	kwɛ˧˧
què	kwɛ˧˨
quẻ	kwɛ˧˩˨
queng	kwɛŋ˧˧
quếnh	kweŋ˨˦
quềnh	kweŋ˧˨
quệnh	kweŋ˨ˀ˩ʔ
quên	kwen˧˧
quến	kwen˨˦
quen	kwɛn˧˧
quèn	kwɛn˧˨
queo	kweo˧˧
quèo	kweo˧˨
quẹo	kweo˨ˀ˩ʔ
quết	kwet˦˥
quét	kwɛt˦˥
quẹt	kwɛt˨ˀ˩
quếu	kwɛu˨˦
quều	kwɛu˧˨
qui	kwi˧˧
quí	kwi˨˦
quì	kwi˧˨
quỉ	kwi˧˩˨
quỉ	kwi˧˩˨
quĩ	kwi˧ˀ˥
quị	kwi˨ˀ˩ʔ
quình	kwiŋ˧˨
quít	kwit˦˥
quốc	kwokp˦˥
quới	kwɤj˨˦
quơ	kwɤ˧˧
quờ	kwɤ˧˨
quở	kwɤ˧˩˨
quờn	kwɤn˧˨
quyên	kwiɛn˧˧
quyến	kwiɛn˨˦
quyền	kwiɛn˧˨
quyển	kwiɛn˧˩˨
quyết	kwiɛt˦˥
quy	kwi˧˧
quý	kwi˨˦
quỳ	kwi˧˨
quỷ	kwi˧˩˨
quỹ	kwi˧ˀ˥
quỵ	kwi˨ˀ˩ʔ
quýnh	kwiŋ˨˦
quỳnh	kwiŋ˧˨
quýt	kwit˦˥
rách	zɛk˦˥
rạch	zɛk˨ˀ˩
rác	zak˦˥
rắc	zăk˦˥
rạc	zak˨ˀ˩
ra-đi-ô	za˧˧-di˧˧-o˧˧
rái	zaj˨˦
rải	zaj˧˩˨
rãi	zaj˧ˀ˥
ram	zam˧˧
rám	zam˨˦
răm	zăm˧˧
rắm	zăm˨˦
rằm	zăm˧˨
rặm	zăm˨ˀ˩ʔ
râm	zɤ̆m˧˧
rấm	zɤ̆m˨˦
rầm	zɤ̆m˧˨
rậm	zɤ̆m˨ˀ˩ʔ
rang	zaŋ˧˧
ráng	zaŋ˨˦
ràng	zaŋ˧˨
răng	zăŋ˧˧
răng	zăŋ˧˧
rằng	zăŋ˧˨
rạng	zaŋ˨ˀ˩ʔ
ranh	zɛŋ˧˧
rành	zɛŋ˧˨
rảnh	zɛŋ˧˩˨
rãnh	zɛŋ˧ˀ˥
ran	zan˧˧
rán	zan˨˦
ràn	zan˧˨
răn	zăn˧˧
rắn	zăn˨˦
rắn	zăn˨˦
rằn	zăn˧˨
rạn	zan˨ˀ˩ʔ
rân	zɤ̆n˧˧
rấn	zɤ̆n˨˦
rần	zɤ̆n˧˨
rận	zɤ̆n˨ˀ˩ʔ
rao	zaw˧˧
ráo	zaw˨˦
rào	zaw˧˨
rảo	zaw˧˩˨
rạo	zaw˨ˀ˩ʔ
ráp	zap˦˥
rắp	zăp˦˥
rạp	zap˨ˀ˩
rấp	zɤ̆p˦˥
rập	zɤ̆p˨ˀ˩
rát	zat˦˥
rặt	zăt˨ˀ˩
rất	zɤ̆t˦˥
rau	zăw˧˧
rau	zăw˧˧
ráu	zăw˨˦
râu	zɤ̆w˧˧
râu	zɤ̆w˧˧
rầu	zɤ̆w˧˨
ray	zăj˧˧
ráy	zăj˨˦
rày	zăj˧˨
rầy	zɤ̆j˧˨
rẫy	zɤ̆j˧ˀ˥
(ra)	za˧˧
ra	za˧˧
ra	za˧˧
rá	za˨˦
rá	za˨˦
rà	za˧˨
rả	za˧˩˨
rã	za˧ˀ˥
rạ	za˨ˀ˩ʔ
rếch	zek˦˥
reng	zɛŋ˧˧
rềnh	zeŋ˧˨
rểnh	zeŋ˧˩˨
rên	zen˧˧
rền	zen˧˨
ren	zɛn˧˧
rén	zɛn˨˦
rèn	zɛn˧˨
reo	zeo˧˧
réo	zeo˨˦
rèo	zeo˧˨
rẻo	zeo˧˩˨
rẹo	zeo˨ˀ˩ʔ
rệp	zep˨ˀ˩
rết	zet˦˥
rét	zɛt˦˥
rêu	zɛu˧˧
rệu	zɛu˨ˀ˩ʔ
rế	ze˨˦
rề	ze˧˨
rề	ze˧˨
rể	ze˧˩˨
rễ	ze˧ˀ˥
re	zɛ˧˧
ré	zɛ˨˦
rè	zɛ˧˨
rẻ	zɛ˧˩˨
rẽ	zɛ˧ˀ˥
rịa-vũng	ziə˨ˀ˩ʔ-vuŋm˧ˀ˥
rìa	ziə˧˨
rỉa	ziə˧˩˨
rích	zik˦˥
rịch	zik˨ˀ˩
riêng	ziəŋ˧˧
riềng	ziəŋ˧˨
riết	ziət˦˥
riêu	ziəw˧˧
rinh	ziŋ˧˧
rình	ziŋ˧˨
rin	zin˧˧
rít	zit˦˥
riu	ziw˧˧
ríu	ziw˨˦
rìu	ziw˧˨
ri	zi˧˧
rí	zi˨˦
rì	zi˧˨
rỉ	zi˧˩˨
rĩ	zi˧ˀ˥
rị	zi˨ˀ˩ʔ
rốc	zokp˦˥
rộc	zokp˨ˀ˩
róc	zɔkp˦˥
rọc	zɔkp˨ˀ˩
rơi	zɤj˧˧
rơi	zɤj˧˧
rời	zɤj˧˨
rối	zoj˨˦
rồi	zoj˧˨
rỗi	zoj˧ˀ˥
roi	zɔj˧˧
rơm	zɤm˧˧
rờm	zɤm˧˨
rởm	zɤm˧˩˨
rôm	zom˧˧
rồm	zom˧˨
ròm	zɔm˧˨
rông	zoŋm˧˧
rống	zoŋm˨˦
rồng	zoŋm˧˨
rỗng	zoŋm˧ˀ˥
rộng	zoŋm˨ˀ˩ʔ
rong	zɔŋm˧˧
ròng	zɔŋm˧˨
rơn	zɤn˧˧
rờn	zɤn˧˨
rởn	zɤn˧˩˨
rợn	zɤn˨ˀ˩ʔ
rôn	zon˧˧
rốn	zon˨˦
rồn	zon˧˨
rổn	zon˧˩˨
rộn	zon˨ˀ˩ʔ
rón	zɔn˨˦
ròn	zɔn˧˨
rợp	zɤp˨ˀ˩
rớt	zɤt˦˥
rốt	zot˦˥
rột	zot˨ˀ˩
rót	zɔt˦˥
rọt	zɔt˨ˀ˩
rơ	zɤ˧˧
rờ	zɤ˧˨
rỡ	zɤ˧ˀ˥
rợ	zɤ˨ˀ˩ʔ
rô	zo˧˧
rồ	zo˧˨
rổ	zo˧˩˨
rỗ	zo˧ˀ˥
rộ	zo˨ˀ˩ʔ
ro	zɔ˧˧
ró	zɔ˨˦
rò	zɔ˧˨
rỏ	zɔ˧˩˨
rõ	zɔ˧ˀ˥
rọ	zɔ˨ˀ˩ʔ
rùa	zuə˧˨
rủa	zuə˧˩˨
rưa	zɯə˧˧
rửa	zɯə˧˩˨
rữa	zɯə˧ˀ˥
rựa	zɯə˨ˀ˩ʔ
rúc	zukp˦˥
rục	zukp˨ˀ˩
rực	zɯk˨ˀ˩
rúi	zuj˨˦
rủi	zuj˧˩˨
rúm	zum˨˦
rùm	zum˧˨
rung	zuŋm˧˧
rúng	zuŋm˨˦
rùng	zuŋm˧˨
rủng	zuŋm˧˩˨
rụng	zuŋm˨ˀ˩ʔ
rưng	zɯŋ˧˧
rừng	zɯŋ˧˨
rửng	zɯŋ˧˩˨
run	zun˧˧
rún	zun˨˦
rủn	zun˧˩˨
ruốc	zuək˦˥
rước	zɯək˦˥
ruồi	zuəj˧˨
ruổi	zuəj˧˩˨
rươi	zɯəj˧˧
rười	zɯəj˧˨
rươm	zɯəm˧˧
rườm	zɯəm˧˨
ruồng	zuəŋ˧˨
ruỗng	zuəŋ˧ˀ˥
ruộng	zuəŋ˨ˀ˩ʔ
rương	zɯəŋ˧˧
rường	zɯəŋ˧˨
ruôn	zuən˧˧
rướn	zɯən˨˦
rườn	zɯən˧˨
rượn	zɯən˨ˀ˩ʔ
ruột	zuət˨ˀ˩
rượu	zɯəw˨ˀ˩ʔ
rụp	zup˨ˀ˩
rút	zut˦˥
rụt	zut˨ˀ˩
rứt	zɯt˦˥
ru	zu˧˧
rú	zu˨˦
rù	zu˧˨
rủ	zu˧˩˨
rũ	zu˧ˀ˥
rụ;	zu˨ˀ˩ʔ
sách	sɛk˦˥
sạch	sɛk˨ˀ˩
sạch	sɛk˨ˀ˩
sắc	săk˦˥
sặc	săk˨ˀ˩
sai	saj˧˧
sái	saj˨˦
sài	saj˧˨
sải	saj˧˩˨
sãi	saj˧ˀ˥
sam	sam˧˧
sám	sam˨˦
sàm	sam˧˨
săm	săm˧˧
sắm	săm˨˦
sạm	sam˨ˀ˩ʔ
sặm	săm˨ˀ˩ʔ
sâm	sɤ̆m˧˧
sấm	sɤ̆m˨˦
sầm	sɤ̆m˧˨
sẩm	sɤ̆m˧˩˨
sậm	sɤ̆m˨ˀ˩ʔ
sang	saŋ˧˧
sang	saŋ˧˧
sáng	saŋ˨˦
sáng	saŋ˨˦
sàng	saŋ˧˨
sàng	saŋ˧˨
săng	săŋ˧˧
sằng	săŋ˧˨
sảng	saŋ˧˩˨
sanh	sɛŋ˧˧
sánh	sɛŋ˨˦
sành	sɛŋ˧˨
sảnh	sɛŋ˧˩˨
san	san˧˧
sán	san˨˦
sàn	san˧˨
săn	săn˧˧
sắn	săn˨˦
sản	san˧˩˨
sẵn	săn˧ˀ˥
sạn	san˨ˀ˩ʔ
sân	sɤ̆n˧˧
sấn	sɤ̆n˨˦
sần	sɤ̆n˧˨
sao	saw˧˧
sao	saw˧˧
sáo	saw˨˦
sào	saw˧˨
sảo	saw˧˩˨
sạo	saw˨ˀ˩ʔ
sáp	sap˦˥
sắp	săp˦˥
sẵp	săp˧ˀ˥
sạp	sap˨ˀ˩
sấp	sɤ̆p˦˥
sập	sɤ̆p˨ˀ˩
sa	sa˧˧
sa	sa˧˧
sá	sa˨˦
sà	sa˧˨
sả	sa˧˩˨
sã	sa˧ˀ˥
sát	sat˦˥
sắt	săt˦˥
sạt	sat˨ˀ˩
sặt	săt˨ˀ˩
sau	săw˧˧
sáu	săw˨˦
sâu	sɤ̆w˧˧
sầu	sɤ̆w˧˨
say	săj˧˧
sảy	săj˧˩˨
sây	sɤ̆j˧˧
sấy	sɤ̆j˨˦
sầy	sɤ̆j˧˨
sẩy	sɤ̆j˧˩˨
sém	sɛm˨˦
sênh	seŋ˧˧
sềnh	seŋ˧˨
sểnh	seŋ˧˩˨
sên	sen˧˧
sến	sen˨˦
sền	sen˧˨
sen	sɛn˧˧
sẻn	sɛn˧˩˨
seo	seo˧˧
sẹo	seo˨ˀ˩ʔ
sếp	sep˦˥
sê	se˧˧
sề	se˧˨
sệ	se˨ˀ˩ʔ
se	sɛ˧˧
sè	sɛ˧˨
sẻ	sɛ˧˩˨
sẽ	sɛ˧ˀ˥
sét	sɛt˦˥
sêu	sɛu˧˧
sếu	sɛu˨˦
sỉa	siə˧˩˨
siểm	siəm˧˩˨
siêng	siəŋ˧˧
siết	siət˦˥
siêu	siəw˧˧
sim	sim˧˧
sinh	siŋ˧˧
sính	siŋ˨˦
sình	siŋ˧˨
sin	sin˧˧
sín	sin˨˦
sìn	sin˧˨
si	si˧˧
si	si˧˧
sì	si˧˨
sỉ	si˧˩˨
sĩ	si˧ˀ˥
sít	sit˦˥
sịt	sit˨ˀ˩
soái	swaj˨˦
soái	swaj˨˦
soàm	swam˧˨
soán	swan˨˦
soàn	swan˧˨
soạn	swan˨ˀ˩ʔ
soát	swat˦˥
sộc	sokp˨ˀ˩
sóc	sɔkp˦˥
sợi	sɤj˨ˀ˩ʔ
sôi	soj˧˧
sôi	soj˧˧
sồi	soj˧˨
soi	sɔj˧˧
sói	sɔj˨˦
sỏi	sɔj˧˩˨
sõi	sɔj˧ˀ˥
sơm	sɤm˧˧
sớm	sɤm˨˦
sờm	sɤm˧˨
sóm	sɔm˨˦
sòm	sɔm˧˨
sọm	sɔm˨ˀ˩ʔ
sông	soŋm˧˧
sống	soŋm˨˦
sống	soŋm˨˦
sồng	soŋm˧˨
sổng	soŋm˧˩˨
song	sɔŋm˧˧
sóng	sɔŋm˨˦
sòng	sɔŋm˧˨
sõng	sɔŋm˧ˀ˥
sơn	sɤn˧˧
sớn	sɤn˨˦
sờn	sɤn˧˨
sởn	sɤn˧˩˨
sồn	son˧˨
son	sɔn˧˧
son	sɔn˧˧
sòn	sɔn˧˨
sốp	sop˦˥
sơ	sɤ˧˧
sớ	sɤ˨˦
sờ	sɤ˧˨
sở	sɤ˧˩˨
sở	sɤ˧˩˨
sợ	sɤ˨ˀ˩ʔ
sô	so˧˧
số	so˨˦
sồ	so˧˨
sổ	so˧˩˨
sỗ	so˧ˀ˥
so	sɔ˧˧
sò	sɔ˧˨
sọ	sɔ˨ˀ˩ʔ
sốt	sot˦˥
sột	sot˨ˀ˩
sót	sɔt˦˥
sọt	sɔt˨ˀ˩
sô-vanh	so˧˧-vɛŋ˧˧
sủa	suə˧˩˨
sứa	sɯə˨˦
sửa	sɯə˧˩˨
sữa	sɯə˧ˀ˥
suất	swɤ̆t˦˥
suất;	swɤ̆t˦˥
súc	sukp˦˥
sục	sukp˨ˀ˩
sức	sɯk˦˥
sực	sɯk˨ˀ˩
sui	suj˧˧
sùi	suj˧˨
sủi	suj˧˩˨
sum	sum˧˧
sùm	sum˧˨
sụm	sum˨ˀ˩ʔ
sung	suŋm˧˧
súng	suŋm˨˦
sùng	suŋm˧˨
sủng	suŋm˧˩˨
sưng	sɯŋ˧˧
sừng	sɯŋ˧˨
sửng	sɯŋ˧˩˨
sững	sɯŋ˧ˀ˥
sựng	sɯŋ˨ˀ˩ʔ
sun-phát	sun˧˧-fat˦˥
sun	sun˧˧
sún	sun˨˦
sụn	sun˨ˀ˩ʔ
sừn	sɯn˧˨
suối	suəj˨˦
sưởi	sɯəj˧˩˨
suông	suəŋ˧˧
suồng	suəŋ˧˨
sương	sɯəŋ˧˧
sướng	sɯəŋ˨˦
sường	sɯəŋ˧˨
sượng	sɯəŋ˨ˀ˩ʔ
suôn	suən˧˧
sườn	sɯən˧˨
suốt	suət˦˥
sướt	sɯət˦˥
súp	sup˦˥
sụp	sup˨ˀ˩
su	su˧˧
sú	su˨˦
sù	su˧˨
sù;	su˧˨
sủ	su˧˩˨
sụ	su˨ˀ˩ʔ
sư	sɯ˧˧
sư	sɯ˧˧
sứ	sɯ˨˦
sử	sɯ˧˩˨
sự	sɯ˨ˀ˩ʔ
sự	sɯ˨ˀ˩ʔ
sút	sut˦˥
sụt	sut˨ˀ˩
sứt	sɯt˦˥
sưu	sɯw˧˧
súy	suj˨˦
suy	swi˧˧
suý	swi˨˦
suýt	swit˦˥
suỵt	swit˨ˀ˩
sỹ	si˧ˀ˥
tách	tɛk˦˥
tác	tak˦˥
tắc	tăk˦˥
tạc	tak˨ˀ˩
tặc	tăk˨ˀ˩
tấc	tɤ̆k˦˥
tai	taj˧˧
tai	taj˧˧
tai;	taj˧˧
tái	taj˨˦
tài	taj˧˨
tải	taj˧˩˨
tại	taj˨ˀ˩ʔ
tam	tam˧˧
tám	tam˨˦
tám	tam˨˦
tàm	tam˧˨
tăm	tăm˧˧
tắm	tăm˨˦
tằm	tăm˧˨
tằm	tăm˧˨
tạm	tam˨ˀ˩ʔ
tâm	tɤ̆m˧˧
tấm	tɤ̆m˨˦
tấm	tɤ̆m˨˦
tầm	tɤ̆m˧˨
tẩm	tɤ̆m˧˩˨
tậm	tɤ̆m˨ˀ˩ʔ
tang	taŋ˧˧
táng	taŋ˨˦
tàng	taŋ˧˨
tăng	tăŋ˧˧
tằng	tăŋ˧˨
tảng	taŋ˧˩˨
tạng	taŋ˨ˀ˩ʔ
tặng	tăŋ˨ˀ˩ʔ
tâng	tɤ̆ŋ˧˧
tầng	tɤ̆ŋ˧˨
tanh	tɛŋ˧˧
tánh	tɛŋ˨˦
tành	tɛŋ˧˨
tạnh	tɛŋ˨ˀ˩ʔ
tan	tan˧˧
tán	tan˨˦
tàn	tan˧˨
tằn	tăn˧˨
tẳn	tăn˧˩˨
tản	tan˧˩˨
tân	tɤ̆n˧˧
tấn	tɤ̆n˨˦
tần	tɤ̆n˧˨
tẩn	tɤ̆n˧˩˨
tận	tɤ̆n˨ˀ˩ʔ
tao	taw˧˧
táo	taw˨˦
tào	taw˧˨
tảo	taw˧˩˨
tạo	taw˨ˀ˩ʔ
táp	tap˦˥
tắp	tăp˦˥
tạp	tap˨ˀ˩
tấp	tɤ̆p˦˥
tập	tɤ̆p˨ˀ˩
ta	ta˧˧
ta	ta˧˧
tá	ta˨˦
tà	ta˧˨
tà;	ta˧˨
tả	ta˧˩˨
tã	ta˧ˀ˥
tạ	ta˨ˀ˩ʔ
tát	tat˦˥
tát	tat˦˥
tắt	tăt˦˥
tạt	tat˨ˀ˩
tất	tɤ̆t˦˥
tật	tɤ̆t˨ˀ˩
tật	tɤ̆t˨ˀ˩
tàu	tăw˧˨
tàu	tăw˧˨
tâu	tɤ̆w˧˧
tấu	tɤ̆w˨˦
tầu	tɤ̆w˧˨
tẩu	tɤ̆w˧˩˨
tậu	tɤ̆w˨ˀ˩ʔ
tay	tăj˧˧
tay	tăj˧˧
táy	tăj˨˦
tày	tăj˧˨
tây	tɤ̆j˧˧
tầy	tɤ̆j˧˨
tẩy	tɤ̆j˧˩˨
tếch	tek˦˥
têm	tem˧˧
tem	tɛm˧˧
tèm	tɛm˧˨
teng	tɛŋ˧˧
tèng	tɛŋ˧˨
tênh	teŋ˧˧
tềnh	teŋ˧˨
tên	ten˧˧
ten	tɛn˧˧
tén	tɛn˨˦
tèn	tɛn˧˨
tẽn	tɛn˧ˀ˥
teo	teo˧˧
tèo	teo˧˨
tẻo	teo˧˩˨
tép	tɛp˦˥
tẹp	tɛp˨ˀ˩
tê	te˧˧
tế	te˨˦
tề	te˧˨
tể	te˧˩˨
tễ	te˧ˀ˥
tệ	te˨ˀ˩ʔ
te	tɛ˧˧
té	tɛ˨˦
tè	tɛ˧˨
tẻ	tɛ˧˩˨
tết	tet˦˥
tết	tet˦˥
tẹt	tɛt˨ˀ˩
tếu	tɛu˨˦
thách	tʰɛk˦˥
thạch	tʰɛk˨ˀ˩
thác	tʰak˦˥
thắc	tʰăk˦˥
thạc	tʰak˨ˀ˩
thai	tʰaj˧˧
thái	tʰaj˨˦
thài	tʰaj˧˨
thải	tʰaj˧˩˨
tham	tʰam˧˧
thám	tʰam˨˦
thàm	tʰam˧˨
thăm	tʰăm˧˧
thắm	tʰăm˨˦
thắm	tʰăm˨˦
thẳm	tʰăm˧˩˨
thảm	tʰam˧˩˨
thâm	tʰɤ̆m˧˧
thấm	tʰɤ̆m˨˦
thầm	tʰɤ̆m˧˨
thẩm	tʰɤ̆m˧˩˨
thậm	tʰɤ̆m˨ˀ˩ʔ
thang	tʰaŋ˧˧
tháng	tʰaŋ˨˦
thăng	tʰăŋ˧˧
thắng	tʰăŋ˨˦
thắng	tʰăŋ˨˦
thằng	tʰăŋ˧˨
thẳng	tʰăŋ˧˩˨
thảng	tʰaŋ˧˩˨
thặng	tʰăŋ˨ˀ˩ʔ
thanh	tʰɛŋ˧˧
thánh	tʰɛŋ˨˦
thành	tʰɛŋ˧˨
thành	tʰɛŋ˧˨
thảnh	tʰɛŋ˧˩˨
thạnh	tʰɛŋ˨ˀ˩ʔ
than	tʰan˧˧
thán	tʰan˨˦
thăn	tʰăn˧˧
thằn	tʰăn˧˨
thản	tʰan˧˩˨
thân	tʰɤ̆n˧˧
thân	tʰɤ̆n˧˧
thần	tʰɤ̆n˧˨
thẩn	tʰɤ̆n˧˩˨
thẫn	tʰɤ̆n˧ˀ˥
thận	tʰɤ̆n˨ˀ˩ʔ
thao	tʰaw˧˧
tháo	tʰaw˨˦
thào	tʰaw˧˨
thảo	tʰaw˧˩˨
thạo	tʰaw˨ˀ˩ʔ
tháp	tʰap˦˥
thắp	tʰăp˦˥
thấp	tʰɤ̆p˦˥
thập	tʰɤ̆p˨ˀ˩
tha	tʰa˧˧
tha	tʰa˧˧
thà	tʰa˧˨
thả	tʰa˧˩˨
thát	tʰat˦˥
thắt	tʰăt˦˥
thất	tʰɤ̆t˦˥
thật	tʰɤ̆t˨ˀ˩
thau	tʰăw˧˧
tháu	tʰăw˨˦
thâu	tʰɤ̆w˧˧
thấu	tʰɤ̆w˨˦
thầu	tʰɤ̆w˧˨
thẩu	tʰɤ̆w˧˩˨
thay	tʰăj˧˧
tháy	tʰăj˨˦
thày	tʰăj˧˨
thảy	tʰăj˧˩˨
thây	tʰɤ̆j˧˧
thấy	tʰɤ̆j˨˦
thầy	tʰɤ̆j˧˨
thêm	tʰem˧˧
thêm	tʰem˧˧
thềm	tʰem˧˨
thèm	tʰɛm˧˨
thênh	tʰeŋ˧˧
then	tʰɛn˧˧
thèn	tʰɛn˧˨
thẹn	tʰɛn˨ˀ˩ʔ
theo	tʰeo˧˧
thèo	tʰeo˧˨
thếp	tʰep˦˥
thép	tʰɛp˦˥
thẹp	tʰɛp˨ˀ˩
thê	tʰe˧˧
thế	tʰe˨˦
thề	tʰe˧˨
thể	tʰe˧˩˨
thệ	tʰe˨ˀ˩ʔ
the	tʰɛ˧˧
thè	tʰɛ˧˨
thẻ	tʰɛ˧˩˨
thẽ	tʰɛ˧ˀ˥
thết	tʰet˦˥
thét	tʰɛt˦˥
thêu	tʰɛu˧˧
thều	tʰɛu˧˨
thia	tʰiə˧˧
thìa	tʰiə˧˨
thích	tʰik˦˥
thịch	tʰik˨ˀ˩
thiếc	tʰiək˦˥
thiêm	tʰiəm˧˧
thiềm	tʰiəm˧˨
thiểm	tʰiəm˧˩˨
thiêng	tʰiəŋ˧˧
thiên	tʰiən˧˧
thiền	tʰiən˧˨
thiển	tʰiən˧˩˨
thiện	tʰiən˨ˀ˩ʔ
thiếp	tʰiəp˦˥
thiệp	tʰiəp˨ˀ˩
thiết	tʰiət˦˥
thiệt	tʰiət˨ˀ˩
thiêu	tʰiəw˧˧
thiếu	tʰiəw˨˦
thiếu	tʰiəw˨˦
thiều	tʰiəw˧˨
thiểu	tʰiəw˧˩˨
thiệu	tʰiəw˨ˀ˩ʔ
thinh	tʰiŋ˧˧
thính	tʰiŋ˨˦
thình	tʰiŋ˧˨
thỉnh	tʰiŋ˧˩˨
thịnh	tʰiŋ˨ˀ˩ʔ
thin	tʰin˧˧
thi	tʰi˧˧
thí	tʰi˨˦
thì	tʰi˧˨
thì	tʰi˧˨
thỉ	tʰi˧˩˨
thị	tʰi˨ˀ˩ʔ
thít	tʰit˦˥
thịt	tʰit˨ˀ˩
thịt	tʰit˨ˀ˩
thiu	tʰiw˧˧
thoai	tʰwaj˧˧
thoái	tʰwaj˨˦
thoải	tʰwaj˧˩˨
thoại	tʰwaj˨ˀ˩ʔ
thoang	tʰwaŋ˧˧
thoáng	tʰwaŋ˨˦
thoảng	tʰwaŋ˧˩˨
thoán	tʰwan˨˦
thoăn	tʰwăn˧˧
thoa	tʰwa˧˧
thoá	tʰwa˨˦
thoả	tʰwa˧˩˨
thóa	tʰwa˨˦
thỏa	tʰwa˧˩˨
thoát	tʰwat˦˥
thoắt	tʰwăt˦˥
thoạt	tʰwat˨ˀ˩
thốc	tʰokp˦˥
thóc	tʰɔkp˦˥
thóc	tʰɔkp˦˥
thọc	tʰɔkp˨ˀ˩
thới	tʰɤj˨˦
thời	tʰɤj˧˨
thời	tʰɤj˧˨
thôi	tʰoj˧˧
thối	tʰoj˨˦
thổi	tʰoj˧˩˨
thoi	tʰɔj˧˧
thói	tʰɔj˨˦
thói	tʰɔj˨˦
thòi	tʰɔj˧˨
thơm	tʰɤm˧˧
thồm	tʰom˧˨
thom	tʰɔm˧˧
thòm	tʰɔm˧˨
thông	tʰoŋm˧˧
thống	tʰoŋm˨˦
thong	tʰɔŋm˧˧
thòng	tʰɔŋm˧˨
thõng	tʰɔŋm˧ˀ˥
thơn	tʰɤn˧˧
thờn	tʰɤn˧˨
thôn	tʰon˧˧
thốn	tʰon˨˦
thồn	tʰon˧˨
thổn	tʰon˧˩˨
thỗn	tʰon˧ˀ˥
thon	tʰɔn˧˧
thoòng	tʰɔŋm˧˨
thộp	tʰop˨ˀ˩
thơ	tʰɤ˧˧
thớ	tʰɤ˨˦
thờ	tʰɤ˧˨
thở	tʰɤ˧˩˨
thợ	tʰɤ˨ˀ˩ʔ
thô	tʰo˧˧
thố	tʰo˨˦
thồ	tʰo˧˨
thổ	tʰo˧˩˨
thò	tʰɔ˧˨
thỏ	tʰɔ˧˩˨
thọ	tʰɔ˨ˀ˩ʔ
thớt	tʰɤt˦˥
thốt	tʰot˦˥
thuần	tʰwɤ̆n˧˨
thuận	tʰwɤ̆n˨ˀ˩ʔ
thua	tʰuə˧˧
thùa	tʰuə˧˨
thủa;	tʰuə˧˩˨
thưa	tʰɯə˧˧
thừa	tʰɯə˧˨
thuật	tʰwɤ̆t˨ˀ˩
thúc	tʰukp˦˥
thục	tʰukp˨ˀ˩
thức	tʰɯk˦˥
thực	tʰɯk˨ˀ˩
thuê	tʰwe˧˧
thuế	tʰwe˨˦
thuể	tʰwe˧˩˨
thui	tʰuj˧˧
thùi	tʰuj˧˨
thủi	tʰuj˧˩˨
thum	tʰum˧˧
thùm	tʰum˧˨
thung	tʰuŋm˧˧
thúng	tʰuŋm˨˦
thúng	tʰuŋm˨˦
thùng	tʰuŋm˧˨
thủng	tʰuŋm˧˩˨
thũng	tʰuŋm˧ˀ˥
thụng	tʰuŋm˨ˀ˩ʔ
thưng	tʰɯŋ˧˧
thừng	tʰɯŋ˧˨
thun	tʰun˧˧
thùn	tʰun˧˨
thuốc	tʰuək˦˥
thuộc	tʰuək˨ˀ˩
thước	tʰɯək˦˥
thược	tʰɯək˨ˀ˩
thuồi	tʰuəj˧˨
thười	tʰɯəj˧˨
thuông	tʰuəŋ˧˧
thuồng	tʰuəŋ˧˨
thương	tʰɯəŋ˧˧
thường	tʰɯəŋ˧˨
thưởng	tʰɯəŋ˧˩˨
thượng	tʰɯəŋ˨ˀ˩ʔ
thuôn	tʰuən˧˧
thuồn	tʰuən˧˨
thườn	tʰɯən˧˨
thưỡn	tʰɯən˧ˀ˥
thuở	tʰuə˧˩˨
thuở	tʰuə˧˩˨
thướt	tʰɯət˦˥
thụp	tʰup˨ˀ˩
thu	tʰu˧˧
thú	tʰu˨˦
thù	tʰu˧˨
thủ	tʰu˧˩˨
thủ	tʰu˧˩˨
thụ	tʰu˨ˀ˩ʔ
thư	tʰɯ˧˧
thứ	tʰɯ˨˦
thử	tʰɯ˧˩˨
thự	tʰɯ˨ˀ˩ʔ
thút	tʰut˦˥
thụt	tʰut˨ˀ˩
thuyên	tʰwiən˧˧
thuyền	tʰwiən˧˨
thuyết	tʰwiət˦˥
thùy	tʰuj˧˨
thủy	tʰuj˧˩˨
thụy	tʰuj˨ˀ˩ʔ
thuý	tʰwi˨˦
thuỳ	tʰwi˧˨
thuỷ	tʰwi˧˩˨
thuỵ	tʰwi˨ˀ˩ʔ
tia	tiə˧˧
tía	tiə˨˦
tỉa	tiə˧˩˨
tích	tik˦˥
tịch	tik˨ˀ˩
tiếc	tiək˦˥
tiếc	tiək˦˥
tiệc	tiək˨ˀ˩
tiêm	tiəm˧˧
tiếm	tiəm˨˦
tiềm	tiəm˧˨
tiệm	tiəm˨ˀ˩ʔ
tiêng	tiəŋ˧˧
tiếng	tiəŋ˨˦
tiếng	tiəŋ˨˦
tiên	tiən˧˧
tiến	tiən˨˦
tiền	tiən˧˨
tiền	tiən˧˨
tiễn	tiən˧ˀ˥
tiện	tiən˨ˀ˩ʔ
tiếp	tiəp˦˥
tiệp	tiəp˨ˀ˩
tiết	tiət˦˥
tiệt	tiət˨ˀ˩
tiêu	tiəw˧˧
tiếu	tiəw˨˦
tiều	tiəw˧˨
tiểu	tiəw˧˩˨
tiễu	tiəw˧ˀ˥
tim	tim˧˧
tím	tim˨˦
tìm	tim˧˨
tỉm	tim˧˩˨
tinh	tiŋ˧˧
tinh	tiŋ˧˧
tính	tiŋ˨˦
tính	tiŋ˨˦
tính;	tiŋ˨˦
tình	tiŋ˧˨
tỉnh	tiŋ˧˩˨
tĩnh	tiŋ˧ˀ˥
tịnh	tiŋ˨ˀ˩ʔ
tin	tin˧˧
tín	tin˨˦
típ	tip˦˥
ti	ti˧˧
tí	ti˨˦
tì	ti˧˨
tỉ	ti˧˩˨
tị	ti˨ˀ˩ʔ
tít	tit˦˥
tịt	tit˨ˀ˩
tiu	tiw˧˧
tíu	tiw˨˦
tỉu	tiw˧˩˨
toác	twak˦˥
toạc	twak˨ˀ˩
toại	twaj˨ˀ˩ʔ
toang	twaŋ˧˧
toan	twan˧˧
toán	twan˨˦
toàn	twan˧˨
toát	twat˦˥
toa	twa˧˧
toá	twa˨˦
toà	twa˧˨
toả	twa˧˩˨
tòa	twa˧˨
tỏa	twa˧˩˨
toạ	twa˨ˀ˩ʔ
tọa	twa˨ˀ˩ʔ
tộc-ngôn	tokp˨ˀ˩-ŋon˧˧
tốc	tokp˦˥
tộc	tokp˨ˀ˩
tộc;	tokp˨ˀ˩
tóc	tɔkp˦˥
tóc	tɔkp˦˥
tọc	tɔkp˨ˀ˩
toen	twen˧˧
toèn	twen˧˨
toét	twet˦˥
toe	twe˧˧
toé	twe˨˦
tóe	twe˨˦
tơi	tɤj˧˧
tới	tɤj˨˦
tới	tɤj˨˦
tôi	toj˧˧
tối	toj˨˦
tồi	toj˧˨
tội	toj˨ˀ˩ʔ
toi	tɔj˧˧
tỏi	tɔj˧˩˨
tởm	tɤm˧˩˨
tôm	tom˧˧
tôm;	tom˧˧
tồm	tom˧˨
tom	tɔm˧˧
tóm	tɔm˨˦
tòm	tɔm˧˨
tỏm	tɔm˧˩˨
tông	toŋm˧˧
tống	toŋm˨˦
tồng	toŋm˧˨
tổng	toŋm˧˩˨
tong	tɔŋm˧˧
tòng	tɔŋm˧˨
tỏng	tɔŋm˧˩˨
tớn	tɤn˨˦
tợn	tɤn˨ˀ˩ʔ
tôn	ton˧˧
tốn	ton˨˦
tốn	ton˨˦
tồn	ton˧˨
tổn	ton˧˩˨
ton	tɔn˧˧
tòn	tɔn˧˨
toong	tɔŋm˧˧
toòng	tɔŋm˧˨
tô-pô	to˧˧-po˧˧
tốp	top˦˥
top	tɔp˧˧
tóp	tɔp˦˥
tô-tem	to˧˧-tɛm˧˧
tơ	tɤ˧˧
tớ	tɤ˨˦
tờ	tɤ˧˨
tở	tɤ˧˩˨
tô	to˧˧
tố	to˨˦
tồ	to˧˨
tổ	to˧˩˨
to	tɔ˧˧
tò	tɔ˧˨
tỏ	tɔ˧˩˨
tỏ	tɔ˧˩˨
tốt	tot˦˥
tốt	tot˦˥
tột	tot˨ˀ˩
tót	tɔt˦˥
tọt	tɔt˨ˀ˩
tra	ca˧˧
trá	ca˨˦
trà	ca˧˨
trả	ca˧˩˨
trả	ca˧˩˨
trác	cak˦˥
trắc	căk˦˥
trách	cɛk˦˥
trạch	cɛk˨ˀ˩
trai	caj˧˧
trái	caj˨˦
trài	caj˧˨
trải	caj˧˩˨
trại	caj˨ˀ˩ʔ
trám	cam˨˦
tràm	cam˧˨
trăm	căm˧˧
trắm	căm˨˦
trằm	căm˧˨
trảm	cam˧˩˨
trạm	cam˨ˀ˩ʔ
trâm	cɤ̆m˧˧
trầm	cɤ̆m˧˨
trẫm	cɤ̆m˧ˀ˥
trậm	cɤ̆m˨ˀ˩ʔ
trán	can˨˦
tràn	can˧˨
trăn	căn˧˧
trằn	căn˧˨
trân	cɤ̆n˧˧
trấn	cɤ̆n˨˦
trần	cɤ̆n˧˨
trận	cɤ̆n˨ˀ˩ʔ
trang	caŋ˧˧
tráng	caŋ˨˦
tráng	caŋ˨˦
tràng	caŋ˧˨
trăng	căŋ˧˧
trắng	căŋ˨˦
trằng	căŋ˧˨
trảng	caŋ˧˩˨
trạng	caŋ˨ˀ˩ʔ
trâng	cɤ̆ŋ˧˧
tranh	cɛŋ˧˧
tránh	cɛŋ˨˦
trao	caw˧˧
tráo	caw˨˦
trào	caw˧˨
trào	caw˧˨
trảo	caw˧˩˨
trập	cɤ̆p˨ˀ˩
trát	cat˦˥
trất	cɤ̆t˦˥
trật	cɤ̆t˨ˀ˩
trau	căw˧˧
trâu	cɤ̆w˧˧
trấu	cɤ̆w˨˦
trầu	cɤ̆w˧˨
trẩu	cɤ̆w˧˩˨
trày	căj˧˨
trây	cɤ̆j˧˧
trầy	cɤ̆j˧˨
trẩy	cɤ̆j˧˩˨
tréc	cɛk˦˥
trê	ce˧˧
trề	ce˧˨
trễ	ce˧ˀ˥
trệ	ce˨ˀ˩ʔ
tre	cɛ˧˧
tre	cɛ˧˧
trẻ	cɛ˧˩˨
trém	cɛm˨˦
trên	cen˧˧
trèn	cɛn˧˨
trẽn	cɛn˧ˀ˥
treo	ceo˧˧
treo	ceo˧˧
tréo	ceo˨˦
trèo	ceo˧˨
trẽo	ceo˧ˀ˥
trẹo	ceo˨ˀ˩ʔ
trết	cet˦˥
trệt	cet˨ˀ˩
trét	cɛt˦˥
trẹt	cɛt˨ˀ˩
trêu	cɛu˧˧
trếu	cɛu˨˦
trệu	cɛu˨ˀ˩ʔ
trích	cik˦˥
trịch	cik˨ˀ˩
tri	ci˧˧
trí	ci˨˦
trí	ci˨˦
trì	ci˧˨
trĩ	ci˧ˀ˥
trị	ci˨ˀ˩ʔ
triền	ciən˧˨
triển	ciən˧˩˨
triết	ciət˦˥
triệt	ciət˨ˀ˩
triêu	ciəw˧˧
triều	ciəw˧˨
triệu	ciəw˨ˀ˩ʔ
trinh	ciŋ˧˧
trình	ciŋ˧˨
trịnh	ciŋ˨ˀ˩ʔ
trìu	ciw˧˨
trĩu	ciw˧ˀ˥
trốc	cokp˦˥
trộc	cokp˨ˀ˩
tróc	cɔkp˦˥
trọc	cɔkp˨ˀ˩
trơ	cɤ˧˧
trớ	cɤ˨˦
trờ	cɤ˧˨
trở	cɤ˧˩˨
trợ	cɤ˨ˀ˩ʔ
trô	co˧˧
trổ	co˧˩˨
trỗ	co˧ˀ˥
tro	cɔ˧˧
trò	cɔ˧˨
trỏ	cɔ˧˩˨
trọ	cɔ˨ˀ˩ʔ
trời	cɤj˧˨
trời	cɤj˧˨
trôi	coj˧˧
trối	coj˨˦
trổi	coj˧˩˨
trỗi	coj˧ˀ˥
trội	coj˨ˀ˩ʔ
trói	cɔj˨˦
tròi	cɔj˧˨
trọi	cɔj˨ˀ˩ʔ
trộm	com˨ˀ˩ʔ
trộm	com˨ˀ˩ʔ
tróm	cɔm˨˦
tròm	cɔm˧˨
trơn	cɤn˧˧
trớn	cɤn˨˦
trờn	cɤn˧˨
trợn	cɤn˨ˀ˩ʔ
trôn	con˧˧
trốn	con˨˦
trộn	con˨ˀ˩ʔ
tròn	cɔn˧˨
tròn	cɔn˧˨
trọn	cɔn˨ˀ˩ʔ
trông	coŋm˧˧
trông	coŋm˧˧
trống	coŋm˨˦
trống	coŋm˨˦
trồng	coŋm˧˨
trong	cɔŋm˧˧
tróng	cɔŋm˨˦
tròng	cɔŋm˧˨
trọng	cɔŋm˨ˀ˩ʔ
trọng	cɔŋm˨ˀ˩ʔ
trớt	cɤt˦˥
trợt	cɤt˨ˀ˩
trót	cɔt˦˥
trưa	cɯə˧˧
trưa	cɯə˧˧
truân	cwɤ̆n˧˧
truất	cwɤ̆t˦˥
trúc	cukp˦˥
trục	cukp˨ˀ˩
trực	cɯk˨ˀ˩
tru	cu˧˧
trú	cu˨˦
trù	cu˧˨
trụ	cu˨ˀ˩ʔ
trứ	cɯ˨˦
trừ	cɯ˧˨
trữ	cɯ˧ˀ˥
trui	cuj˧˧
trùi	cuj˧˨
trụi	cuj˨ˀ˩ʔ
trùm	cum˧˨
trung	cuŋm˧˧
trúng	cuŋm˨˦
trùng	cuŋm˧˨
trủng	cuŋm˧˩˨
trưng	cɯŋ˧˧
trứng	cɯŋ˨˦
trứng	cɯŋ˨˦
trừng	cɯŋ˧˨
trước	cɯək˦˥
trước	cɯək˦˥
truông	cuəŋ˧˧
truồng	cuəŋ˧˨
trương	cɯəŋ˧˧
trướng	cɯəŋ˨˦
trường	cɯəŋ˧˨
trường	cɯəŋ˧˨
trưởng	cɯəŋ˧˩˨
trượng	cɯəŋ˨ˀ˩ʔ
trượt	cɯət˨ˀ˩
trút	cut˦˥
trừu	cɯw˧˨
trụy	cuj˨ˀ˩ʔ
truy	cwi˧˧
truỵ	cwi˨ˀ˩ʔ
truyền	cwiən˧˨
truyện	cwiən˨ˀ˩ʔ
tuân	twɤ̆n˧˧
tuấn	twɤ̆n˨˦
tuần	twɤ̆n˧˨
tuẫn	twɤ̆n˧ˀ˥
tua	tuə˧˧
tủa	tuə˧˩˨
từa	tɯə˧˨
tựa	tɯə˨ˀ˩ʔ
túc	tukp˦˥
tục	tukp˨ˀ˩
tức	tɯk˦˥
tuếch	twek˦˥
tuệch	twek˨ˀ˩
tuềnh	tweŋ˧˨
tuế	twe˨˦
tuệ	twe˨ˀ˩ʔ
túi	tuj˨˦
tủi	tuj˧˩˨
tụi	tuj˨ˀ˩ʔ
tum	tum˧˧
túm	tum˨˦
tùm	tum˧˨
tủm	tum˧˩˨
tụm	tum˨ˀ˩ʔ
tung	tuŋm˧˧
túng	tuŋm˨˦
tùng	tuŋm˧˨
tủng	tuŋm˧˩˨
tụng	tuŋm˨ˀ˩ʔ
tưng	tɯŋ˧˧
từng	tɯŋ˧˨
tun	tun˧˧
tủn	tun˧˩˨
tước	tɯək˦˥
tuổi	tuəj˧˩˨
tươi	tɯəj˧˧
tưới	tɯəj˨˦
tươm	tɯəm˧˧
tườm	tɯəm˧˨
tuồng	tuəŋ˧˨
tương	tɯəŋ˧˧
tướng	tɯəŋ˨˦
tường	tɯəŋ˧˨
tưởng	tɯəŋ˧˩˨
tượng	tɯəŋ˨ˀ˩ʔ
tuôn	tuən˧˧
tuồn	tuən˧˨
tuốt	tuət˦˥
tuột	tuət˨ˀ˩
tướt	tɯət˦˥
tườu	tɯəw˧˨
túp	tup˦˥
tụt	tut˨ˀ˩
tu	tu˧˧
tú	tu˨˦
tù	tu˧˨
tủ	tu˧˩˨
tụ	tu˨ˀ˩ʔ
tư	tɯ˧˧
tứ	tɯ˨˦
từ	tɯ˧˨
tử	tɯ˧˩˨
tự	tɯ˨ˀ˩ʔ
tửu	tɯw˧˩˨
tựu	tɯw˨ˀ˩ʔ
tuyên	twiən˧˧
tuyến	twiən˨˦
tuyền	twiən˧˨
tuyển	twiən˧˩˨
tuyết	twiət˦˥
tuyệt	twiət˨ˀ˩
tuýt	twit˦˥
túy	tuj˨˦
tùy	tuj˧˨
tủy	tuj˧˩˨
tụy	tuj˨ˀ˩ʔ
tuy	twi˧˧
tuý	twi˨˦
tuỳ	twi˧˨
tuỷ	twi˧˩˨
ty	ti˧˧
tỳ	ti˧˨
tỷ	ti˧˩˨
tỵ	ti˨ˀ˩ʔ
uẩn	wɤ̆n˧˩˨
uất	wɤ̆t˦˥
úa	uə˨˦
ùa	uə˧˨
ụa	uə˨ˀ˩ʔ
ưa	ɯə˧˧
ưa	ɯə˧˧
ứa	ɯə˨˦
úc	ukp˦˥
ục	ukp˨ˀ˩
ức	ɯk˦˥
uế	we˨˦
uể	we˧˩˨
ui	uj˧˧
úi	uj˨˦
ủi	uj˧˩˨
um	um˧˧
úm	um˨˦
ùm	um˧˨
ung	uŋm˧˧
úng	uŋm˨˦
ùng	uŋm˧˨
ủng	uŋm˧˩˨
ưng	ɯŋ˧˧
ứng	ɯŋ˨˦
ừng	ɯŋ˧˨
ửng	ɯŋ˧˩˨
un	un˧˧
ùn	un˧˨
ủn	un˧˩˨
ước	ɯək˦˥
ươi	ɯəj˧˧
uôm	uəm˧˧
ươm	ɯəm˧˧
ướm	ɯəm˨˦
uông	uəŋ˧˧
uống	uəŋ˨˦
uổng	uəŋ˧˩˨
ương	ɯəŋ˧˧
uốn	uən˨˦
ươn	ɯən˧˧
ưỡn	ɯən˧ˀ˥
ướp	ɯəp˦˥
ướt	ɯət˦˥
úp	up˦˥
út	ut˦˥
ụt	ut˨ˀ˩
u	u˧˧
ú	u˨˦
ù	u˧˨
ủ	u˧˩˨
ưu	ɯw˧˧
ụ	u˨ˀ˩ʔ
ư	ɯ˧˧
ư	ɯ˧˧
ứ	ɯ˨˦
ừ	ɯ˧˨
ừ	ɯ˧˨
uyên	wiən˧˧
uyển	wiən˧˩˨
uỳnh	wiŋ˧˨
ủy	uj˧˩˨
uy	wi˧˧
uý	wi˨˦
uỷ	wi˧˩˨
vách	vɛk˦˥
vạch	vɛk˨ˀ˩
vác	vak˦˥
vạc	vak˨ˀ˩
vặc	văk˨ˀ˩
vai	vaj˧˧
vái	vaj˨˦
vài	vaj˧˨
vải	vaj˧˩˨
vãi	vaj˧ˀ˥
vàm	vam˧˨
vằm	văm˧˨
vạm	vam˨ˀ˩ʔ
vậm	vɤ̆m˨ˀ˩ʔ
vang	vaŋ˧˧
vang	vaŋ˧˧
váng	vaŋ˨˦
vàng	vaŋ˧˨
văng	văŋ˧˧
vắng	văŋ˨˦
vằng	văŋ˧˨
vãng	vaŋ˧ˀ˥
vâng	vɤ̆ŋ˧˧
vầng	vɤ̆ŋ˧˨
vanh	vɛŋ˧˧
vành	vɛŋ˧˨
van	van˧˧
ván	van˨˦
vàn	van˧˨
văn	văn˧˧
vắn	văn˨˦
vằn	văn˧˨
vãn	van˧ˀ˥
vạn	van˨ˀ˩ʔ
vặn	văn˨ˀ˩ʔ
vân	vɤ̆n˧˧
vấn	vɤ̆n˨˦
vần	vɤ̆n˧˨
vẩn	vɤ̆n˧˩˨
vẫn	vɤ̆n˧ˀ˥
vận	vɤ̆n˨ˀ˩ʔ
vào	vaw˧˨
vấp	vɤ̆p˦˥
vập	vɤ̆p˨ˀ˩
vắt	văt˦˥
vạt	vat˨ˀ˩
vặt	văt˨ˀ˩
vất	vɤ̆t˦˥
vật	vɤ̆t˨ˀ˩
va	va˧˧
vá	va˨˦
và	va˧˨
vả	va˧˩˨
vã	va˧ˀ˥
vạ	va˨ˀ˩ʔ
vạ	va˨ˀ˩ʔ
vay	văj˧˧
váy	văj˨˦
vày	văj˧˨
vảy	văj˧˩˨
vạy	văj˨ˀ˩ʔ
vây	vɤ̆j˧˧
vấy	vɤ̆j˨˦
vầy	vɤ̆j˧˨
vẫy	vɤ̆j˧ˀ˥
vậy	vɤ̆j˨ˀ˩ʔ
véc	vɛk˦˥
vẹc	vɛk˨ˀ˩
vênh	veŋ˧˧
vểnh	veŋ˧˩˨
vên	ven˧˧
vền	ven˧˨
ven	vɛn˧˧
vén	vɛn˨˦
vẻn	vɛn˧˩˨
vẹn	vɛn˨ˀ˩ʔ
veo	veo˧˧
véo	veo˨˦
vèo	veo˧˨
vẹo	veo˨ˀ˩ʔ
vết	vet˦˥
vét	vɛt˦˥
vẹt	vɛt˨ˀ˩
vêu	vɛu˧˧
vê	ve˧˧
về	ve˧˨
vệ	ve˨ˀ˩ʔ
ve	vɛ˧˧
vé	vɛ˨˦
vè	vɛ˧˨
vẻ	vɛ˧˩˨
vẽ	vɛ˧ˀ˥
vía	viə˨˦
vỉa	viə˧˩˨
vi-đê-ô	vi˧˧-de˧˧-o˧˧
việc	viək˨ˀ˩
viêm	viəm˧˧
viêng	viəŋ˧˧
viếng	viəŋ˨˦
viên	viən˧˧
viên;	viən˧˧
viển	viən˧˩˨
viễn	viən˧ˀ˥
viện	viən˨ˀ˩ʔ
việt-nam	viət˨ˀ˩-nam˧˧
viết	viət˦˥
việt	viət˨ˀ˩
vinh	viŋ˧˧
vĩnh	viŋ˧ˀ˥
vin	vin˧˧
vi-rút	vi˧˧-zut˦˥
vịt	vit˨ˀ˩
vi	vi˧˧
ví	vi˨˦
vì	vi˧˨
vỉ	vi˧˩˨
vĩ	vi˧ˀ˥
vị	vi˨ˀ˩ʔ
vóc	vɔkp˦˥
vọc	vɔkp˨ˀ˩
vơi	vɤj˧˧
với	vɤj˨˦
vời	vɤj˧˨
vôi	voj˧˧
vôi	voj˧˧
vồi	voj˧˨
vội	voj˨ˀ˩ʔ
voi	vɔj˧˧
vòi	vɔj˧˨
vòm	vɔm˧˨
vông	voŋm˧˧
vông	voŋm˧˧
vong	vɔŋm˧˧
vòng	vɔŋm˧˨
võng	vɔŋm˧ˀ˥
vọng	vɔŋm˨ˀ˩ʔ
vọng	vɔŋm˨ˀ˩ʔ
vôn	von˧˧
vốn	von˨˦
vồn	von˧˨
von	vɔn˧˧
vòn	vɔn˧˨
vỏn	vɔn˧˩˨
voọc	vɔkp˨ˀ˩
vọp	vɔp˨ˀ˩
vớt	vɤt˦˥
vót	vɔt˦˥
vọt	vɔt˨ˀ˩
vơ	vɤ˧˧
vớ	vɤ˨˦
vờ	vɤ˧˨
vở	vɤ˧˩˨
vỡ	vɤ˧ˀ˥
vợ	vɤ˨ˀ˩ʔ
vô	vo˧˧
vồ	vo˧˨
vỗ	vo˧ˀ˥
vo	vɔ˧˧
vó	vɔ˨˦
vó	vɔ˨˦
vò	vɔ˧˨
vỏ	vɔ˧˩˨
võ	vɔ˧ˀ˥
vọ	vɔ˨ˀ˩ʔ
vua	vuə˧˧
vùa	vuə˧˨
vừa	vɯə˧˨
vữa	vɯə˧ˀ˥
vựa	vɯə˨ˀ˩ʔ
vúc	vukp˦˥
vực	vɯk˨ˀ˩
vui	vuj˧˧
vùi	vuj˧˨
vung	vuŋm˧˧
vùng	vuŋm˧˨
vũng	vuŋm˧ˀ˥
vụng	vuŋm˨ˀ˩ʔ
vụng	vuŋm˨ˀ˩ʔ
vừng	vɯŋ˧˨
vững	vɯŋ˧ˀ˥
vựng	vɯŋ˨ˀ˩ʔ
vun	vun˧˧
vùn	vun˧˨
vụn	vun˨ˀ˩ʔ
vuông	vuəŋ˧˧
vương	vɯəŋ˧˧
vướng	vɯəŋ˨˦
vượng	vɯəŋ˨ˀ˩ʔ
vươn	vɯən˧˧
vườn	vɯən˧˨
vượn	vɯən˨ˀ˩ʔ
vuốt	vuət˦˥
vuột	vuət˨ˀ˩
vượt	vɯət˨ˀ˩
vút	vut˦˥
vụt	vut˨ˀ˩
vứt	vɯt˦˥
vưu	vɯw˧˧
vu	vu˧˧
vú	vu˨˦
vù	vu˧˨
vũ	vu˧ˀ˥
vụ	vu˨ˀ˩ʔ
vy	vi˧˧
xách	sɛk˦˥
xạch	sɛk˨ˀ˩
xác	sak˦˥
xắc	săk˦˥
xạc	sak˨ˀ˩
xấc	sɤ̆k˦˥
xái	saj˨˦
xài	saj˧˨
xam	sam˧˧
xám	sam˨˦
xàm	sam˧˨
xăm	săm˧˧
xắm	săm˨˦
xâm	sɤ̆m˧˧
xầm	sɤ̆m˧˨
xẩm	sɤ̆m˧˩˨
xậm	sɤ̆m˨ˀ˩ʔ
xàng	saŋ˧˨
xăng	săŋ˧˧
xằng	săŋ˧˨
xẵng	săŋ˧ˀ˥
xanh	sɛŋ˧˧
xành	sɛŋ˧˨
xán	san˨˦
xăn	săn˧˧
xắn	săn˨˦
xẩn	sɤ̆n˧˩˨
xao	saw˧˧
xáo	saw˨˦
xào	saw˧˨
xảo	saw˧˩˨
xáp	sap˦˥
xấp	sɤ̆p˦˥
xập	sɤ̆p˨ˀ˩
xa	sa˧˧
xa	sa˧˧
xá	sa˨˦
xà	sa˧˨
xả	sa˧˩˨
xã	sa˧ˀ˥
xạ	sa˨ˀ˩ʔ
xát	sat˦˥
xạu	săw˨ˀ˩ʔ
xâu	sɤ̆w˧˧
xấu	sɤ̆w˨˦
xầu	sɤ̆w˧˨
xay	săj˧˧
xảy	săj˧˩˨
xây	sɤ̆j˧˧
xẩy	sɤ̆j˧˩˨
xếch	sek˦˥
xệch	sek˨ˀ˩
xềm	sem˧˨
xem	sɛm˧˧
xẻng	sɛŋ˧˩˨
xênh	seŋ˧˧
xềnh	seŋ˧˨
xen	sɛn˧˧
xén	sɛn˨˦
xèn	sɛn˧˨
xẻn	sɛn˧˩˨
xeo	seo˧˧
xéo	seo˨˦
xèo	seo˧˨
xẹo	seo˨ˀ˩ʔ
xếp	sep˦˥
xép	sɛp˦˥
xẹp	sɛp˨ˀ˩
xê	se˧˧
xế	se˨˦
xề	se˧˨
xe	sɛ˧˧
xé	sɛ˨˦
xè	sɛ˧˨
xẻ	sɛ˧˩˨
xét	sɛt˦˥
xều	sɛu˧˨
xệu	sɛu˨ˀ˩ʔ
xỉa	siə˧˩˨
xích	sik˦˥
xiêm	siəm˧˧
xiểm	siəm˧˩˨
xiềng	siəŋ˧˨
xiểng	siəŋ˧˩˨
xiên	siən˧˧
xiển	siən˧˩˨
xiết	siət˦˥
xiêu	siəw˧˧
xiếu	siəw˨˦
xinh	siŋ˧˧
xính	siŋ˨˦
xình	siŋ˧˨
xin	sin˧˧
xín	sin˨˦
xi	si˧˧
xí	si˨˦
xì	si˧˨
xỉ	si˧˩˨
xị	si˨ˀ˩ʔ
xít	sit˦˥
xíu	siw˨˦
xìu	siw˧˨
xỉu	siw˧˩˨
xịu	siw˨ˀ˩ʔ
xoạc	swak˨ˀ˩
xoai	swaj˧˧
xoài	swaj˧˨
xoang	swaŋ˧˧
xoàng	swaŋ˧˨
xoành	swɛŋ˧˨
xoan	swan˧˧
xoàn	swan˧˨
xoăn	swăn˧˧
xoắn	swăn˨˦
xoẳn	swăn˧˩˨
xoa	swa˧˧
xoá	swa˨˦
xoay	swăj˧˧
xoáy	swăj˨˦
xốc	sokp˦˥
xộc	sokp˨ˀ˩
xóc	sɔkp˦˥
xọc	sɔkp˨ˀ˩
xoen	swen˧˧
xoèn	swen˧˨
xơi	sɤj˧˧
xới	sɤj˨˦
xởi	sɤj˧˩˨
xôi	soj˧˧
xôi	soj˧˧
xối	soj˨˦
xổi	soj˧˩˨
xoi	sɔj˧˧
xói	sɔj˨˦
xờm	sɤm˧˨
xôm	som˧˧
xồm	som˧˨
xom	sɔm˧˧
xóm	sɔm˨˦
xòm	sɔm˧˨
xông	soŋm˧˧
xống	soŋm˨˦
xồng	soŋm˧˨
xổng	soŋm˧˩˨
xong	sɔŋm˧˧
xòng	sɔŋm˧˨
xỏng	sɔŋm˧˩˨
xõng	sɔŋm˧ˀ˥
xơn	sɤn˧˧
xớn	sɤn˨˦
xôn	son˧˧
xốn	son˨˦
xồn	son˧˨
xổn	son˧˩˨
xộn	son˨ˀ˩ʔ
xon	sɔn˧˧
xoong	sɔŋm˧˧
xợp	sɤp˨ˀ˩
xốp	sop˦˥
xóp	sɔp˦˥
xơ	sɤ˧˧
xớ	sɤ˨˦
xờ	sɤ˧˨
xô	so˧˧
xổ	so˧˩˨
xo	sɔ˧˧
xó	sɔ˨˦
xỏ	sɔ˧˩˨
xọ	sɔ˨ˀ˩ʔ
xớt	sɤt˦˥
xốt	sot˦˥
xót	sɔt˦˥
xô-viết	so˧˧-viət˦˥
xuân	swɤ̆n˧˧
xuẩn	swɤ̆n˧˩˨
xua	suə˧˧
xưa	sɯə˧˧
xưa	sɯə˧˧
xửa	sɯə˧˩˨
xuất	swɤ̆t˦˥
xuất	swɤ̆t˦˥
xúc	sukp˦˥
xục	sukp˨ˀ˩
xức	sɯk˦˥
xuệch	swek˨ˀ˩
xuềnh	sweŋ˧˨
xuê	swe˧˧
xuề	swe˧˨
xui	suj˧˧
xúi	suj˨˦
xụi	suj˨ˀ˩ʔ
xum	sum˧˧
xúm	sum˨˦
xùm	sum˧˨
xung	suŋm˧˧
xúng	suŋm˨˦
xùng	suŋm˧˨
xủng	suŋm˧˩˨
xưng	sɯŋ˧˧
xứng	sɯŋ˨˦
xửng	sɯŋ˧˩˨
xun	sun˧˧
xước	sɯək˦˥
xuôi	suəj˧˧
xuôi	suəj˧˧
xười	sɯəj˧˨
xuống	suəŋ˨˦
xuống	suəŋ˨˦
xuồng	suəŋ˧˨
xương	sɯəŋ˧˧
xướng	sɯəŋ˨˦
xường	sɯəŋ˧˨
xưởng	sɯəŋ˧˩˨
xúp	sup˦˥
xu	su˧˧
xú	su˨˦
xù	su˧˨
xủ	su˧˩˨
xụ	su˨ˀ˩ʔ
xứ	sɯ˨˦
xử	sɯ˧˩˨
xuyên	swiən˧˧
xuy	swi˧˧
xuý	swi˨˦
xuýt	swit˦˥
yêm	iɛm˧˧
yếm	iɛm˨˦
yểm	iɛm˧˩˨
yêng	iɛŋ˧˧
yểng	iɛŋ˧˩˨
yên	iɛn˧˧
yến	iɛn˨˦
yết	iɛt˦˥
yêu	iəw˧˧
yếu	iəw˨˦
yểu	iəw˧˩˨
y	i˧˧
y	i˧˧
ý	i˨˦
ý	i˨˦
ỷ	i˧˩˨
