a	a
aaba	aːba
aad	aːd
aadiens	aːdiens
aaf	aːf
aafwe	aːfwe
aagan	aːgan
aaganizieshan	aːganizɪɛʃan
aaganizm	aːganizm̩
aagas	aːgas
aagiment	aːgiment
aajentiina	aːdʒentiːna
aakid	aːkid
aal	aːl
aalmuos	aːlmuɔs
aalwiez	aːlwɪɛz
aarait	aːɹaɪt
aaredi	aːɹedi
aas	aːs
aas-riesin	aːsɹɪɛsin
aat	aːt
aata	aːta
aatagrafi	aːtagɹafi
aatiek	aːtɪɛk
aatis	aːtis
aawez	aːwez
aazwiez	aːzwɪɛz
ab	ab
abee	abeː
abov	abov
abraad	abɹaːd
achrakshan	atʃɹakʃan
achribyut	atʃɹibjut
ada	ada
adaels	adaels
adawaiz	adawaɪz
adminischrietiv	administʃɹɪɛtiv
advokiet	advokɪɛt
afrika	afɹika
afta	afta
agen	agen
agrikolcha	agɹikoltʃa
agrikolcharal	agɹikoltʃaɹal
agyu	aɟu
ahn	ã
ai	aɪ
aida	aɪda
aidentifai	aɪdentifaɪ
aidentiti	aɪdentiti
aidie	aɪdie
aigl	aɪgl̩
aijrosfier	aɪdʒɹosfɪɛɹ
ail	aɪl
ailan	aɪlan
ailant	aɪlant
airilan	aɪɹilan
airish	aɪɹiʃ
ais	aɪs
aiskriim	aɪskɹiːm
aisoliet	aɪsolɪɛt
ait	aɪt
aiyan	aɪjan
aizak	aɪzak
ajres	adʒɹes
aki	aki
akliem	aklɪɛm
aknalij	aknalidʒ
akraas	akɹaːs
aktivis	aktivis
aktuoba	aktuɔba
ala	ala
alaiv	alaɪv
alayans	alajans
alduo	alduɔ
aligeta	aligeta
aligzanda	aligzanda
aliv	aliv
amerika	amɛɹɪka
amfisbiinyan	amfisbiːɲan
amtan	amtan
ana	ana
an	an
anarebl	anaɹebl̩
anda	anda
andastan	andastan
aneda	aneda
anju	andʒu
anlain	anlaɪn
anles	anles
anmigl	anmigl̩
ansa	ansa
ansofistikietid	ansofistikɪɛtid
antiiga	antiːga
antuoni	antuɔni
anuova	anuova
anz	anz
apaat	apaːt
apaint	apaɪnt
api	api
apier	apɪɛɹ
aplai	aplaɪ
apl	apl̩
apm	apm̩
aprishiet	apɹiʃɪɛt
apruoch	apɹuɔtʃ
apruuv	apɹuːv
ar	aɹ
aredi	aɹedi
ariebia	aɹɪɛbja
arinj	aɹindʒ
asaalt	asaːlt
aschranami	astʃɹanami
aschranomi	astʃɹanomi
aschrielia	astʃɹɪɛlja
askaadn	askaːdn̩
aspital	aspital
at	at
atlantik	atlantik
atletix	atletiks
atmosfier	atmosfɪɛɹ
aul	aul
avielobl	avɪɛlobl̩
awie	awɪɛ
ax	aks
axep	aksep
axtiel	akstɪɛl
aya	aja
az	az
azwel	azwel
ba'aamaz	ba'aːmaz
baaba	baːba
baabiedoz	baːbɪɛdoz
baabyuuda	baːbjuːda
baagin	baːgin
baal	baːl
baan	baːn
baara	baːɹa
baas	baːs
baaskitbaal	baːskitbaːl
baat	baːt
baazli	baːzli
bada	bada
badarieshan	badaɹɪɛʃan
bad	bad
badi	badi
badman	badman
bai	baɪ
baik	baɪk
bailoji	baɪlodʒi
bait	baɪt
baka	baka
bakbuon	bakbuɔn
bakl	bakl̩
bami	bamɪ
banaana	banaːna
ban	ban
banit	banit
baptis	baptis
batam	batam
batn	batn̩
baul	baul
bax	baks
baxin	baksin
baya	baya
bayagrafi	bajagɹafi
bayosfier	bajosfɪɛɹ
beg	beg
bekaa	bekaː
bel	bel
beli	beli
ben	ben
bex	beks
biebi	bɪɛbi
bie	bɪɛ
bied	bɪɛd
biefies	bɪɛfɪɛs
biej	bɪɛdʒ
biek	bɪɛk
bier	bɪɛɹ
bies	bɪɛs
biesik	bɪɛsik
biesin	bɪɛsin
biev	bɪɛv
bifuo	bifuɔ
bifuor	bifuɔɹ
bifuotaim	bifuɔtaɪm
bigop	bɪgop
biif	biːl
biin	biːn
biini	biːni
biis	biːs
bikaazn	bikaːzn̩
bilang	bilaŋ
bil	bil
biyain	bijaɪn
bizniz	bizniz
blai	blaɪ
blak	blak
blingki	bliŋki
bluu	bluː
bod	bod
bokl	bokl̩
bon	bon
bongjri	boŋdʒɹi
bongx	boŋks
bota	bota
bot	bot
botn	botn̩
bou	bɔu
bout	bɔut
braad	bɹaːd
braatopsi	bɹaːtopsi
brazil	bɹazil
breda	bɹeda
bred	bɹed
bredfruut	bɹedfɹuːt
brejrin	bɹedʒɹin
briekop	bɹɪɛkop
briev	bɹɪɛv
bring	bɹiŋ
bringgl	bɹiŋgl̩
britn	bɹitn
brok	bɹok
broun	bɹɔun
bruus	bɹuːs
buk	buk
bulfraag	bulfɹaːg
buod	buɔd
buodn	buɔdn̩
buot	buɔt
bush	buʃ
buut	buːt
bwai	bwaɪ
bwail	bwaɪl
byuuno	bjuːno
byuuti	bjuːti
chaaj	tʃaːdʒ
chaaklit	tʃaːklit
chaali	tʃaːli
chaina	tʃaɪna
chais	tʃaɪs
chaka-chaka	tʃakatʃaka
chat	tʃat
cheri	tʃeɹi
ches	tʃes
chichi	tʃitʃi
chienj	tʃɪɛndʒ
chiiz	tʃiːz
chikin	tʃikin
chobl	tʃobl̩
choch	tʃotʃ
chokcha	tʃoktʃa
chostii	tʃostiː
chos	tʃos
cho	tʃo
chrabl	tʃɹabl̩
chradishan	tʃɹadiʃan
chrai	tʃɹaɪ
chrajidi	tʃɹadʒidi
chrang	tʃɹaŋ
chranzfaam	tʃɹanzfaːm
chranzishan	tʃɹanziʃan
chranznashinal	tʃɹanznaʃinal
chrapikal	tʃɹapikal
chrapik	tʃɹapik
chrap	tʃɹap
chrecha	tʃɹetʃa
chrech	tʃɹetʃ
chrent	tʃɹent
chretn	tʃɹetn̩
chried	tʃɹɪɛd
chrienin	tʃɹɪɛnin
chrienja	tʃɹɪɛndʒa
chrien	tʃɹɪɛn
chriet	tʃɹɪɛt
chriiti	tʃɹiːti
chrii	tʃɹiː
chriit	tʃɹiːt
chrikifai	tʃɹikifaɪ
chrik	tʃɹik
chrilaani	tʃɹilaːni
chrinidad	tʃɹinidad
chrompit	tʃɹompit
chruu	tʃɹuː
chuocho	tʃuɔtʃo
chuochuo	tʃuɔtʃuɔ
chupid	tʃupid
chuu-chuu	tʃuːtʃuː
chuuhout	tʃuːhɔut
chuun	tʃuːn
chuu	tʃuː
chuut	tʃuːt
chuuz	tʃuːz
daa	daː
daag	daːg
daans	daːns
daata	daːta
da	da
dahn	dã
dailuut	daɪluːt
dainasuor	daɪnasuɔɹ
dairek	daɪɹek
dala	dala
daminiika	daminiːka
daminikan	daminikan
danal	danal
dangki	daŋki
darati	daɹati
dash	daʃ
dashiin	daʃiːn
dat	dat
dat-de	datde
dayalek	dajalek
dayaspora	dajaspoɹa
dayatishan	dajatiʃan
debl	debl̩
ded	ded
de	de
definishan	definiʃan
dehn	dẽ
dehn	dehn
dekied	dekɪɛd
demakrasi	demakɹasi
dem-de	demde
dem	dem
dem-ya	demja
dep	dep
derik	deɹik
deso	deso
dezat	dezat
dibiet	dibɪɛt
di	di
die	dɪɛ
dieli	dɪɛli
dievid	dɪɛvid
difiit	difiːt
difikolti	difikolti
difrahn	difɹã
difrans	difɹans
digrii	digɹiː
diil	diːl
diklier	diklɪɛɹ
diktieta	diktɪɛta
diktietaship	diktɪɛtaʃip
dimokratizieshan	dimokɹatizɪɛʃan
dipaacha	dipaːtʃa
dipen	dipen
disaid	disaɪd
disaya	disaja
dischribyuushan	distʃɹibjuːʃan
dis	dis
disemba	disemba
disendant	disendant
disepshos	dɪsepʃos
disgostid	disgostid
diskovri	diskovɹi
distingshan	distiŋʃan
dis-ya	disja
ditiel	ditɪɛl
divaid	divaɪd
dizain	dizaɪn
dizort	dizoɹt
domestikieshan	domestikɪɛʃan
domplin	domplin
dong	doŋ
dopi	dopɪ
dos	dos
doti	doti
dout	dɔut
drop	dɹop
dukunu	dukunu
duo	duɔ
duohn	duõ
duor	duɔɹ
dwiit	dwiːt
dyuu	djuː
ebi	ebi
ebn	ebn̩
ebribadi	ebɹibadi
ebri	ebɹi
ebriting	ebɹitiŋ
ed	ed
edikieshan	edikɪɛʃan
edita	edita
Edwad	edwad
ef	ef
egvaantij	egvaːntidʒ
egzakli	egzakli
egzamin	egzamin
egzampl	egzampl̩
egzis	egzis
Eliat	eliat
eliment	eliment
elivieta	elivɪɛta
elp	elp
els	els
elswe	elswe
enaji	enadʒi
en	en
enibadi	enibadi
eniebl	enɪɛbl̩
eni	eni
enitaim	enɪtaɪm
eniwiez	eniwɪɛz
entapraiz	entapɹaɪz
eritij	eɹitidʒ
esn	esn̩
evidens	evidens
evri	evɹi
exchienj	ekstʃɪɛndʒ
exchriim	ekstʃɹiːm
exepshan	eksepʃan
exkiep	ekskɪɛp
exkluudn	ekskluːdn̩
expanshan	ekspanʃan
expiriens	ekspiɹɪɛns
expuot	ekspuɔt
extablish	ekstabli
extingk	ekstiŋk
faada	faːda
faal	faːl
faama	faːma
faamat	faːmat
faam	faːm
faam	faːma
faar	faːɹ
faas	faːs
faatifikieshan	faːtifikɪɛʃan
fa	fa
fagivnis	fagivnis
faib	faɪb
fainal	faɪnal
fain	faɪn
faiya	faɪja
faiyaman	faɪjaman
fak	fak
fala	fala
falara	falaɹa
falarin	falaɹin
falmot	falmot
fambli	fambli
farina	faɹina
farin	faɹin
fasilitiet	fasilitɪɛt
faya	faja
febiweri	febiweɹi
feda	feda
feminis	feminis
feminizim	feminizim
fene	fene
fens	fens
fiemos	fɪɛmos
fies	fɪɛs
fiesti	fɪɛsti
fiet	fɪɛt
fieva	fieva
fif	fif
fi	fi
fiftiin	fiftiːn
figa	figa
figat	figat
fiicha	fiːtʃa
fiil	fiːl
fiimiel	fiːmɪɛl
fiiva	fiːva
fikshan	fikʃan
filasafi	filasafi
filipiinz	filipiːnz
finaminan	finaminan
finanshal	finanʃal
fingga	fiŋga
fingga-hed	fiŋgahed
fiziolaji	fizioladʒi
fizishan	fiziʃan
fizix	fiziks
flai	flaɪ
flieva	flɪɛva
flim	flim
flod	flod
flowa	flowa
fluor	fluɔɹ
fongkshan	foŋkʃan
foris	foɹis
form	foɹm
fos	fos
foul	foul
fraag	fɹaːg
frahn	fɹã
frai	fɹaɪ
fraitn	fɹaɪtn̩
frans	fɹans
frenship	fɹenʃip
fruut	fɹuːt
fufu	fufu
ful	ful
fuo	fuɔ
fuokos	fuɔkos
fuos	fuɔs
fuot	fuɔt
fuotiin	fuɔtiːn
futbaal	futbaːl
fut	fut
fuud	fuːd
fyuil	fjuil
fyuu	fjuː
gaa	gaː
galang	galaŋ
gens	gens
get	get
gien	gɪɛn
giet	gɪɛt
ginep	ginep
gluobal	gluɔbal
gobna	gobna
gobna-jinaral	gobnadʒinaɹal
go	go
golibl	golibl̩
goli	golɪ
gon	gon
govament	govament
graasapa	gɹaːsapa
grampierans	gɹampɪɛɹans
grenidiinz	gɹenidiːnz
griep	gɹɪɛp
griet	gɹɪɛt
grietis	gɹɪɛtis
grii	gɹiː
griin	gɹiːn
griis	gɹiːs
grinieda	gɹinɪɛda
grong	gɹoŋ
gruo	gɹuɔ
gruot	gɹuɔt
gud	gud
gudz	gudz
gunggu	guŋgu
guol	guɔl
guot	guɔt
guzu	guzu
gwaava	gwaːva
gwan	gwan
gyaad	ɟaːd
gyaadn	ɟaːdn̩
gyaalik	ɟaːlik
gyada	ɟada
gyadarin	ɟadaɹin
gyal	ɟal
gyas	ɟas
haakiek	haːkɪɛk
haalzwie	haːlzwɪɛ
haatagrafi	haːtagɹafi
haatikl	haːtikl̩
haatis	haːtis
habrij	habɹidʒ
habvios	habvios
hada	hada
hadap	hadap
hadvenchara	hadventʃaɹa
hafi	hafi
haid	haɪd
hairish	haɪɹiʃ
hambrela	hambɹela
hanalisis	hanalisis
hanimal	hanimal
harijin	haɹidʒin
hat	hat
hatityuud	hatitjuːd
haxent	haksent
haxesobl	haksesobl̩
haxpek	hakspek
hayan	hajan
hayan-mekin	hajanmekin
haz	haz
hebini	hebini
hebm	hebm̩
hedituoryal	hedituɔɹjal
heg	heg
hels	hels
hen	hen
heni	heni
heniting	henitiŋ
hexpand	hekspand
hexplien	heksplɪɛn
hexpreshan	hekspɹeʃan
hexten	heksten
hextingk	hekstiŋk
hidyam	hidjam
hieja	hɪɛdʒa
hiem	hɪɛm
hiet	hɪɛt
hietiin	hɪɛtiːn
hifek	hifek
higla	higla
hiit	hiːt
hiiz	hiːz
hilekchranik	hilektʃɹanik
himpres	himpɹes
hinchradokshan	hintʃɹadokʃan
hinchrajuus	hintʃɹadʒuːs
hinchres	hintʃɹes
hinfluens	hinfluens
hingglish	hiŋgliʃ
hinishal	hiniʃal
hinkluudn	hinkluːdn̩
hintanashinal	hintanaʃinal
hofishal	hofiʃal
honggl	hoŋgl̩
honggri	hoŋgɹi
honyan	hoɲan
hopin-en	hopinen
horbanizieshan	hoɹbanizɪɛʃan
hori	hoɹi
horli	hoɹli
howa	howa
hox	hoks
huobaluk	huɔbaluk
huol	huɔl
huoliip	huɔliːp
huol-taima	huɔltaɪma
huoral	huɔɹal
huovn	huɔvn̩
iebl	ɪɛbl̩
ieda	ɪɛda
ie	ɪɛ
ieja	ɪɛdʒa
iej	ɪɛdʒ̩
iejobl	ɪɛdʒobl̩
iel	ɪɛl
iemi	ɪɛmi
ienshent	ɪɛnʃent
iepril	ɪɛpɹil
ieria	ɪɛɹia
ier	ɪɛɹ
ies	ɪɛs
ietiin	ɪɛtiːn
ieti	ɪɛti
iet	ɪɛt
iezha	ɪɛʒa
iez	iez
ifainali	ifaɪnali
ifek	ifek
igwaana	igwaːna
ihn	ĩ
iibm	iːbm̩
iibn	iːbn̩
iihn	ĩː
iijip	iːdʒip
iikwal	iːkwal
iin	iːn
iip	iːp
iir	iːɹ
iis	iːs
iistan	iːstan
iit	iːt
iivn	iːvn̩
iivnin	iːvnin
ikanami	ikanami
ikanamik	ikanamik
ikanamix	ikanamiks
ilek	ilek
ilizibet	ilizibet
iloschrieshan	ilostʃɹɪɛʃan
im	im
impak	impak
impruuv	impɹuːv
impuotant	impuɔtant
imuoshan	imuɔʃan
inaamos	inaːmos
inabit	inhabit
ina	ina
indiiz	indiːz
indipendans	indipendans
indischroktebl	indistʃɹoktebl̩
indoschrial	indostʃɹial
indoschrializieshan	indostʃɹializɪɛʃan
indoschri	indostʃɹi
infamieshan	infamɪɛʃan
influens	influens
inggiej	iŋgɪɛdʒ
ingglan	iŋglan
ingkluudn	iŋkluːdn̩
ingkorij	iŋkoɹidʒ
iniebl	inɪɛbl̩
in	in
injai	indʒaɪ
injinierin	indʒinɪɛɹin
inkluud	inkluːd
inkriis	inkɹiːs
inruol	inɹuɔl
insaiklopiidya	insaɪklopiːdja
inspaya	inspaya
intaikl	intaɪkl̩
intanashinal	intanaʃinal
intanet	intanet
intatiena	intatɪɛna
invalv	invalv
inviejan	invɪɛdʒan
ischri	istʃɹi
iself	ɪself
ishu	iʃhu
istuorian	istuɔɹian
itali	itali
it	it
ivalv	ivalv
ivenchuali	iventʃuali
ivent	ivent
jaagrafi	dʒaːgɹafi
jaagrofi	dʒaːgɹofi
jaaj	dʒaːdʒ
jaaloji	dʒaːlodʒi
jain	dʒaɪn
jainop	dʒaɪnop
jakfruut	dʒakfɹuːt
jaloji	dʒalodʒi
jan	dʒan
jangkro	dʒaŋkɹo
janiweri	dʒaniweɹi
japan	dʒapan
jeliduo	dʒeliduɔ
jeli	dʒeli
jiel	dʒɪɛl
jiemz	dʒɪɛmz
jien	dʒɪɛn
jinaral	dʒinaɹal
jinarasiti	dʒinaɹasiti
jinarieshan	dʒinaɹɪɛʃan
jinja	dʒindʒa
joj	dʒodʒ
jomp	dʒomp
jomp-up	dʒompop
jonjo	dʒondʒo
jork	dʒoɹk
jormani	joɹmani
jornal	dʒoɹnal
jostis	dʒostis
jraadong	dʒɹaːdoŋ
jraa	dʒɹaː
jraaf	dʒɹaːf
jraafut	dʒɹaːfut
jraaz	dʒɹaːz
jragan	dʒɹagan
jrai	dʒɹaɪ
jramatik	dʒɹamatik
jrap	dʒɹap
jred	dʒɹed
jresbak	dʒɹesbak
jresdong	dʒɹesdoŋ
jres	dʒɹes
jriepop	dʒɹɪɛpop
jringk	dʒɹiŋk
jrog	dʒɹog
jrom	dʒɹom
juk	dʒuk
juki-juki	dʒukidʒuki
julai	dʒulaɪ
jumieka	dʒumɪɛka
jumieka	jumɪɛka
junjo	dʒundʒo
juo	dʒuɔ
juok	dʒuɔk
juu	dʒuː
juun	dʒuːn
juurin	dʒuːɹin
juus	dʒuːs
kaa	kaː
kaali	kaːli
kaal	kaːl
kaanful	kaːnful
kaan	kaːn
kaanwal	kaːnwal
kaaz	kaːz
kaazn	kaːzn̩
kach	katʃ
kain	kaɪn
kait	kaɪt
kak	kak
kala	kala
kalalu	kalalu
kalani	kalani
kalanis	kalanis
kalek	kalek
kalekshan	kalekʃan
kalij	kalɪdʒ
kaman	kaman
kamedi	kamedi
kanchosnis	kantʃosnis
kanchrak	kantʃɹak
kanchuol	kantʃuɔl
kanekshan	kanekʃan
kanschrokshan	kanstʃɹokʃan
kansda	kansda
kantent	kantent
kantinyu	kantiɲu
kanvasieshan	kanvasɪɛʃan
karambuola	kaɹambuɔla
kasaada	kasaːda
kasaava	kasaːva
kasta	kasta
katn	katn̩
kazmopalitan	kazmopalitan
kech	ketʃ
kechop	ketʃop
kelyan	keljan
kenet	kenet
kiachrin	kjatʃɹin
kianada	kjanada
kiaribiyan	kjaɹibijan
kidni	kidni
kiedens	kɪɛdens
kieful	kɪɛful
kiek	kɪɛk
kien	kien
kien	kɪɛn
kier	kɪɛɹ
kies	kɪɛs
kiet	kɪɛt
kilomita	kilomita
kimischri	kimistʃɹi
kindom	kindom
kin	kin
kinston	kinston
kisaada	kisaːda
kits	kits
kja	kja
	kjapita
kja	umotʃ
	klaːs
klaat	klaːt
klaax	klaːks
klarindan	klaɹindan
klasikal	klasikal
klie	klɪɛ
kliem	klɪɛm
klier	klɪɛɹ
kliermont	klɪɛɹmont
klifod	klifod
kliin	kliːn
kola	kola
kolcha	koltʃa
komiunikieshan	komjunikɪɛʃan
kom	kom
kompail	kompaɪl
kompyuuta	kompjuːta
konchri	kontʃɹi
kongk	koŋk
koni	koni
korant	koɹant
koria	koɹia
kori	koɹi
koril	koɹil
korl	koɹl
kos	kos
koskos	koskos
kostad	kostad
kot	kot
kotlis	kotlis
kou	kɔu
kounti	kounti
kounti	kɔunti
kowich	kowitʃ
kozn	koːzn̩
kraani	kɹaːni
kraitiirya	kɹaɪtiːɹja
krap	kɹap
krichoul	kɹitʃɔul
kriebn	kɹɪɛbn̩
kriep	kɹɪɛp
krietiv	kɹɪɛtiv
kriet	kɹiet
kriim	kɹiːm
krikit	kɹikit
kris	kɹis
kritikal	kɹitikal
kruuz	kɹuːz
kudn	kudn̩
kuk	kuk
ku	ku
kukumba	kukumba
kunu	kunu
kuoknat	kuɔknat
kuoko	kuɔko
kuol	kuɔl
kuos	kuɔs
kuot	kuɔt
kuul	kuːl
kwaadinet	kwaːdinet
kwaat	kwaːt
kwait	kwaɪt
kwaiyat	kwaɪjat
kwestiyan	kwestijan
kwiin	kwiːn
kwik	kwik
kwik-taim	kwiktaɪm
kwint	kwint
kyaahn	kjãː
kyaa	kjaː
kyaarat	kjaːɹat
kyaar	kjaːɹ
kyabij	kjabidʒ
kyahn	kjã
kya	kja
kyaklik	kjaklik
kya	kyja
kyamil	kjamil
kyanal	kjanal
kyanggl	kjaŋgl̩
kyangkro	kjaŋkɹo
kyapasiti	kjapasiti
kyapcha	kjaptʃa
kyapitalis	kjapitalis
kyapital	kjapital
kyaptin	kjaptin
kyarakta	kjaɹakta
kyari	kjaɹi
kyar	kjaɹ
kyash	kjaʃ
kyashu	kjaʃu
kyata	kjata
kyatalis	kjatalis
kyatigari	kjatigaɹi
kyuuba	kjuːba
laaf	laːf
laaj	laːdʒ
laa	laː
laan	laːn
labsta	labsta
laibri	laɪbɹi
laif	laɪf
laifstail	laɪfstaɪl
laik	laɪk
lai	laɪ
lait	laɪt
laitous	laɪtɔus
laiyad	laɪjad
laiyan	laɪjan
laka	laka
lam	lam
landan	landan
lang	laŋ
langwij	laŋwidʒ
langx	laŋks
lan	lan
larans	laɹans
layad	lajad
lebl	lebl̩
lebm	lebm̩
leda	leda
lef	lef
lego	lego
lejislieta	ledʒislɪɛta
lent	lent
leta	leta
lib	lib
libn	libn̩
lichicha	litʃitʃa
lieba	lɪɛba
liedi	lɪɛdi
lieta	lɪɛta
liet	lɪɛt
lieya	lɪɛja
lifop	lifop
liida	liːda
liig	liːg
liin	liːn
lik	lik
likl	likl̩
lili	lili
lingguistik	liŋguistik
linggwis	liŋgwis
lis	lis
lisn	lisn̩
litosfier	litosfɪɛɹ
lizad	lizad
lob	lob
long	loŋ
lorn	loɹn
lou	lɔu
luk	luk
luokalaiz	luɔkalaɪz
luokal	luɔkal
luokiet	luɔkɪɛt
luo	lʊo
luusha	luːʃa
luusi	luːsi
luwiiz	luwi:z
luwi	luwi
maach	maːtʃ
maaga	maːga
maakit	maːkit
maak	maːk
maakos	maːkos
maanin	maːnin
mada	mada
madan	madan
mada-tong	madatoŋ
madifai	madifaɪ
madifikieshan	madifikɪɛʃan
magaziin	magaziːn
magij	magɪdʒ
magl	magl̩
maigrieshan	maɪgɹɪɛʃan
maikal	maɪkal
main	maɪn
maitbi	maɪtbi
mait	maɪt
majariti	madʒaɹiti
manatii	manatiː
manazebl	manazebl̩
manchesta	mantʃesta
mandivl	mandivl̩
manggo	maŋgo
mangguus	maŋguːs
manita	manita
man	man
mantiga	mantiga
manyufakcha	maɲufaktʃa
manyufakcharin	maɲufaktʃaɹin
maraya	maɹaja
maruun	maɹuːn
mashet	maʃet
mashiin	maʃiːn
mashiinri	maʃiːnɹi
mas	mas
matiirialis	matiːɹialis
matimatix	matimatiks
matyu	matju
medisn	medisn̩
meditieshan	meditɪɛʃan
meja	medʒa
mejament	medʒament
mek	mek
mekop	mekop
memba	memba
mexiko	meksiko
midiom	midiom
midya	midja
miebi	mɪɛbi
mieja	mɪɛdʒa
miel	mɪɛl
mie	mɪɛ
mienli	mɪɛnli
mien	mɪɛn
mieri	mɪɛɹi
migl-klaas	migl̩
migl	migl̩
miglsex	migl̩seks
miinin	miːnin
miin	miːn
miita	miːta
miit	miːt
miizolek	miːzolek
milichri	militʃɹi
miliyan	milijan
milk	mɪlk
mi	mi
mimuorial	mimuɔɹial
minista	minista
mishaneri	miʃaneɹi
misnuoma	misnuɔma
mixcha	mikstʃa
mixcho	mikstʃo
mobie	mɔbɪɛ
mongx	moŋks
moni	moni
morant	moɹant
mountn	mɔuntn̩
mout	mɔut
muobail	muɔbaɪl
muo	muɔ
muor	muɔɹ
muosli	muɔsli
muos	muɔs
muotaim	muɔtaɪm
muuv	muːv
myuuzik	mjuːzik
myuziom	mjuziom
naamali	naːmali
naaman	naːman
naasi	naːsi
naasti	naːsti
naatiis	naːtiːs
naat	naːt
naatwes	naːtwes
nadan	nadan
naijiiria	naɪdʒiːɹja
nain	naɪn
naintiin	naɪntiːn
naint	naɪnt
nais	naɪs
nait	naɪt
naiz	naɪz
nalij	nalidʒ
na	na
nanfikshan	nanfikʃan
nansi	nansi
naritiv	naɹitiv
nashinal	naʃinal
navl	navl̩
neba	neba
nedalanz	nedalanz
nex	neks
niecha	nɪɛtʃa
niel	nɪɛl
niem	nɪɛm
niernis	nɪɛɹnis
nier	nɪɛɹ
nieshan	nɪɛʃan
nietib	nɪɛtib
nigril	nigɹil
niigl	niːgl̩
niivis	niːvis
niyilis	nijilis
nof	nof
nof-nof	nofnof
noftaim	noftaɪm
nomba	nomba
nondiles	nondiles
non	non
no	no
no	nokja
notn	notn̩
nou	nɔu
novemba	novemba
nuo	nuɔ
nuot	nuɔt
nuotobl	nuɔtobl̩
nuoz	nuɔz
nyaamps	ɲaːmps
nyami-nyami	ɲamiɲami
nyam	ɲam
nyuu	njuː
nyuu	ɲuː
nyuuz	ɲuːz
nyuuzpiepa	ɲuːzpɪɛpa
ogli	oglɪ
okor	okoɹ
okro	okɹo
olo	olo
ombl	ombl̩
onggl	oŋgl̩
onjrid	ondʒɹid
ontalaji	ontaladʒi
ontin	ontin
ont	ont
ontruut	ontɹuːt
opdiet	opdɪɛt
opinyan	opiɲan
op	op
opsaid	opsaɪd
orbort	oɹbort
ortkwiek	oɹtkwɪɛk
ort	oɹt
oun	ɔun
ou	ɔu
ousomeba	ɔusomeba
ous	ɔus
owad	owad
ozban	ozban
paadn	paːdn̩
paaliment	paːliment
paal	paːl
paapos	paːpos
paarat	paːɹat
paasl	paːsl̩
paasn	paːsn̩
paas	paːs
paasteriti	paːsteɹiti
paati	paːti
paat	paːat
paat	paːta
pachrik	patʃɹik
pahn	pã
pain	paɪn
paint	paɪnt
paip	paɪp
pakistan	pakistan
pakit	pakit
paliis	paliːs
palisi	palisi
palitikal	palitikal
palitishan	palitiʃan
palitix	palitiks
panish	panish
panish	paniʃ
pan	pan
papila	papila
papilieshan	papilɪɛʃan
papishuo	papiʃuɔ
papyulieshan	papjulɪɛʃan
parish	paɹiʃ
pashan	paʃan
patan	patan
pati	pati
pat	pat
patwa	patwa
pelin	pelin
pel	pel
pen	pen
pepa	pepa
picha	pitʃa
piej	pɪɛdʒ
piepa	pɪɛpa
pie	pɪɛ
pierans	pɪɛɹans
pier	pɪɛɹ
pieschri	pɪɛstʃɹi
pieshans	pɪɛʃans
piich	piːtʃ
piika	piːka
piiki-puoki	piːkipuɔki
piik	piːk
piil	piːl
piini	pːini
piini-waali	piːniwaːli
piipl	piːpl̩
piiplz	piːplz
piiriad	piːɹiad
piis	piːs
piita	piːta
piiz	piːz
pikni	pikni
pilikin	pilikin
pimenta	pimenta
pio	pio
pitieta	pitɪɛta
pitni	pitni
pit	pit
plaan	plaːn
plaantin	plaːntin
plaant	plaːnt
pleja	pledʒa
plie	plɪɛ
plies	plɪɛs
pliet	plɪɛt
plit	plit
plom	plom
poblikieshan	poblikɪɛʃan
poblik	poblik
poblisha	pobliʃa
poblish	pobliʃ
pofaam	pofaːm
poliisman	poliːsman
poliis	poliːs
politikal	politikal
pongkin	poŋkin
ponishment	poniʃment
ponish	poniʃ
por-kiapita	poɹ
porl	poɹl
pormanent	poɹmanent
posnal	posnal
pospektiv	pospektiv
potenshal	potenʃal
potienin	potɪɛnin
potikila	potikila
potikyula	potikjula
powa	powa
prablem	pɹablem
praim	pɹaɪm
prais	pɹaɪs
praivisi	pɹaɪvisi
prajek	pɹadʒek
pramis	pɹamis
pravins	pɹavins
pred	pɹed
preke	pɹeke
priivos	pɹiːvos
primenta	pɹimenta
prizaab	pɹizaːb
prizn	pɹizn̩
prodok	pɹodok
prodokshan	pɹodokʃan
profeshanal	pɹofeʃanal
pronongx	pɹonoŋks
protek	pɹotek
protekshan	pɹotekʃan
prumuot	pɹumuɔt
pruogram	pɹuɔgɹam
pruoses	pɹuɔses
pudn	pudn̩
pumuot	pumuɔt
puohim	puɔhim
puok	puɔk
puo	puɔ
puosha	puɔʃa
puosi	puɔsi
puos	puɔs
puotlan	puɔtlan
puotmuor	puotmuoɹ
puot	puot
puot	puɔt
pupaa	pupaː
pus	pus
pwail	pwaɪl
pyaa-pyaa	pjaːpjaː
pyuuriti	pjuːɹɪtɪ
raa	ɹaː
raatid	ɹaːtid
raip	ɹaɪp
rais	ɹaɪs
raita	ɹaɪta
raitn	ɹaɪtn̩
rait	ɹaɪt
raki	ɹaki
raktuon	ɹaktuɔn
rang	ɹaŋ
rang-said	ɹaŋsaɪd
raya	ɹaja
rayas	ɹajas
reda	ɹeda
redi	ɹedɪ
refarans	ɹefaɹans
refa	ɹefa
refrans	ɹefɹans
rekaad	ɹekaːd
rekanaiz	ɹekanaɪz
rekanishan	ɹekaniʃan
respirieshan	ɹespiɹɪɛʃan
revaluushan	ɹevaluːʃan
revarii	ɹevaɹiː
revinyuu	ɹeviɲuː
riba	ɹiba
ribelyan	ɹibeljan
ridim	ɹidim
riedio	ɹɪɛdio
ried	ɹɪɛd
riek	ɹɪɛk
rielwie	ɹɪɛlwɪɛ
rienj	ɹɪɛndʒ
rien	ɹɪɛn
riesin	ɹɪɛsin
riesizim	ɹɪɛsizim
ries	ɹɪɛs
rieza	ɹɪɛza
riezn	ɹɪɛzn̩
rifaam	ɹifaːm
rifain	ɹifaɪn
rigl	ɹigl̩
riida	ɹiːda
riid	ɹiːd
riijanal	ɹiːdʒanal
riijan	ɹiːdʒan
riika	ɹiːka
riili	ɹiːli
riisant	ɹiːsant
riizn	ɹiːzn̩
rijais	ɹijaɪs
rilaxieshan	ɹilaksɪɛʃan
rilieshanship	ɹilɪɛʃanʃip
rilietid	ɹilɪɛtid
riliis	ɹiliːs
rilijan	ɹilidʒan
rimien	ɹimɪɛn
ripoblik	ɹipoblik
riprizent	ɹipɹizent
rispek	ɹispek
ris	ɹis
ritorn	ɹitoɹn
riva	ɹiva
rivazdiel	ɹivazdɪɛl
rivuolt	ɹivuɔlt
rizaat	ɹizaːt
rizolt	ɹizolt
romantik	ɹomantik
ronawe	ɹonawe
ron	ɹon
rosha	ɹoʃa
ruod	ɹuɔd
ruoman	ɹuɔman
ruos	ɹuɔs
ruudnis	ɹuːdnis
ruul	ɹuːl
ruut	ɹuːt
saabis	saːbis
saab	saːb
saach	saːtʃ
saadi	saːdi
saaf	saːf
saalfish	saːlfiʃ
saas	saːs
saaya	saːja
saiman	saɪman
sai	saɪ
sait	saɪt
saiyans	saɪjans
sakrifais	sakɹifaɪs
salaman	salaman
samyuel	samjuel
sang	saŋ
sanja	sandʒa
san	san
santapii	santapiː
santa	santa
saril	saɹil
sar	saɹ
sasayati	sasajati
sataya	sataja
savlamaar	savlamaːɹ
sayans	sajans
sayantis	sajantis
schraip	stʃɹaɪp
schuu	stʃuː
sebm	sebm̩
sebmtiin	sebm̩tiːn
sebmt	sebm̩t
sebn	sebn̩
sebntiin	sebn̩tiːn
sebnt	sebn̩t
sebral	sebɹal
sef	sef
sekan	sekan
seklment	sekl̩ment
sekl	sekl̩
sekshan	sekʃan
sela	sela
senchral	sentʃɹal
senchri	sentʃɹi
senita	senita
senit	senit
sensobl	sensobl̩
sensos	sensos
sens	sens
sentans	sentans
sentri	sentɹi
separieshan	sepaɹɪɛʃan
septemba	septemba
se	se
set	set
sexizim	seksizim
sfier	sfɪɛɹ
shaachij	ʃaːtʃɪdʒ
shaat	ʃaːt
shap-maasa	ʃapmaːsa
shap	ʃap
sheda	ʃeda
shiem	ʃɪɛm
shier	ʃɪɛɹ
shob	ʃob
shot	ʃot
shout	ʃɔut
shudn	ʃudn̩
shuga	ʃuga
shuor	ʃuɔɹ
shuo	ʃuɔ
shuut	ʃuːt
sib	sib
sidong	sidoŋ
sief	sɪɛf
sieka	sɪɛka
siel	sɪɛl
siem	sɪɛm
siera	sɪɛra
siev	sɪɛv
siikuel	siːkwel
siim	siːm
siin	siːn
sii	siː
siis	siːs
siitorkl	siːtoɹkl̩
siiznin	siːznin
siizn	siːzn̩
sik	sɪk
silekshan	silekʃan
silvia	silvia
singa	siŋa
singgapuor	siŋgapuoɹ
sing	sɪŋ
siniek	sinɪɛk
sinieli	sɪnɪɛli
sin	sin
sinting	sintiŋ
sint	sint
sipl	sipl̩
si	si
sista	sista
sistim	sistim
sitieshan	sitɪɛʃan
sitiet	sitɪɛt
siti	siti
sitizn	sitizn̩
sitn	sitn̩
six	siks
sixtiin	sikstiːn
sixt	sikst
skai	skaɪ
skelyan	skeljan
skuul	skuːl
skwier	skwɪɛɹ
slait	slaɪt
slieb	slɪɛb
sliip	sliːp
sluo	slʊo
smaal	smaːl
smadi	smadi
smuok	smuɔk
sobjek	sobdʒek
sodan	sodan
sofarieshan	sofaɹɪɛʃan
sofa	sofa
sohn	sõ
sojes	sodʒes
soma	soma
som	som
somwe	somwe
sopm	sopm̩
sopraizn	sopɹaɪzn̩
sopres	sopɹes
sori	soɹi
sorkl	soɹkl̩
sorniem	soɹnɪɛm
sorosi	soɹosi
soroun	soɹɔun
so	so
sostien	sostɪɛn
soua	sɔua
soun	sɔun
soutiis	soutiːs
soutiis	sɔutiːs
sout	sout
sout	sɔut
soutwes	sɔutwes
spais	spaɪs
spekchrom	spektʃɹom
spien	spɪɛn
spies	spɪɛs
spiishiz	spiːʃiz
spring	spɹiŋ
spuoxman	spuɔksman
staach	staːtʃ
staam	staːm
staarfruut	staːɹfɹuːt
staar	staːɹ
staat	staːt
stail	staɪl
stiebl	stɪɛbl̩
stiej	stɪɛdʒ
stieshan	stɪɛʃan
stie	stɪɛ
stietos	stɪɛtos
stiet	stɪɛt
stiibm	stiːbm̩
stiim	stiːm
stodi	stodi
stuon	stuɔn
suhn	sũ
suimz	suimz
suitsalan	suitsalan
sumaal	sumaːl
sumuud	sumuːd
suoja	suɔdʒa
suop	suɔp
suoshal	suɔʃal
suos	suɔs
suoviet	suovɪɛt
susu	susu
suucha	suːtʃa
suun	suːn
suup	suːp
swiidn	swiːdn̩
swiit	swiːt
swiit-swiit	swiːtswiːt
swimin	swimin
taakin	taːkin
taak	taːk
taat	taːt
taikl	taɪkl̩
tailan	taɪlan
taim	taɪm
talawa	talawa
tamas	tamas
tambrik	tambɹik
tambrin	tambɹin
tandad	tandad
tangx	taŋks
tan	tan
tapik	tapik
tap	tap
tayad	tajad
taya	taja
tekniik	tekniːk
tek	tek
tel	tel
tenis	tenis
ten	ten
tent	tent
tenya	teɲa
terichri	teɹitʃɹi
tertiin	teɹtiːn
textail	tekstaɪl
tide	tide
tiebl	tɪɛbl̩
tiel	tɪɛl
ties	tɪɛs
tieta	tɪɛta
tigeda	tigeda
tiich	tiːtʃ
tiif	tiːf
tii	tiː
tiit	tiːt
tik	tik
tingk	tiŋk
tingz	tiŋz
tiori	tioɹi
tisyu	tisju
tix	tɪks
toch	totʃ
todi	todi
tod	tod
tof	tof
tong	toŋ
tong	tɔŋ
ton	ton
torki	toɹki
torkl	toɹkl̩
tormal	toɹmal
torm	toɹm
tornin	toɹnin
torpmtaim	toɹpm̩taɪm̩
toti	totɪ
toun	tɔun
touzn	tɔuzn̩
towa	towa
towil	towil
tros	tɹos
tubiego	tubɪɛgo
tumatis	tumatis
tuofuu	tuɔfuː
tuonaliti	tuɔnaliti
tuon	tuɔn
tuori	tuɔɹi
tuo	tuɔ
tu	tu
tuul	tuːl
tuu	tuː
twelb	twelb
twenti	twenti
ud	ud
uman	uman
umoch	
umoch	umotʃ
unu	unu
uobasior	uɔbasioɹ
uoba	uɔba
uochi	uotʃi
uoliip	huɔliːp
uoli	uɔli
uol	uɔl
uol	wuɔl
uom	uɔm
uonaship	uɔnaʃip
uona	uɔna
uon	uɔn
uonyan	uoɲan
uopm	uɔpm̩
uoshan	uoʃan
uoshan	uɔʃan
uovn	uovn̩
uu	uː
vais	vaɪs
van	van
varayati	vaɹajati
vejitebl	vedʒitebl̩
vieri	vɪɛɹi
vietnam	vɪɛtnam
vijan	vidʒan
vik	vik
viniga	viniga
vinsn	vinsn̩
volkieno	volkɪɛno
vorjan	voɹdʒan
vowil	vowil
vuokalis	vuɔkalis
vuokal	vuɔkal
vuot	vuɔt
waak	waːk
waal	waːl
waam	waːm
waapm	waːpm̩
waar	waːɹ
waata	waːta
wahn	wã
waidpred	waɪdpɹed
waif	waɪf
wails	waɪls
wail	waɪl
wait	waɪt
wala	wala
wan	wan
wapn-bapn	wapn̩bapn̩
was	was
wat-lef	watlef
wat-liiv	watliːv
wa	wa
weda	weda
wehn	wẽ
wesmolan	wesmolan
westan	wɛstan
wes	wes
we	we
widoutn	widɔutn̩
widout	widɔut
wid	wid
wiej	wɪɛdʒ
wiet	wɪɛt
wie	wɪɛ
wiik	wiːk
wiil	wiːl
winta	winta
wi	wi
wod-a-mout	wodamɔut
wod	wod
woka	woka
woklis	woklis
wok	wok
wol	wol
wori	woɹi
worom	woɹom
wotlis	wotlis
wot	wot
wud	wud
wuol	wuɔl
yaadi	jaːdi
yaad	jaːd
yaak	jaːk
yai	jaɪ
ya	ja
yam	jam
yampi	jampi
yaso	jaso
yaxep	jaksep
yeside	jeside
yong	joŋ
yu	ju
yumaniti	jumaniti
yunaitid	junaɪtid
yunivorsiti	junivoɹsiti
yuu	juː
yuukrien	juːkɹɪɛn
yuuman	juːman
yuuna	yuːna
yuunian	juːnjan
yuuniiknis	juːniːknis
yuunyan	juːɲan
yuurop	juːɹop
yuusful	juːsful
yuusij	juːsidʒ
yuus	juːs
yuut	juːt
yuuz	juːz
zela	zela
zuu	zuː
