bana	bana
boikanyego	boik͡xanɛɣo
boikarabelo	boik͡xarabɛlo
boikgogomosô	boik͡xoxomosô
boikokobetso	boik͡xokobɛt͡so
boitshepo	boit͡sʰɛpo
boitshwarelo	boit͡sʰʷarɛlo
boitumelo	boitumelo
dijo	did͡ʒo
diphaphatha	dipʰapʰatʰa
kgomo	k͡xomo
leihlo	leihlo
letsatsi	lɛt͡satsi
mariga	mariga
metsi	mɛt͡si
mme	mːɛ
monna	mɔnːa
mosadi	mosadi
motho	motʰo
nakò	nakò
ngaka	ŋaka
ntlo	ntɬo
pula	pula
rre	rːɛ
seatla	sɛatɬa
sefate	sefate
thaba	tʰaba
