กก	gok
กกไม้	gokmai
กด	got
กด	got
กน	gon
ก่น	gon
ก้น	gon
กบ	gop
กม	gom
ก้ม	gom
กวด	gu:at
ก้วย	gu:ai
กวยเตียว	gu:aiti:ao
กว่า	gwa:
กว้าง	gwa:ŋ
ก่อ	gɔ:
ก้อกๆ	gɔ:k
ก่อกน้ำ	gɔkna:m
กอง	gɔ:ŋ
กอง	gɔ:ŋ
ก่อง	gɔŋ
ก้อง	gɔ:ŋ
ก่องแก่ง	gɔŋgɛŋ
กองไฟ	gɔ:ŋfai
กอน	gɔ:n
ก่อน	gɔ:n
ก้อน	gɔ:n
ก้อนเมก	gɔ:nme:k
ก้อนหิน	gɔ:nhin
กอบ	gɔ:p
ก่อส้าง	gɔ:sa:ŋ
กะ	ga
กะ	ga
กะคุ	gaku
กะจก	gajok
กะด้อกะเดี้ย	gadɔ:kgadi:a
กะดอง	gadɔ:ŋ
กะดาด	gada:t
กะดาดแข็ง	gada:tkhɛŋ
กะดาน	gada:n
กะดิก	gadik
กะดุม	gadum
กะดูก	gadu:k
กะเดย	gadə:i
กะโดด	gado:t
กะต่า	gata:
กะทะ	gatha
กะเทียม	gathi:am
กะปอง	gapɔŋ
กะปุก	gapuk
กะเปา	gapao
กะเปาเป้	gapaope:
กะโปง	gapo:ŋ
กะเพาะ	gaphɔ
กะละกะดาคม	galagada:khom
กะละมัง	galamaŋ
กะลัง	galaŋ
กะหล้ำ	galam
กะหล้ำปี	galampi:
กะโหลก	galo:k
กัด	gat
กัน	gan
กัน	gan
กั้น	gan
กันไก	gangai
กันญาย๊น	ganɲa:yon
กับ	gap
กับ	gap
กับเข้า	gapkhao
กับตัน	gaptan
ก้า	ga:
ก้า	ga:
ก้ากๆ	ga:kga:k
กากะบาด	ga:gaba:t
กากี	ga:gi:
กาง	ga:ŋ
กางเกง	ga:ŋge:ŋ
กาตูน	ga:tu:n
กาน	ga:n
ก้าน	ga:n
กานเมือง	ga:nmʉ:aŋ
กาบ	ga:p
กาแฟ	ga:fɛ:
ก้าม	ga:m
กาย	ga:i
กาละเทสะ	ga:lathe:sa
ก้าว	ga:o
ก่ำ	gam
กำปั้น	gamban
กำแพง	gamphɛ:ŋ
กำลัง	gamlaŋ
กำลัง	gamlaŋ
กิ่ง	giŋ
กิ่ง	giŋ
กิดจะกัม	gitjagam
กิน	gin
กิ่น	gin
กีบ	gi:p
กีลา	gi:la:
กุงเทบ	guŋthe:p
กุงไทย	guŋthai
กุนแก	gungɛ:
กุนแกข้อมือ	gungɛ:khɔ:mʉ:
กุนแจ	gunjɛ:
กุ่บ	gup
กุมพา	gumpha:
กุมพาพัน	gumpha:phan
กู	gu:
กู้	gu:
เก	ge:
เก่ง	geŋ
เก็ด	get
เก่ด	get
เก็บ	gep
เกม	ge:m
เกสอน	ge:sɔ:n
เกะกะ	gega
เก่า	gao
เก้า	gao
เก้าอี้	gaoi:
เกาะ	gɔ
เกาะ	gɔ
เกิด	gə:t
เกิน	gə:n
เกินเหด	gə:nhe:t
เกิบ	gə:p
เกิบคีบ	gə:pkhi:p
เกิบแตะ	gə:ptɛ
เกิบโบก	gə:pbo:k
เกิบผ้าใบ	gə:ppha:bai
เกีย	gi:a
เกียก	gi:ak
เกี้ยง	gi:aŋ
เกี้ยงเกา	gi:aŋgao
เกี้ยงมิ่นลิ่น	gi:aŋminlin
เกียบ	gi:ap
เกี่ยว	gi:ao
เกี่ยวกับ	gi:aogap
แก	gɛ:
แก	gɛ:
แก่	gɛ:
แก้	gɛ:
แกง	gɛ:ŋ
แก้ง	gɛ:ŋ
แก่งจ่างป่าง	gɛŋja:ŋpa:ŋ
แก้ม	gɛ:m
แก้ว	gɛ:o
แกะ	gɛ
โก่งโด่ง	go:ŋdo:ŋ
โกน	go:n
ใก้	gai
ไก	gai
ไก่	gai
ขดตะหมาด	khottama:t
ขน	khon
ขนส่ง	khonsoŋ
ขม	khom
ขวด	khu:at
ขวน	khu:an
ขวา	khwa:
ขอ	khɔ:
ของ	khɔ:ŋ
ของ	khɔ:ŋ
ข้อง	khɔŋ
ของขวน	khɔ:ŋkhu:an
ของหวาน	khɔ:ŋwa:n
ของเหล้น	khɔ:ŋlen
ขอซ้าง	khɔ:sa:ŋ
ข้อต่อ	khɔ:tɔ:
ขอโต	khɔ:to:
ขอทาน	khɔ:tha:n
ข้อน	khɔn
ขอนไม้	khɔ:nmai
ขอบ	khɔ:p
ขอบคุณ	khɔ:pkhun
ขอบใจ	khɔ:pjai
ขอบิ่น	khɔ:bin
ข้อมูน	khɔ:mu:n
ข้อย	khɔ:i
ข้อหล้อ	khɔ:lɔ:
ขะบวน	khabu:an
ขะโมย	khamo:i
ขะยะ	khaya
ขะหนม	khanom
ขะหนาด	khana:t
ขัง	khaŋ
ขัน	khan
ขั้น	khan
ขั้น	khan
ขั้น	khan
ขั้นตอน	khantɔ:n
ขับ	khap
ขั้วน	khu:an
ขา	kha:
ข้า	kha:
ข้าง	kha:ŋ
ข้างขวา	kha:ŋkwa:
ข้างซ้าย	kha:ŋsa:i
ข้างเทิง	kha:ŋthə:ŋ
ข้างนอก	kha:ŋnɔ:k
ข้างใน	kha:ŋnai
ข้างล่าง	kha:ŋla:ŋ
ข้างหน้า	kha:ŋna:
ข้างหลัง	kha:ŋlaŋ
ขาด	kha:t
ขาตั้ง	kha:taŋ
ข้าม	kha:m
ขาย	kha:i
ขาว	kha:o
ข่าว	kha:o
ขิ้น	khin
ขี่	khi:
ขี้	khi:
ขีด	khi:t
ขี้ดิน	khi:din
ขี้ตม	khi:tom
ขี้ผึ้ง	khi:pʉŋ
ขี้ฝ้า	khi:fa:
ขี้มึน	khi:mʉn
ขึง	khʉŋ
ขึงขัง	khʉŋkhaŋ
ขึ้น	khʉn
ขึ้นซื่อ	khʉnsʉ:
ขุด	khut
เข้ง	kheŋ
เข็ม	khem
เข้ม	khem
เขา	khao
เขา	khao
เข่า	khao
เข้า	khao
เข้า	khao
เข้า	khao
เข้างาย	khaoŋa:i
เข้าเจ้า	khaojao
เข้าเซ้า	khaosao
เข้าแลง	khaolɛ:ŋ
เข้าสวย	khaosu:ai
เข้าสาน	khaosa:n
เขียน	khi:an
เขียว	khi:ao
แข็ง	khɛŋ
แข่ง	khɛŋ
แข็งแลง	khɛŋlɛ:ŋ
แขน	khɛ:n
แขน	khɛ:n
แข้ว	khɛ:o
ไข่	khai
ไข่ขาว	khaikha:o
ไข่เจียว	khaiji:ao
ไข่ดาว	khaida:o
ไข่แดง	khaidɛ:ŋ
ไขมัน	khaiman
ไข้เลือดออก	khailʉ:atɔ:k
คก	khok
คน	khon
คน	khon
คนไข้	khonkhai
คนป่วย	khonpu:ai
คนละ	khonla
คม	khom
คม	khom
ควน	khu:an
ควย	khu:ai
ความ	khwa:m
ความคิด	khwa:mkhit
ความทุก	khwa:mthuk
ความปอดพัย	khwa:mpɔ:tphai
ความฝัน	khwa:mfan
ความเย็น	khwa:myen
ความลู้	khwa:mlu:
ความสุข	khwa:msuk
ความหมาย	khwa:mma:i
ความหายยะนะ	khwa:mha:iyana
ความฮ้อน	khwa:mhɔ:n
ความฮู้	khwa:mhu:
คอ	khɔ:
คอก	khɔ:k
คอง	khɔ:ŋ
ค็อนกีด	khɔngi:t
ค็อนโด	khondo:
คอบคัว	khɔ:pkhu:a
ค็อม	khom
ค็อมพิวเต้อ	khompiutə:
ค่อย	khɔ:i
ค้อย	khɔ:i
คอสอ	khɔ:sɔ:
คะนิด	khanit
คะนิดตะสาด	khanittasa:t
คะนิดสาด	khanitsa:t
คะแนน	khanɛ:n
คัก	khak
คัด	khat
คัน	khan
คันเล่ง	khanleŋ
คับ	khap
คัว	khu:a
ค่า	kha:
ค้า	kha:
คาง	kha:ŋ
ค้าง	kha:ŋ
คาน	kha:n
คาบ	kha:p
คาบ	kha:p
คาย	kha:i
ค้าย	kha:i
คาว	kha:o
ค่าวๆ	kha:o
ค้าวๆ	kha:okha:o
คำ	kham
คำ	kham
คำ	kham
ค่ำ	kham
คำนวน	khamnu:an
คิด	khit
คิบ	khip
คิว	kiu
คิ้ว	khiu
คิหนิก	khi:nik
คีบ	khi:p
คีบ	khi:p
คึ้ม	khʉm
คื้น	khʉ:n
คืนหลัง	khʉ:nlaŋ
คือ	khʉ:
คือกัน	khʉ:gan
คือเก่า	khʉ:gao
คือใดบุ	khʉ:daibu
คุณ	khun
คุม	khum
คุย	khui
คู	khu:
คู่	khu:
เค่งเคียด	kheŋkhi:at
เค็ม	khem
เคย	khə:i
เคา	khao
เคาเต้อ	khaotə:
เคาลบ	khaolop
เคิ่ง	khəŋ
เคียง	khi:aŋ
เคียง	khi:aŋ
เคี่ยง	khi:aŋ
เคี่ยงคิดเลข	khi:aŋkitle:k
เคี่ยงญก	khi:aŋɲok
เคี่ยงบิน	khi:aŋbin
เคี่ยงปุง	khi:aŋpuŋ
เคี่ยงสำอาง	khi:aŋsama:ŋ
เคี้ยงหมาย	khi:aŋma:i
เคียด	khi:at
เคื้อนที้	khʉ:anthi:
แค่	khɛ:
โคก	kho:k
โค้ง	kho:ŋ
ใคแน่	khainɛ:
งวง	ŋu:aŋ
งอ	ŋɔ:
งัด	ŋat
งับ	ŋap
งัว	ŋu:a
งา	ŋa:
ง่า	ŋa:
งาน	ŋa:n
งาม	ŋa:m
ง่าย	ŋa:i
เงิน	ŋən
เงินสด	ŋənsot
ไง่	ŋai
จก	jok
จ่ง	joŋ
จดจำ	jotjam
จน	jon
จบ	jop
จอ	jɔ:
จ้อง	jɔŋ
จอด	jɔ:t
จ่อย	jɔ:i
จ้อย	jɔ:i
จะ	ja
จะเลิน	jalə:n
จัก	jak
จักกะย๊าน	jakgaya:n
จักอย่าง	jakya:ŋ
จั่ง	jaŋ
จั่งซั้น	jaŋsan
จั่งซี้	jaŋsi:
จั่งใด	jaŋdai
จังหวะ	jaŋwa
จังหวัด	jaŋwat
จัด	jat
จัด	jat
จับ	jap
จา	ja:
จ้า	ja:
จาก	ja:k
จาน	ja:n
จานฮองกาแฟ	ja:nhɔ:ŋga:fɛ:
จ่าย	ja:i
จำ	jam
จำนวน	jamnu:an
จำเป็น	jampen
จิก	jik
จิง	jiŋ
จินตะนา	jintana:
จินตะนากาน	jintana:ga:n
จิ้ม	jim
จีวอน	ji:wɔ:n
จึ่งคื่ง	jʉŋkhʉ:ŋ
จืด	jʉ:t
จุก	juk
จุด	jut
จุดมุ่งหมาย	jutmuŋma:i
จุดหมาย	jutma:i
จุ่นพู่น	junphu:n
จุ่ม	jum
เจ็ด	jet
เจดี	je:di:
เจ็บ	jep
เจ้า	jao
เจ้าของ	jaokhɔ:ŋ
แจ้ง	jɛ:ŋ
โจก	jo:k
โจ้กๆ	jo:k
โจ่งโป่ง	jo:ŋpo:ŋ
โจน	jo:n
โจ้น	jo:n
โจ่โล่	jo:lo:
ใจ	jai
ใจกาง	jaiga:ŋ
ใจฮ้าย	jaiha:i
ชะนิด	chanit
ชักกะเย้อ	chakgayə:
ชักโคก	chakkho:k
ชาว	cha:o
ชาวบ้าน	cha:oba:n
เช็ค	chek
แชะ	chɛ
ซง	soŋ
ซงผม	soŋphom
ซงสี	soŋsi:
ซม	som
ซมพู	somphu:
ซ้วง	su:aŋ
ซวน	su:an
ซ้วน	su:an
ซวย	su:ai
ซอก	sɔ:k
ซ่อก	sɔk
ซอง	sɔ:ŋ
ซ้อง	sɔ:ŋ
ซ้อน	sɔ:n
ซ้อน	sɔ:n
ซ้อนซา	sɔ:nsa:
ซ้อนส้อม	sɔ:nsɔm
ซ่อย	sɔ:i
ซ่อยเหลีย	sɔ:ili:a
ซะนะ	sana
ซะสั้น	sasan
ซัก	sak
ซั่ง	saŋ
ซัด	sat
ซัน	san
ซั้น	san
ซั้นวางหนังสือ	sanwa:ŋnaŋsʉ:
ซัว	su:a
ซั่วคาว	su:akha:o
ซั่วโมง	su:amo:ŋ
ซ้า	sa:
ซ้า	sa:
ซ่าง	sa:ŋ
ซ้าง	sa:ŋ
ซ่างตัดผม	sa:ŋtatphom
ซ่าด	sa:t
ซาน	sa:n
ซานซาลา	sa:nsa:la:
ซาย	sa:i
ซ้าย	sa:i
ซายหาด	sa:iha:t
ซาว	sa:o
ซ่าว่า	sa:wa:
ซ้ำ	sam
ซำบาย	samba:i
ซ้ำแมะ	sammɛ
ซิด	sit
ซิ้น	sin
ซิ้นเนี้ย	sinni:a
ซิม	sim
ซี้	si:
ซีวิด	si:wit
ซื่อ	sʉ:
ซื้อ	sʉ:
ซื่อๆ	sʉ:
ซุด	sut
ซุดโซม	sutso:m
ซุม	sum
ซู่	su:
ซูด	su:t
ซู่มื้อนี้	su:mʉ:ni:
ซู่สิ่งซู่อย่าง	su:siŋsu:ya:ŋ
เซ็ก	sek
เซ็ด	set
เซ้น	sen
เซเว้น	se:wen
เซา	sao
เซ้า	sao
เซียก	si:ak
เซี้ยม	si:am
เซี้ยโลก	si:alo:k
เซี้ยวซาน	si:aosa:n
เซื้อเพิง	sʉ:aphə:ŋ
แซ่	sɛ:
แซ่แข็ง	sɛ:khɛŋ
แซง	sɛ:ŋ
แซบ	sɛ:p
แซม	sɛ:m
แซมพู	sɛ:mphu:
โซ	so:
โซ้	so:
โซกดี	so:kdi:
โซฟา	so:fa:
ใซ้	sai
ใซ้งาน	saiŋa:n
ใซ้ซีวิด	saisi:wit
ไซ	sai
ญก	ɲok
ญ้อง	ɲɔ:ŋ
ญ้อน	ɲɔ:n
ญ้อน	ɲɔ:n
ญ้อย	ɲɔ:i
ญัง	ɲaŋ
ญาก	ɲa:k
ญ่าง	ɲa:ŋ
ญาด	ɲa:t
ญาม	ɲa:m
ญาม	ɲa:m
ญ้าย	ɲa:i
ญาว	ɲa:o
ญิง	ɲiŋ
ญุง	ɲuŋ
ญู้	ɲu:
เญ็บ	ɲep
เญี่ย	ɲi:a
เญียง	?
เญี่ยว	ɲi:ao
แญง	ɲɛ:ŋ
โญก	ɲo:k
โญน	ɲo:n
ดง	doŋ
ด้น	don
ดม	dom
ดวง	du:aŋ
ดวงจัน	du:aŋjan
ดวงดาว	du:aŋda:o
ดวงตะเว็น	du:aŋtawen
ด้วย	du:ai
ด้วยกัน	du:aigan
ด้วยดี	du:aidi:
ดอก	dɔ:k
ดอก	dɔ:k
ดอก	dɔ:k
ดอกบัว	dɔ:kbu:a
ดอกไม้	dɔ:kmai
ดอกวา	dɔ:kwa:
ดอกว่า	dɔ:kwa:
ดัง	daŋ
ดัง	daŋ
ดับ	dap
ด่า	da:
ดาก	da:k
ด้าน	da:n
ด้าม	da:m
ด้าย	da:i
ดาว	da:o
ดำ	dam
ดำนา	damna:
ดำไฮ่ดำนา	damhaidamna:
ดิน	din
ดิ้น	din
ดิบ	dip
ดี	di:
ดีใจ	di:jai
ดึก	dʉk
ดึก	dʉk
ดึง	dʉŋ
ดืน	dʉ:n
ดุ	du
ดุ	du
ดุล้าย	dula:i
ดู	du:
ดูด	du:t
ดูแล	du:lɛ:
เด่	de:
เด๊	de:
เด็ก	dek
เด็กน้อย	deknɔ:i
เด็กเสิบ	deksə:p
เด้อ	də:
เด่ะ	de
เดา	dao
เดิ่น	də:n
เดินทาง	də:ntha:ŋ
เดียน	di:an
เดียว	di:ao
เดียวกัน	di:aogan
แดง	dɛ:ŋ
แดด	dɛ:t
โด่งดัง	do:ŋdaŋ
โดด	do:t
โดน	do:n
โดน	do:n
โดยสาน	do:isa:n
ใด	dai
ได้	dai
ได้ญิน	daiɲin
ได้ลับ	dailap
ได้ฮับ	daihap
ตก	tok
ตกใจ	tokjai
ตกดิน	tokdin
ตกแต่ง	toktɛŋ
ตง	toŋ
ตน	ton
ต่น	ton
ต้น	ton
ต้นก้า	tonga:
ต้นเข้า	tonkhao
ต้นไม้	tonmai
ตบ	top
ต้ม	tɔm
ตวด	tu:at
ตวดสอบ	tu:atsɔ:p
ต่อ	tɔ:
ตอก	tɔ:k
ต่อคิว	tɔ:kiu
ต้อง	tɔŋ
ต้องกาน	tɔŋga:n
ตอน	tɔ:n
ตอนนี้	tɔ:nni:
ตอบ	tɔ:p
ตอบแทน	tɔ:pthɛ:n
ต่อไป	tɔ:pai
ต่อไปนี้	tɔ:paini:
ตอม	tɔ:m
ต่อสู้	tɔ:su:
ตะก้า	taga:
ตะเกียบ	tagi:ap
ตะขอ	takhɔ:
ตะปู	tapu:
ตะลี	tali:
ตะเว็น	tawen
ตะหลก	talok
ตะหลอดเวลา	talɔ:twe:la:
ตะหลาด	tala:t
ตะหลาดนัด	tala:tnat
ตัก	tak
ตั้ง	taŋ
ตั้ง	taŋ
ตั้งค้า	taŋkha:
ตั้งจิด	taŋjit
ตั้งใจ	taŋjai
ตั้งแต่	taŋtɛ:
ตัด	tat
ตับ	tap
ตัว	tu:a
ตั๊วะ	tu:a
ตา	ta:
ตา	ta:
ตา	ta:
ตาก	ta:k
ตาข่าย	ta:kha:i
ต่าง	ta:ŋ
ต่างๆ	ta:ŋta:ŋ
ต่างปะเทด	ta:ŋpathet
ตาซั่ง	ta:saŋ
ตาแซบ	ta:sɛ:p
ตาบอด	ta:bɔ:t
ตาเบิ่ง	ta:bəŋ
ตาพุฮ้าย	ta:phuha:i
ตาม	ta:m
ตาม่วน	ta:mu:an
ตามสั่ง	ta:msaŋ
ตามีความสุข	ta:mi:khwa:msuk
ตามีแฮง	ta:mi:hɛ:ŋ
ตาย	ta:i
ตาย้าน	ta:ya:n
ตาลิโตน	ta:lito:n
ตาหน่าย	ta:na:i
ตาอยากหัว	ta:ya:khu:a
ตาฮัก	ta:hak
ตำ	tam
ต่ำ	tam
ตำบน	tambon
ตำบักหุ่ง	tambakhuŋ
ตำหลวด	tamlu:at
ติ	ti
ติ่ก	tik
ติด	tit
ติด	tit
ตี	ti:
ตีน	ti:n
ตีนเปิ่ม	ti:npə:m
ตึก	tʉk
ตึ่บ	tʉp
ตื่น	tʉ:n
ตื้น	tʉ:n
ตุ่กตุ่ก	tuktuk
ตุ้มม้อง	tummɔŋ
ตุ้ย	tui
ตุลาคม	tula:khom
ตู้	tu:
ตู้เย็น	tu:yen
เต็น	ten
เต้น	ten
เต็ม	tem
เต็มปี้ลี้	tempi:li:
เตะ	te
เตา	tao
เต่า	tao
เติบ	tə:p
เติม	tə:m
เตี้ย	ti:a
เตียง	ti:aŋ
เตียม	ti:am
เตือน	tʉ:an
เตือนสะติ	tʉ:ansati
แต่	tɛ:
แต่	tɛ:
แตก	tɛ:k
แตกต่าง	tɛ:kta:ŋ
แต่กี้	tɛ:gi:
แต่ง	tɛŋ
แต่งงาน	tɛŋŋa:n
แต่งโต	tɛŋto:
แตงโม	tɛ:ŋmo:
แต่ละ	tɛ:la
แต่ว่า	tɛ:wa:
แต่ใส	tɛ:sai
โต	to:
โต่ง	to:ŋ
โตหนังสือ	to:naŋsʉ:
โตอย่าง	to:ya:ŋ
โต่ะ	to
ใต้	tai
ไต	tai
ไต้	tai
ถก	thok
ถ้วม	thu:am
ถ้วย	thu:ai
ถอด	thɔ:t
ถ้อน	thɔ:n
ถะหนน	thanon
ถะหนนลาดยาง	thanonla:tya:ŋ
ถะหนัด	thanat
ถะหวาย	thawa:i
ถะแหมะ	thamɛ
ถัง	thaŋ
ถังขะยะ	thaŋkhaya
ถัดไป	thatpai
ถั่วงอก	thu:aŋɔ:k
ถ้า	tha:
ถาด	tha:t
ถ่าน	tha:n
ถานะ	tha:na
ถาม	tha:m
ถ่าย	tha:i
ถิ้ม	thim
ถี่	thi:
ถีบ	thi:p
ถึง	thʉŋ
ถืก	thʉ:k
ถืก	thʉ:k
ถืก	thʉ:k
ถืก	thʉ:k
ถืกกัน	thʉ:kgan
ถืกปาก	thʉ:kpa:k
ถืกหู	thʉ:khu:
ถือ	thʉ:
ถุง	thuŋ
ถุงตีน	thuŋti:n
ถุงเท้า	thuŋthao
ถู	thu:
เถ้า	thao
เถียง	thi:aŋ
แถว	thɛ:o
แถะ	thɛ
โถแก้ว	tho:gɛ:o
โถส้วม	tho:su:am
ไถ	thai
ไถฮุด	thaihut
ทงซาด	thoŋsa:t
ทดแทน	thotthɛ:n
ทน	thon
ทนทาน	thontha:n
ทบทวน	thopthu:an
ท่วน	thu:an
ท่อ	thɔ:
ทอง	thɔ:ŋ
ท้อง	thɔ:ŋ
ท้องถะหนน	thɔ:ŋthanon
ท้องฟ้า	thɔ:ŋfa:
ท้องเสีย	thɔ:ŋsi:a
ทอด	thɔ:t
ทอน	thɔ:n
ท่อน	thɔn
ท้อน	thɔ:n
ท่อนไม้	thɔnmai
ทอละมาน	thɔlama:n
ทะนาคาน	thana:kha:n
ทะเล	thale:
ทะเลาะวิวาท	thalɔwiwa:t
ทะวีบ	thavi:p
ทะหาน	thaha:n
ทักทาย	thaktha:i
ทั้งหลาย	thaŋla:i
ทัน	than
ทั่น	than
ทันได้	thandai
ทันที	thanti:
ทันวาคม	thanwa:khom
ทันเวลา	thanwe:la:
ทับ	thap
ทัพพี	thapphi:
ทัมมะซาด	thammasa:t
ทัมมะดา	thammada:
ทั่ว	thu:a
ทา	tha:
ท่า	tha:
ทาง	tha:ŋ
ทางแย้ก	tha:ŋyɛ:k
ทางเลี้ยว	tha:ŋli:ao
ทางหน้า	tha:ŋna:
ทางหลัง	tha:ŋlaŋ
ท่าทาง	tha:tha:ŋ
ท่าเทบพะบุด	tha:the:pphabut
ทาน	tha:n
ทาน	tha:n
ท้าย	tha:i
ทำ	tham
ทำความสะอาด	thamkhwa:msaa:t
ทำงาน	thamŋa:n
ทำนอง	thamnɔ:ŋ
ทำบุน	thambun
ทำล้าย	thamla:i
ทิด	thit
ที่	thi:
ที่	thi:
ที่ดิน	thi:din
ทีบ	thi:p
ทีละ	thi:la
ที้ลี้	thi:li:
ที่สุด	thi:sut
ทีหลัง	thi:laŋ
ที่อยู่อาสัย	thi:yu:a:sai
ทุก	thuk
ทุ่ง	thuŋ
ทุ้ม	thum
ทุละ	thula
ทุละกิด	thulagit
ทูบ	thu:p
เท	the:
เทา	thao
เท่า	thao
เท่าใด	thaodai
เท่านั้น	thaonan
เท่านี้	thaoni:
เทิง	thə:ŋ
เทิง	thə:ŋ
เทิงเบิด	thə:ŋbət
เที่ย	thi:a
เที่ยง	thi:aŋ
เที่ยงคืน	thi:aŋkhʉ:n
เทียน	thi:an
เที่ยว	thi:ao
แท้	thɛ:
แท่ง	thɛŋ
แทน	thɛ:n
โท	tho:
โทน	tho:n
โทละทัด	tholathat
โทละสับ	tholasap
ไทย	tha:i
นก	nok
นม	nom
นวน	nu:an
น่วย	nu:ai
น่วยตา	nu:aita:
น่อ	nɔ:
น้อ	nɔ:
นอก	nɔ:k
นอกจาก	nɔ:kja:k
น้อง	nɔ:ŋ
น้องซาย	nɔ:ŋsa:i
น้องสาว	nɔ:ŋsa:o
นอน	nɔ:n
นอนหลับ	nɔ:nlap
น้อย	nɔ:i
นะ	na
นักล้อง	naklɔ:ŋ
นักเลียน	nakli:an
นั่ง	naŋ
นัด	nat
นั้น	nan
นั้นหนะ	nanna
นั้นหละ	nanla
นั้นเอง	nane:ŋ
นับ	nap
นับถือ	napthʉ:
นัว	nu:a
นา	na:
น้า	na:
นางพะยาบาน	na:ŋphaya:ba:n
นางเอก	na:ŋe:k
นาที	na:thi:
นาย	na:i
นาลิกา	na:liga:
นาลิกาปุก	na:liga:puk
นำ	nam
น้ำ	na:m
นำกัน	namgan
น้ำแข็ง	na:mkhɛŋ
น้ำโค่ก	na:mkho:k
น้ำเชื้อม	na:mchʉ:am
น้ำแดง	na:mdɛ:ŋ
น้ำตา	na:mta:
น้ำตาน	na:mta:n
น้ำตาน	na:mta:n
น้ำปั่น	na:mpan
น้ำปา	na:mpa:
น้ำเป่า	na:mpao
น้ำมัน	na:mman
น้ำหนัก	na:mnak
น้ำอัดลม	na:matlom
นิยม	niyom
นิ้ว	niu
นิ้วก้อย	niugɔ:i
นิ้วกาง	niuga:ŋ
นิ้วซี้	niusi:
นิ้วตีน	niuti:n
นิ้วนาง	niuna:ŋ
นิ้วโป้	niupo:
นี้	ni:
นี้หละ	ni:la
นุ่งห่ม	nuŋhom
นุ้ม	num
นูน	nu:n
เน่า	nao
เนาะ	nɔ
เนิน	nə:n
เนินเขา	nə:nkhao
เนี้ย	ni:a
เนี้ย	ni:a
เนี้ยง	ni:aŋ
เนื้อหา	nʉ:aha:
แน่	nɛ:
แน่ใจ	nɛ:jai
แนบ	nɛ:p
แนม	nɛ:m
แนมเบิ่ง	nɛ:mbəŋ
แนว	nɛ:o
แนวกิน	nɛ:ogin
แนวโกนหนวด	nɛ:ogo:nnu:at
แนวขั้น	nɛ:okhan
แนวค้อง	nɛ:okhɔ:ŋ
แนวญก	nɛ:oɲok
แนวบำลุง	nɛ:obamluŋ
แนวบิด	nɛ:obit
แนวมัก	nɛ:omak
แนวใส่	nɛ:osai
แนวหนีบ	nɛ:oni:p
แนะนำ	nɛnam
โน่ดบุ่ก	no:tbuk
โนน	no:n
ใน	nai
ใน	nai
ในเมียง	naimi:aŋ
บ่	bɔ:
บก	bok
บ่ค่อย	bɔ:khɔ:i
บ่งบอก	boŋbɔ:k
บดบาด	botba:t
บ่ทันได้	bɔ:thandai
บ่แม่น	bɔ:mɛ:n
บวด	bu:at
บอก	bɔ:k
บอด	bɔ:t
บ่อน	bɔn
บอลิกาน	bɔ:liga:n
บอลิสุด	bɔ:lisut
บ่ฮู้อีโหน้อีเหน้	bɔ:hu:i:no:i:ne:
บัก	bak
บักเขียเคีย	bakkhi:akhi:a
บักคัก	bakkhak
บักคักหนึ่ง	bakkhaknʉŋ
บักจก	bakjok
บักแตง	baktɛ:ŋ
บักแตงโม	baktɛ:ŋmo:
บักนาว	bakna:o
บักพาย	bakpha:i
บักพ้าว	bakpha:o
บักพิก	bakphik
บักม่วง	bakmu:aŋ
บักหล้า	bakla:
บักหุ่ง	bakhuŋ
บัง	baŋ
บังคับ	baŋkhap
บัด	bat
บัดนี้	batni:
บัดหนิ	batni
บันจุ	banju
บันชี	banchi:
บันญากาด	banya:ga:t
บันได	bandai
บันทัด	banthat
บันทุก	banthuk
บันเทา	banthao
บัว	bu:a
บ่า	ba:
บ้า	ba:
บาง	ba:ŋ
บางสิ่งบางอย่าง	ba:ŋsiŋba:ŋya:ŋ
บาด	ba:t
บาด	ba:t
บ่าด	ba:t
บาท	ba:t
บาน	ba:n
บาน	ba:n
บ้าน	ba:n
บ้านนอก	ba:nnɔ:k
บ้านเมียง	ba:nmi:aŋ
บ้านเลียน	ba:nli:an
บ่าย	ba:i
บ่าไหล่	ba:lai
บิน	bin
บิน	bin
บินทะบาด	binthaba:t
บีบ	bi:p
บึ่ด	bʉt
บืน	bʉ:n
บุ	bu
บูชา	bu:cha:
บูด	bu:t
เบก	be:k
เบก	be:k
เบา	bao
เบาหวาน	baowa:n
เบาะ	bɔ
เบาะนั่ง	bɔnaŋ
เบิ่ง	bəŋ
เบิ่งแญง	bəŋɲɛ:ŋ
เบิด	bə:t
เบิด	bət
เบิดมื้อเบิดค่ำ	bətmʉ:bətkham
เบิ้น	bən
เบีย	bi:a
แบก	bɛ:k
แบ้ง	bɛŋ
แบ็ด	bɛt
แบ็ดเตอลี้	bɛttə:li:
แบน	bɛ:n
แบ็น	bɛn
แบนเนม	bɛ:nne:m
แบบ	bɛ:p
โบก	bo:k
โบด	bo:t
ใบ	bai
ใบ้	bai
ใบดอก	baidɔ:k
ใบไม้	baimai
ใบเส็ด	baiset
ใบหน้า	baina:
ไบบ่าย	baiba:i
ปก	pok
ปกกะติ	pokgati
ปน	pon
ปวด	pu:at
ป่วย	pu:ai
ปอก	pɔ:k
ป่อง	pɔŋ
ป่อง	pɔŋ
ป้องกัน	pɔŋgan
ปอดพัย	pɔ:tphai
ป่อน	pɔn
ป้อน	pɔ:n
ปอบ	pɔ:p
ป่อย	pɔ:i
ปะ	pa
ปะชาชน	pacha:chon
ปะดับ	padap
ปะติทิน	patithin
ปะติเสด	patise:t
ปะตู	patu:
ปะเทด	pathet
ปะมาน	pama:n
ปะโยก	payo:k
ปะโยด	payo:t
ปะลินญาโท	palinɲa:tho:
ปะลินญาเอก	palinɲa:e:k
ปะลิมาน	palima:n
ปะเลียน	pali:an
ปะโล่งโป่งเป่ง	palo:ŋpo:ŋpe:ŋ
ปะสา	pasa:
ปั่ก	pak
ปัดจุบัน	patjuban
ปัดโท	pattho:
ปั่น	pan
ปับ	pap
ปั้ม	pam
ปา	pa:
ป่า	pa:
ป้า	pa:
ปาก	pa:k
ปากกา	pa:kga:
ปากกืก	pa:kgʉ:k
ปากด	pa:got
ปากดี	pa:kdi:
ปากเป็น	pa:kpen
ปาด	pa:t
ป๊าด	pa:t
ปาแดก	pa:dɛ:k
ปาตี้	pa:ti:
ปานใด	pa:ndai
ปานนั้น	pa:nnan
ป่าไม้	pa:mai
ปาย	pa:i
ป้าย	pa:i
ปายทาง	pa:itha:ŋ
ปิด	pit
ปิดบัง	pitbaŋ
ปิว	piu
ปี	pi:
ปี้ๆ	pi:pi:
ปีก	pi:k
ปีน	pi:n
ปึก	pʉk
ปึ่กซึก	pʉksʉk
ปึกสา	pʉksa:
ปึ่บ	pʉp
ปืน	bʉ:n
ปุก	puk
ปุง	puŋ
ปุ่ม	pum
ปุย	pui
ปู	pu:
ปูก	pu:k
ปูน	pu:n
เป	pe:
เป่ง	peŋ
เป็ด	pet
เป็น	pen
เป็นที่เป็นทาง	penthi:pentha:ŋ
เปวไฟ	pe:ofai
เป่า	pao
เป่า	pao
เป้าหมาย	paoma:i
เปิด	pə:t
เปียก	pi:ak
เปียก	pi:ak
เปียง	pi:aŋ
เปี่ยง	pi:aŋ
เปี่ยน	pi:an
เปี้ยน	pi:an
เปียบเทียบ	pi:apthi:ap
เปี่ยย	pi:ai
เปี้ยว	pi:ao
แป	pɛ:
แป	pɛ:
แปง	pɛ:ŋ
แปงสีฟัน	pɛ:ŋsi:fan
แปด	pɛ:t
แปน	pɛ:n
แป้นพิม	pɛ:nphim
แป่บเดียว	pɛpdi:ao
ไป	pai
ไป่	pai
ผง	phoŋ
ผงชูลด	phoŋchu:lot
ผงสะหัว	phoŋsahu:a
ผนผะหลิด	phonphalit
ผนละไม้	phonlamai
ผม	phom
ผม	phom
ผะหลิด	phalit
ผัก	phak
ผักกะเสด	phakgase:t
ผักกาดขาว	phakga:tkha:o
ผักบุ้ง	phakbuŋ
ผักอี่เสด	phaki:se:t
ผัด	phat
ผัว	phu:a
ผ่า	pha:
ผ้า	pha:
ผ้าขนหนู	pha:khonnu:
ผ้าเซ็ดโต	pha:setto:
ผ่าน	pha:n
ผ้าปูโต่ะ	pha:pu:to
ผ้าม้าน	pha:ma:n
ผาย	pha:i
ผ้าห่ม	pha:hom
ผิดกดหมาย	phitgotma:i
ผิดใจ	phitjai
ผิว	piu
ผิวหนัง	phiunaŋ
ผืน	phʉ:n
ผูก	phu:k
เผ็ด	phet
เผา	phao
เผี้ย	phi:a
แผ	phɛ:
แผ่น	phɛn
แผนที่	phɛ:nthi:
แผนผัง	phɛ:nphaŋ
โผ่	pho:
ใผ	phai
ฝน	fon
ฝะลั่ง	falaŋ
ฝักบัว	fakbu:a
ฝั่ง	faŋ
ฝัน	fan
ฝา	fa:
ฝาก	fa:k
ฝ่าตีน	fa:ti:n
ฝาน	fa:n
ฝาผะหนัง	fa:pha:naŋ
ฝ่าย	fa:i
ฝิงไฟ	fiŋfai
เฝ้า	fao
พกพา	phokpha:
พวก	phu:ak
พวงมาลัย	phu:aŋma:lai
พวน	phu:an
พอ	phɔ:
พ่อ	phɔ:
พ้อ	phɔ:
พ่อค้า	phɔ:kha:
พอใจ	phɔ:jai
พอดี	phɔ:di:
พอน	phɔ:n
พอปะมาน	phɔ:pama:n
พ้อม	phɔ:m
พ้อม	phɔ:m
พ้อมกัน	phɔ:mgan
พ้อมเพียง	phɔ:mphi:aŋ
พอสมควน	phɔ:somkhu:an
พ่อใหญ่	phɔ:ɲai
พะ	pha
พะทัม	phatham
พะทาด	phatha:t
พะนม	phanom
พะนักงาน	phanakŋa:n
พะพุดทะเจ้า	phaphutthajao
พะพุดทะลูบ	phaphutthalu:p
พะม่า	phama:
พะยาบาน	phaya:ba:n
พะละกำลัง	phalagamlaŋ
พะลัง	phalaŋ
พะลังงาน	phalaŋŋa:n
พะสะติก	phasatik
พะอาทิด	phaa:thit
พะเอก	phae:k
พัก	phak
พัง	phaŋ
พัด	phat
พัดลม	phatlom
พัน	phan
พัน	phan
พับ	phap
พับเพียบ	phapphi:ap
พัย	phai
พั้ว	phu:a
พา	pha:
พาก	pha:k
พาเข้า	pha:khao
พาชะนะ	pha:chana
พาบ	pha:p
พาบถ่าย	pha:ptha:i
พาบวาด	pha:pwa:t
พาย	pha:i
พาย	pha:i
พาสา	pha:sa:
พาหะนะ	pha:hana
พิดสุนักบ้า	phitsunakba:
พิม	phim
พี้	phi:
พี่ซาย	phi:sa:i
พี่สาว	phi:sa:o
พึสะจิกาย๊น	phʉsajiga:yon
พึสะพาคม	phʉsapha:khom
พืด	phʉ:t
พื้น	phʉ:n
พื้นดิน	phʉ:ndin
พื้นที้	phʉ:nthi:
พุ	phu
พุข้า	phukha:
พุซาย	phusa:i
พุเดียว	phudi:ao
พุโดยสาน	phudo:isa:n
พุใด	phudai
พุเถ้า	phuthao
พุโถ	phutho:
พุ้น	phun
พุ้นหนะ	phunna
พุ้นหละ	phunla
พุ้นแหล้ว	phunlɛ:o
พุบ่าว	phuba:o
พุป่วย	phupu:ai
พุล้าย	phula:i
พุสาว	phusa:o
พุหญิง	phuɲiŋ
พุใหญ่	phuɲai
พุใหญ่บ้าน	phuɲaiba:n
พู	phu:
พูเขา	phu:khao
พูมใจ	phu:mjai
พูมถาน	phu:mtha:n
พูมิพาก	phu:mipha:k
เพ	phe:
เพง	phe:ŋ
เพงซาด	phe:ŋsa:t
เพ็ด	phet
เพดาน	phe:da:n
เพน	phe:n
เพาะว่า	phɔwa:
เพาะสะนั้นแล้ว	phɔsananlɛ:o
เพิง	phə:ŋ
เพิดเพิน	phə:tphə:n
เพิ่น	phən
เพิ้ม	phə:m
เพีย	phi:a
เพี่ย	phi:a
เพียง	phi:aŋ
เพื่อ	phʉ:a
เพื่อที่	phʉ:athi:
แพง	phɛ:ŋ
โพด	pho:t
โพดโพ	pho:tpho:
ไพเลาะ	phailɔ
ฟ้ง	foŋ
ฟอง	fɔ:ŋ
ฟองน้ำ	fɔ:ŋna:m
ฟัง	faŋ
ฟัน	fan
ฟัน	fan
ฟ้า	fa:
ฟ้าผ่า	fa:pha:
ฟ้าว	fa:o
ฟิ่ว	fiu
ฟิสิก	fisik
ฟืน	fʉ:n
ฟุดบาด	futba:t
ฟู	fu:
เฟอนิเจอ	fə:nijə:
เฟียง	fi:aŋ
แฟน	fɛ:n
แฟบ	fɛ:p
ไฟ	fai
ไฟแซ็ก	faisɛk
ไฟฟ้า	faifa:
มกกะลาคม	mokgala:khom
ม่น	mon
ม่วน	mu:an
ม่วน	mu:an
มวนอากาด	mu:ana:ga:t
มอ	mɔ:
มอเตอไซ	mɔ:tə:sai
มอบ	mɔ:p
มะละกอ	malagɔ:
มะเล็ด	malet
มะเล็ดพัน	maletphan
มะโล่งโจ่งเจ่ง	malo:ŋjo:ŋje:ŋ
มัก	mak
มัด	mat
มัน	man
มัว	mu:a
มั่วซั่ว	mu:asu:a
มา	ma:
ม้า	ma:
มากกว่า	ma:kgwa:
มากมาย	ma:kma:i
มาละย้าด	ma:laya:t
ม่ำ	mam
มิด	mit
มิดซิด	mitsit
มิถุนาย๊น	mithuna:yon
มี	mi:
มีด	mi:t
มีดโกน	mi:tgo:n
มีดโกนหนวด	mi:tgo:nnu:at
มีนา	mi:na:
มีนาคม	mi:na:khom
มีแฮง	mi:hɛ:ŋ
มึง	mʉŋ
มึน	mʉn
มืด	mʉ:t
มืน	mʉ:n
มือ	mʉ:
มื้อ	mʉ:
มื้อก่อน	mʉ:gɔ:n
มื้อแก้ง	mʉ:gɛ:ŋ
มื้อคืน	mʉ:khʉ:n
มื้อเซ้า	mʉ:sao
มื้อนี้	mʉ:ni:
มื้อแลง	mʉ:lɛ:ŋ
มื้อวาน	mʉ:wa:n
มื้อเว็น	mʉ:wen
มื้อหลัง	mʉ:laŋ
มื้ออื่น	mʉ:ʉ:n
มื้อฮือ	mʉ:hʉ:
มุง	muŋ
มุด	mut
มุ่น	mun
มุม	mum
เม็ด	met
เม็ดพัน	metphan
เม้ม	mem
เมสา	me:sa:
เมสาย๊น	me:sa:yon
เมา	mao
เมา	mao
เมีย	mi:a
เมียง	mi:aŋ
เมียงหลวง	mi:aŋlu:aŋ
เมี้ยน	mi:an
เมี่ยย	mi:ai
แม่	mɛ:
แม่ค้า	mɛ:kha:
แมง	mɛ:ŋ
แมงวัน	mɛ:ŋwan
แมงหวี่	mɛ:ŋwi:
แม่ซี	mɛ:si:
แม่น	mɛ:n
แม่นบ่	mɛ:nbɔ:
แม่น้ำ	mɛ:na:m
แม่บ้าน	mɛ:ba:n
แมว	mɛ:o
แม่หญิง	mɛ:ɲiŋ
โมง	mo:ŋ
โมโห	mo:ho:
ไม	ma:i
ไม้	mai
ไม้ขีด	maikhi:t
ไม้ไผ่	maiphai
ย๊น	yon
ยอก	yɔ:k
ย่อน	yɔn
ยัง	yaŋ
ยา	ya:
ยาง	ya:ŋ
ย้าง	ya:ŋ
ยาดโย๊ม	ya:tyo:m
ย้าน	ya:n
ยานพาหะนะ	ya:npha:hana
ยาสีฟัน	ya:si:fan
ยินดี	yindi:
ยิ้ม	yim
ยี้บ	yi:p
ยี้สิบ	yi:sip
ยี่ห้อ	yi:hɔ:
ยี้ฮ้อ	yi:hɔ:
ยืน	yʉ:n
ยื่น	yʉ:n
เย็น	yen
แย้ก	yɛ:k
ลง	loŋ
ลงทุน	loŋthun
ลด	lot
ลด	lot
ลด	lot
ลดกะบะ	lotgaba
ลดเก็ง	lotgeŋ
ลดขนของ	lotkhonkhɔ:ŋ
ลดเข็น	lotkhen
ลดซาด	lotsa:t
ลดตุ่กตุ่ก	lottuktuk
ลดตู้	lottu:
ลดไถ	lotthai
ลดแท็กซี้	lotthɛksi:
ลดบั่ด	lotbat
ลดบันทุก	lotbanthuk
ลดปะจำทาง	lotpajamtha:ŋ
ลดพิกอั่บ	lotphikap
ลดไฟ	lotfai
ลดเม	lotme:
ลดยน	lotyon
ลดลับส่ง	lotlapsoŋ
ลดโลงบาน	lotlo:ŋba:n
ลดโลงพะยาบาน	lotlo:ŋphaya:ba:n
ลดสามล้อ	lotsa:mlɔ:
ลดสิบล้อ	lotsiplɔ:
ล้น	lon
ลบ	lop
ลม	lom
ลวก	lu:ak
ลวดลาย	lu:atla:i
ลวม	lu:am
ล่วมกัน	lu:amgan
ลวย	lu:ai
ล้อ	lɔ:
ล็อก	lɔk
ลอง	lɔ:ŋ
ล้อง	lɔ:ŋ
ลองเท้าผ้าใบ	lɔ:ŋthaopha:bai
ลอด	lɔ:t
ลอบ	lɔ:p
ล้อม	lɔ:m
ล้อมลอบ	lɔ:mlɔ:p
ลอย	lɔ:i
ล้อย	lɔ:i
ละ	la
ละเกะละกะ	lagelaga
ละคอน	lakhɔ:n
ละงับ	laŋap
ละบาย	laba:i
ละเบียง	labi:aŋ
ละเบียบ	labi:ap
ละยะ	laya
ละลาย	lala:i
ละวัง	lawaŋ
ละว่าง	lawa:ŋ
ละแวก	lawɛ:k
ละเหย	lahə:i
ละเหล้น	lalen
ลัก	lak
ลักสะนะ	laksana
ลักสา	laksa:
ลัง	laŋ
ลับ	lap
ลับจ้าง	lapja:ŋ
ลับลู้	laplu:
ลับส่ง	lapsoŋ
ล้า	la:
ลาก	la:k
ลาคา	la:kha:
ลาง	la:ŋ
ล้าง	la:ŋ
ล้าง	la:ŋ
ล้างกาย	la:ŋga:i
ลาด	la:t
ลาน	la:n
ล้าน	la:n
ล้าน	la:n
ล้านขายของ	la:nkha:ikhɔ:ŋ
ล้านตัดผม	la:ntatphom
ล้านแนวกิน	la:nnɛ:ogin
ล้านอาหาน	la:na:ha:n
ล้าย	la:i
ลายกาน	la:iga:n
ลายได้	la:idai
ลาว	la:o
ลาวๆ	la:ola:o
ลำ	lam
ลำ	lam
ลำคาน	lamkha:n
ลำต้น	lamton
ลำโต	lamto:
ลำโพง	lampho:ŋ
ลำไย	lamyai
ลำไส้	lamsai
ลิง	liŋ
ลิน	lin
ลิ้น	lin
ลิ้นชัก	linchak
ลิบบิ้น	lipbin
ลี้	li:
ลีไซเคิน	li:saikən
ลีโหมด	li:mo:t
ลึก	lʉk
ลึดู	lʉdu:
ลึดูฝน	lʉdu:fon
ลึดูแล้ง	lʉdu:lɛ:ŋ
ลึดูฮ้อน	lʉdu:hɔ:n
ลืม	lʉ:m
ลุก	luk
ลุง	luŋ
ลุน	lun
ลุ้น	lun
ลุล่วง	lulu:aŋ
ลู้	lu:
ลูก	lu:k
ลูกกก	lu:kgok
ลูกค้า	lu:kkha:
ลูกซาย	lu:ksa:i
ลูกซิ้น	lu:ksin
ลูกบอน	lu:kbɔ:n
ลูกสอน	lu:ksɔ:n
ลูกสาว	lu:ksa:o
ลูกหวีด	lu:kwi:t
ลู้จัก	lu:jak
ลูบ	lu:p
ลูบ	lu:p
ลูบแบบ	lu:pbɛ:p
ลูบพาบ	lu:pphap
ลูบพาบถ่าย	lu:ppha:ptha:i
ลูบลัก	lu:plak
ลู้สึก	lu:sʉk
เล็ก	lek
เลข	le:k
เลน	le:n
เล็บ	lep
เล็บตีน	lepti:n
เลย	lə:i
เลว	le:o
เล็ว	leo
เลาะ	lɔ
เลิก	lə:k
เลิ้ม	lə:m
เลีย	li:a
เลียก	li:ak
เลียง	li:aŋ
เลี่ยง	li:aŋ
เลี้ยง	li:aŋ
เลียด	li:at
เลียน	li:an
เลี้ยน	li:an
เลียบ	li:ap
เลียบ	li:ap
เลียบล้อย	li:aplɔ:i
เลี้ยยๆ	li:ai
แลก	lɛ:k
แลง	lɛ:ŋ
แล่น	lɛ:n
แลบลิ้น	lɛ:plin
แล้ว	lɛ:o
แล้วแต่	lɛ:otɛ:
และ	lɛ
โล	lo:
โลก	lo:k
โลก	lo:k
โล้ง	lo:ŋ
โล่งโจ่ง	lo:ŋjo:ŋ
โลงบาน	lo:ŋba:n
โลงพะยาบาน	lo:ŋphaya:ba:n
โลงเลียน	lo:ŋli:an
โลงหนัง	lo:ŋnaŋ
โลตั่ด	lo:tat
โล้น	lo:n
ไล่	lai
วง	woŋ
วงกม	woŋgom
วงเล็บ	woŋlep
ว้อ	wɔ:
วะสั้น	wasan
วั่งหั้น	waŋhan
วัด	wat
วัดทะนะทัม	watthanatham
วัน	wan
วันเกิด	wangə:t
วันจัน	wanjan
วันพะ	wanpha
วันพะลึหัด	wanphalʉhat
วันพุด	wanphut
วันสุก	wansuk
วันเสา	wansao
วันอังคาน	wanaŋkha:n
วันอาทิด	wana:thit
วัย	wai
วัยทอง	waithɔ:ŋ
วัยลุ้น	wailun
วา	wa:
ว่า	wa:
วาง	wa:ŋ
ว้าง	wa:ŋ
วาจา	wa:ja:
วาด	wa:t
ว่าแต่	wa:tɛ:
วิชา	wicha:
วิดีโอ	widi:o:
วิทะยุ	withayu
วิที	withi:
วินาที	wina:thi:
เวลา	we:la:
เว้า	wao
เว้าพื้น	waophʉ:n
เวียดนาม	vi:atna:m
แว่นตา	wɛnta:
ไว	wai
ไว้	wai
ไว้ถ้า	waitha:
สกกะปก	sokgapok
ส่ง	soŋ
ส้ง	soŋ
สงคาม	soŋkha:m
สงสัย	soŋsai
สด	sot
สดซื้น	sotsʉ:n
สดใส	sotsai
ส้น	son
สนทะนา	sonthana:
สบ	sop
ส้ม	som
ส้ม	som
ส้มตำ	somtam
สมมุด	sommut
สวด	su:at
สวน	su:an
ส่วน	su:an
ส่วนโต	su:anto:
ส่วนปะกอบ	su:anpagɔ:p
ส่วนมาก	su:anma:k
สวนสัด	su:ansat
ส่วนหน้อย	su:annɔ:i
ส่วนหลาย	su:anla:i
สอก	sɔ:k
สอง	sɔ:ŋ
ส่อง	sɔŋ
สอด	sɔ:t
สอน	sɔ:n
สอบ	sɔ:p
ส้อม	sɔm
ส้อม	sɔm
ส้อมแซม	sɔmsɛ:m
ส้อย	sɔ:i
สะ	sa
สะ	sa
สะดวก	sadu:ak
สะดุด	sadut
สะแดง	sadɛ:ŋ
สะถานที่	satha:nti:
สะถานะกาน	satha:naga:n
สะถานี	satha:ni:
สะบาย	saba:i
สะบู	sabu:
สะพาน	sapha:n
สะพาย	sapha:i
สะมะแจะ	samajɛ
สะมาชิก	sama:chik
สะวิด	sawit
สะหนาม	sana:m
สะหนามกีลา	sana:mgi:la:
สะหนิด	sanit
สะหมอง	samɔ:ŋ
สะหมัย	samai
สะหมุด	samut
สะหมุนไพ	samunphai
สะหลิด	salid
สะหลึง	salʉŋ
สะหลุบ	salup
สะหวัดดี	sawatdi:
สะหว่าง	sawa:ŋ
สะหว้ายน้ำ	sawa:ina:m
สะออน	saɔ:n
สะอาด	saa:t
สะอาดหูสะอาดตา	saa:thu:saa:tta:
สักสิด	saksit
สั่ง	saŋ
สังสัน	saŋsan
สัด	sat
สัดเคิ่งบกเคิ่งน้ำ	satkhəŋbokkhəŋna:m
สัดเลี้ยง	satli:aŋ
สัน	san
สั่น	san
สั้น	san
สันญะลัก	sanɲalak
สันญาน	sanɲa:n
สันยะกัม	sanyagam
สับ	sap
สาก	sa:k
ส้าง	sa:ŋ
สาด	sa:t
สาม	sa:m
สามแย้ก	sa:myɛ:k
สามสิบ	sa:msip
สามเหลี่ยม	sa:mli:am
สามาด	sa:ma:t
สาย	sa:i
สาย	sa:i
ส่าย	sa:i
สายไฟ	sa:ifai
สาละ	sa:la
สาละคะดี	sa:lakadi:
สาลา	sa:la:
สาลาวัด	sa:la:wat
สาสะนา	sa:sana:
สาสะนาพุด	sa:sana:phut
ส่ำ	sam
สำคัน	samkhan
ส่ำนั้น	samnan
ส่ำนี้	samni:
สำลอง	samlɔ:ŋ
สำหลับ	samlap
สิ	si
สิ่ง	siŋ
สิ่งของ	siŋkhɔ:ŋ
สิงหาคม	siŋha:khom
สิ้น	sin
สิบ	sip
สี	si:
สี่	si:
สีก	si:k
สีดยา	si:tya:
สีตับหมู	si:tapmu:
สีน	si:n
สีสัน	si:san
สี่สิบ	si:sip
สีหน้า	si:na:
สีหน้าสีตา	si:na:si:ta:
สี่เหลี่ยม	si:li:am
สึกสา	sʉksa:
สึม	sʉm
สุก	suk
สุกขะพาบ	sukkhapha:p
สุข	suk
สุด	sut
สุดท้อง	sutthɔ:ŋ
สุบ	sup
สุพาบ	supha:p
สู่	su:
สู้	su:
สูง	su:ŋ
สูด	su:t
สูน	su:n
สูบ	su:p
เสด	se:t
เส็ด	set
เส้น	sen
เสย	sə:i
เสา	sao
เส้า	sao
เสิบ	sə:p
เสิมสวย	sə:msu:ai
เสีย	si:a
เสีย	si:a
เสี้ย	si:a
เสี้ยเกาะอก	si:agɔok
เสียง	si:aŋ
เสี่ยง	si:aŋ
เสียงดัง	si:aŋdaŋ
เสียใจ	si:ajai
เสียบ	si:ap
เสี้ยผ้า	si:apha:
เสี้ยยื้ด	si:ayʉ:t
เสี้ยว	si:ao
เสียหลัก	si:alak
เสียหาย	si:aha:i
แสง	sɛ:ŋ
ใส	sai
ใส	sai
ใส่	sai
หก	hok
หงอก	ŋɔ:k
หงอน	ŋɔ:n
หญ้ม	ɲom
หญอง	ɲɔŋ
หญัง	ɲaŋ
หญ้า	ɲa:
หญุ้ง	ɲuŋ
หญุ้งญาก	ɲuŋɲa:k
หนทาง	hontha:ŋ
หนวด	nu:at
หนอง	nɔ:ŋ
หน่อย	nɔ:i
หน้อย	nɔ:i
หน่อยเดียว	nɔ:idi:ao
หน่อยหนึ่ง	nɔ:inʉŋ
หนะ	na
หนัก	nak
หนัง	naŋ
หนังสือ	naŋsʉ:
หนังสือพิม	naŋsʉ:phim
หนั้น	nan
หนั้นหละ	nanla
หนา	na:
หน้า	na:
หน้าจอ	na:jɔ:
หน้าจะ	na:ja
หน้าตา	na:ta:
หน้าต่าง	na:ta:ŋ
หน้าที่	na:thi:
หน้าผาก	na:pha:k
หน้าฝน	na:fon
หน้าแล้ง	na:lɛ:ŋ
หนาว	na:o
หน้าหนาว	na:na:o
หน้าเอิก	na:ək
หน้าฮ้อน	na:hɔ:n
หนิ	ni
หนิหละ	nila
หนี	ni:
หนี้	ni:
หนีบ	ni:p
หนึ่ง	nʉŋ
หนุ่ม	num
ห่ม	hom
หม้น	mon
หมวก	mu:ak
หมวกกันน็อก	mu:akgannɔk
หมอ	mɔ:
หม้อ	mɔ:
หมอง	mɔ:ŋ
หม้อง	mɔŋ
หมอน	mɔ:n
หมอฟัน	mɔ:fan
หมั้น	man
หมั้นใจ	manjai
หมา	ma:
หมากไม้	ma:kmai
หมาด	ma:t
หมายความ	ma:ikhwa:m
หมายถึง	ma:ithʉŋ
หมื่น	mʉ:n
หมุน	mun
หมุน	mun
หมู	mu:
หมู่	mu:
หมู่บ้าน	mu:ba:n
หยาบ	ya:p
หยิบ	yip
หยุด	yut
หลก	lok
หลงเหลีย	loŋli:a
หล่น	lon
หลบ	lop
หลบซ้อน	lopsɔn
หล่อ	lɔ:
หลอด	lɔ:t
หล่อเลี้ยง	lɔ:li:aŋ
หละ	la
หลัก	lak
หลักอากาด	laka:ga:t
หลัง	laŋ
หลังกะสี	laŋgasi:
หลังคา	laŋka:
หลังจาก	laŋja:k
หลับ	lap
หล้า	la:
หลาน	la:n
หลาย	la:i
หลายเติบ	la:itə:p
หลายสิ่งหลายอย่าง	la:isiŋla:iya:ŋ
หลือ	lʉ:
หลุด	lut
หลุดมือ	lutmʉ:
หลุม	lum
หวอ	wɔ:
หวัดดี	watdi:
หวาน	wa:n
หว่าน	wa:n
หว้าย	wa:i
หว้ายน้ำ	wa:ina:m
หวี	wi:
หอ	hɔ:
ห่อ	hɔ:
ห้อง	hɔŋ
ห้องนอน	hɔŋnɔ:n
ห้องน้ำ	hɔŋna:m
ห้องเลียน	hɔŋli:an
ห้องสะหมุด	hɔŋsamut
หอบ	hɔ:p
หอม	hɔ:m
หอม	hɔ:m
หอมหัวแดง	hɔ:mhu:adɛ:ŋ
ห้อย	hɔ:i
หอั้น	an
หัก	hak
หัน	han
หั่น	han
หั้น	han
หันใจ	hanjai
หัว	hu:a
หัว	hu:a
หัว	hu:a
หัวขวัน	hu:akwan
หัวเข่า	hu:akhao
หัวใจ	hu:ajai
หัวเตอะหัวเติน	hu:atəhu:atə:n
หัวล้อ	hu:alɔ:
หัวหน้า	hu:ana:
หัวหอม	hu:ahɔ:m
หา	ha:
ห้า	ha:
หาง	ha:ŋ
ห่าง	ha:ŋ
ห้าง	ha:ŋ
หาย	ha:i
หายใจ	ha:ijai
ห้าสิบ	ha:sip
หิน	hin
หิว	hiu
หิ้ว	hiu
หุ่น	hun
หุ้ม	hum
หู	hu:
หูจับ	hu:jap
หูฟัง	hu:faŋ
หูหนวก	hu:nu:ak
เหงี่ย	ŋi:a
เหงียก	ŋi:ak
เหด	he:t
เหดกาน	he:tga:n
เหดผน	he:tphon
เหดล้าย	he:tla:i
เห็น	hen
เหน้ก	nek
เหม้	me:
เหม็น	men
เหมาะสม	mɔsom
เหมิกเถิก	mə:kthə:k
เหยียด	yi:at
เหยียบ	yi:ap
เหล็ก	lek
เหล้น	len
เหล้ม	lem
เหลว	le:o
เหล้า	lao
เหลีย	li:a
เหลียง	li:aŋ
เหลียน	li:an
เหลี่ยม	li:am
เหลียว	li:ao
เห่า	hao
เหี่ย	hi:a
แห่ง	hɛŋ
แห้ง	hɛ:ŋ
แห้งแล้ง	hɛ:ŋlɛ:ŋ
แห้น	hɛ:n
แหน้น	nɛn
แหลก	lɛ:k
แหลม	lɛ:m
แหล้ว	lɛ:o
แหวน	wɛ:n
แหวว	wɛ:o
ให้	hai
ใหญ่	ɲai
ใหม่	mai
ไหน	nai
ไหม้	mai
ไหล	lai
ไหล่	lai
ไหล้	lai
ไหว	wai
ไหว้	wai
ไหว้พะ	waipha
อก	ok
อง	oŋ
องสา	oŋsa:
อบอุ่น	opun
อ่มๆ	om
อย่า	ya:
อยาก	ya:k
อยากหัว	ya:khu:a
อย่าง	ya:ŋ
อย่างเซ้น	ya:ŋsen
อย่างเดียว	ya:ŋdi:ao
อย่างหลาย	ya:ŋla:i
อยู่	yu:
อ้วน	u:an
อ่วย	u:ai
ออก	ɔ:k
ออกกำลังกาย	ɔ:kgamlaŋga:i
อ่องต่อง	ɔŋtɔŋ
อ่อน	ɔ:n
ออนสอน	ɔ:nsɔ:n
อ้อม	ɔ:m
อ้อยต้อย	ɔ:itɔ:i
อะดีด	adi:t
อะทิดถาน	athittha:n
อะทิบาย	athiba:i
อะนาคด	ana:khot
อะพิทัม	aphitham
อะวัยยะวะ	awaiyawa
อักสน	aksɔ:n
อังกิด	aŋgit
อัด	at
อัน	an
อันตะลาย	antala:i
อันแต่ว่า	antɛ:wa:
อับ	ap
อา	a:
อ้า	a:
อากาด	a:ga:t
อากาน	a:ga:n
อ่าง	a:ŋ
อ่างล้างหน้า	a:ŋla:ŋna:
อาจาน	a:ja:n
อาซีบ	a:si:p
อาด	a:t
อาดจะ	a:tja
อาทิ	a:thi
อาทิด	a:thit
อ่าน	a:n
อาบ	a:p
อาบน้ำ	a:pna:m
อ่ามล่าม	a:mla:m
อ้าย	a:i
อายุ	a:yu
อาลม	a:lom
อาวุโส	a:wuso:
อาสัย	a:sai
อาหาน	a:ha:n
อำเพอ	amphə:
อิ่จิ่หนึ่ง	ijinʉŋ
อิด	it
อิ่ม	im
อีก	i:k
อี่เกิ้ง	i:gə:ŋ
อี่ปู	i:pu:
อี่แม่	i:mɛ:
อี่สาน	i:sa:n
อี่หยัง	i:yaŋ
อี่หล้า	i:la:
อี่หลี	i:li:
อี่หลีอี่หลอ	i:li:i:lɔ:
อึ้งตึ้ง	ʉŋtʉŋ
อึ้มคึ้ม	ʉmkhʉm
อื่น	ʉ:n
อุดมสมบูน	udomsombu:n
อุ่น	un
อุบะติเหด	ubatihe:t
อุปะกอน	upagɔ:n
อุ้ม	um
อุ้ย	ui
อุ้ยปุ้ย	uipui
เอง	e:ŋ
เอเซีย	e:si:a
เอ็ด	et
เอทีเอ็ม	e:thi:em
เอน	e:n
เอ้ม	em
เอ่ย	ə:i
เอ่ย	ə:i
เอ้ย	ə:i
เออ	ə:
เอ้อเฮ้อ	ə:hə:
เอา	ao
เอา	ao
เอ๊า	ao
เอาโลด	aolo:t
เอ่าะเจ่าะ	ɔjɔ
เอ่าะเญาะ	ɔɲɔ
เอิก	ək
เอิ้น	ə:n
เอี่ยม	i:am
เอื้อย	ʉ:ai
แอ	ɛ:
แอ็นกอฮอ	ɛngɔ:hɔ:
แอ็ปเปิ้น	ɛppən
แออัด	ɛ:at
โอ	o:
โอกาด	o:ga:t
โอ่ง	o:ŋ
โอ่งโล่ง	o:ŋlo:ŋ
โอน	o:n
โอ๊ย	o:i
ไอ	ai
ไอติม	aitim
ไอน้ำ	aina:m
ฮ่ม	hom
ฮวมกัน	hu:amgan
ฮอง	hɔ:ŋ
ฮ้อง	hɔ:ŋ
ฮ้องไห้	hɔ:ŋhai
ฮอด	hɔ:t
ฮ่อน	hɔn
ฮ้อน	hɔ:n
ฮอย	hɔ:i
ฮัก	hak
ฮับ	hap
ฮั่ว	hu:a
ฮั้ว	hu:a
ฮาก	ha:k
ฮ้าง	ha:ŋ
ฮาน	ha:n
ฮ้าน	ha:n
ฮ้าย	ha:i
ฮาว	ha:o
ฮำ	ham
ฮึ	hʉ
ฮึ่มๆ	hʉm
ฮุ	hu
ฮุ่ง	huŋ
ฮู้	hu:
ฮู้จัก	hu:jak
ฮูด	hu:t
ฮู้สึก	hu:sʉk
ฮู้สึกโต	hu:sʉkto:
เฮ็ด	het
เฮ็ดกานเฮ็ดงาน	hetga:nhetŋa:n
เฮ็ดงาน	hetŋa:n
เฮ็ดนา	hetna:
เฮ็ดบุน	hetbun
เฮ็ดไฮ่	hethai
เฮ้ย	hə:i
เฮา	hao
เฮียง	hi:aŋ
เฮียน	hi:an
แฮง	hɛ:ŋ
ไฮ่	hai
