abantu	aɓáːntu
amabele	amáɓeːlé
amabele	ámaɓéːle
amabhanqa	ámabáːᵑǃa
amafutha	ámafûːtʰa
amagcino	amáᶢǀʱiːno
amahlebezi	amáɬeɓeːzí
amahloni	ámaɬôːni
amakha	ámaːkʰá
amakhaza	ámakʰâːza
amakhosi	ámáꜜkʰóːsí
amakhwezikhwezi	ámakʰwezikʰwêːzi
amala	amáːla
amandla	amáːnɮa
amanga	amáːnga
amanqamu	amáᵑǃaːmú
amanyala	amáɲaːlá
amanzi	ámáːnzi
amatata	amátaːtá
amathe	ámaːtʰé
ayina	ʔajiːna
bana	ɓáːna
bayede	ɓajéːde
be	ɓe
bona	ɓoːná
botswana	ɓôːtsʼʷaːna
buhlungu	ɓuɬûːngu
cha	ǀʰá
cishe	ǀíːʃe
cwala	ǀwaːla
cwecwa	ǀweːǀwa
cwila	ǀwiːla
cwilisa	ǀwiliːsa
c	ǀ
dabuka	daɓuːɠa
dana	daːna
dladla	ɮʱaːɮa
dlala	ɮʱaːla
dla	ɮa
dlamini	ɮʱamiːni
dlwengula	ɮwenguːla
duma	dúːma
dwa	dwa
ebula	eɓuːla
ebuza	eɓuːza
egoli	ɛgɔːli
eluka	eluːɠa
engeza	engeːza
ethwasa	etʰwaːsa
funa	fûːna
futhi	fuːtʰi
futhi	fúːtʰi
fuya	fúːja
gaya	gaːja
gcoba	ᶢǀʱôːɓa
gcwalisa	ᶢǀʱwalíːsa
gqagqa	ᶢǃʱáːᶢǃʱa
gqagqaza	ᶢǃʱaᶢǃʱáːza
gqaja	ᶢǃʱaːdʒa
gqama	ᶢǃʱaːma
gqamuka	ᶢǃʱamúːɠa
gqekeza	ᶢǃʱeɠeːza
gqola	ᶢǃʱoːla
gqula	ᶢǃʱuːla
gqwala	ᶢǃʱwaːla
gwansa	gwaːnsa
gwavuma	gwavuːma
gwaza	gwáːza
gwedla	gweːɮa
gwema	gwéːma
gwinqa	gwiːᵑǃa
gwinya	gwiːɲa
gxeka	ᶢǁʱeːɠa
gxila	ᶢǁʱiːla
hambakahle	hámbaɠaːɬé
hambanikahle	hambániɠaːɬé
hawu	hǎːwu
hlafuna	ɬafuːna
hleka	ɬeːɠa
hleze	ɬéːze
hlikihla	ɬiɠiːɬa
hlobonga	ɬoɓoːnga
hlonipha	ɬoníːpʰa
ibala	îːɓâːla
ibalazwe	îːɓaláːzwe
ibandla	íɓâːnɮa
ibele	îːɓéːle
ibhaka	íːbaːɠá
ibhakede	iːbaɠêːde
ibhala	îːbáːla
ibhanoyi	îːbanóːji
ibhantshi	îːbáːɲtʃi
ibhasi	îːbáːsi
ibhayibheli	îːbajíbeːli
ibhayisikili	îːbajisíkiːli
ibhayisikobho	îːbajísikóːbo
ibhaza	îːbazâː
ibhentshi	îːbéːɲtʃi
ibhimbi	îːbîːmbi
ibhodi	îːbôːdi
ibhodlela	iːbóɮeːla
ibhodlo	íːboːɮo
ibhodwe	íːboːdwé
ibhokisi	iːboɠîːsi
ibhola	îːbóːla
ibhomu	îːbôːmu
ibhotela	îːbotêːla
ibhubesi	iːbuɓêːsi
ibhudla	îːbûːɮa
ibhuku	îːbûːɠu
ibhulakufesi	îːbulaɠúfeːsi
ibhulashi	îːbuláːʃi
ibhuleki	îːbuléːɠi
ibhulukwe	îːbulúːɠwe
ibhungane	îːbungâːne
ibhunu	îːbûːnu
ibizo	îːɓîːzo
ibomvu	íːɓoːmvú
ibululu	îːɓúluːlú
ibumba	îːɓûːmba
ibunzi	îːɓúːnzi
icala	íːǀaːlá
icala	íːǀâːla
icebo	îːǀéːɓo
icele	íːǀeːlé
ichibi	íːǀʰiːɓí
ichopho	íːǀʰoːpʰo
ichwane	îːǀʰwáːne
icici	îːǀíːǀi
icilongo	îːǀilóːngo
icukazi	îːǀúɠaːzi
iculo	íːǀuːlo
idada	íːdaːda
idesiki	iːdesîːɠi
idikazi	iːdiɠâːzi
idimoni	iːdimôːni
idlaka	íːɮaːɠá
idlozi	íːɮoːzi
idolobha	iːdolôːba
idolo	íːdoːlo
idube	îːdúːɓe
iduku	îːdûːɠu
idwala	íːdwaːlá
idweshu	îːdwéːʃu
ifa	îːfá
ifilimu	iːfíliːmu
ifleyistata	iflejistaːta
ifosholo	iːfóʃoːlo
ifotho	îːfóːtʰo
ifu	íːfu
ifulentshi	îːfuléːɲtʃi
igagasi	iːgágaːsi
igalaji	iːgalâːdʒi
igalofu	iːgalôːfu
igama	îːgâːma
iganu	íːgaːnú
igazi	íːgaːzí
igceke	íːᶢǀʱeːɠe
igciwane	íːᶢǀʱiwáːne
igcukumuva	íːᶢǀʱuɠumuːvá
igedlela	iːgéɮeːla
igeja	íːgeːdʒa
igeza	íːgeːza
igilavu	îːgilâːvu
igilebhisi	îːgilébiːsi
igobongo	îːgoɓóːngo
igola	îːgóːla
igolide	îːgolíːde
igoli	îːgóːli
igoli	îːgóːli
igoqo	îːgóːǃo
igqubu	íːᶢǃʱuːɓú
igquma	îːᶢǃʱûːma
igqwetha	íːᶢǃʱweːtʰá
igugu	íːguːgu
igula	îːgúːla
igumbi	îːgúːmbi
igundane	iːgúndaːne
igundwane	iːgúndwaːne
igwababa	îːgwaɓáːɓa
igwala	íːgwaːlá
igwebu	íːgweːɓu
igwenya	îːgwêːɲa
igwinya	íːgwiːɲá
igxolo	îːᶢǁʱôːlo
ihansi	îːháːnsi
ihawa	îːháːwa
ihembe	îːhéːmbe
ihhala	îːɦáːla
ihhashi	îːɦáːʃi
ihhofu	îːɦóːfu
ihhoko	íːɦoːɠo
ihholo	îːɦóːlo
ihhotela	îːɦotéːla
ihhovisi	iːɦóviːsi
ihlahla	íːɬaːɬa
ihlakani	îːɬaɠâːni
ihlathi	îːɬâːtʰi
ihlaya	íːɬaːjá
ihlelo	íːɬeːlo
ihlengethwa	iːɬéngeːtʰwa
ihlezi	íːɬeːzi
ihlobo	íːɬoːɓo
ihlo	îːɬo
ihlombe	îːɬôːmbe
ihlumela	îːɬúmeːlá
iholide	iːhóliːde
ihora	îːhóːra
ihubo	íːhuːɓo
ijaji	îːdʒáːdʒi
ijazi	îːdʒáːzi
ijele	îːdʒêːle
ijezi	íːdʒeːzí
ijokwe	îːdʒóːɠwe
ijongosi	iːdʒóngoːsi
ijuba	íːdʒuːɓa
ijubane	îːdʒuɓâːne
ikalikuni	íːkalikúːni
ikamela	iːkámeːla
ikati	îːkáːti
ikatshana	îːkátʃaːna
ikesi	îːkéːsi
ikewu	îːkéːwu
ikhabe	îːkʰáːɓe
ikhabethe	iːkʰáɓeːtʰe
ikhala	íːkʰaːla
ikhalenda	iːkʰáleːnda
ikhanda	îːkʰâːnda
ikhangaru	iːkʰángaːru
ikhanjana	îːkʰaɲdʒáːna
ikhanzi	îːkʰáːnzi
ikhaphethe	iːkʰápʰeːtʰe
ikhasi	íːkʰaːsi
ikhasimende	îːkʰasiméːnde
ikhaya	îːkʰâːja
ikhefu	íːkʰeːfu
ikhehla	íːkʰeːɬá
ikheji	îːkʰéːdʒi
ikhekheba	îːkʰekʰêːɓa
ikhekhe	îːkʰéːkʰe
ikheli	îːkʰéːli
ikhemese	iːkʰémeːse
ikhethini	iːkʰétʰiːni
ikhishi	íːkʰiːʃi
ikhiwane	íːkʰiwáːne
ikholwase	îːkʰolwáːse
ikhonsathi	iːkʰónsaːtʰi
ikhukhamba	îːkʰukʰáːmba
ikhukhu	íːkʰuːkʰu
ikhulu	îːkʰûːlu
ikhwapha	íːkʰwaːpʰá
ikhweza	îːkʰwéːza
ikhwezi	îːkʰwêːzi
ikhwilithi	iːkʰwíliːtʰi
ikilasi	îːkiláːsi
ikilogo	îːkilóːgo
iklabishi	iːkxáɓiːʃi
iklwa	îːkxwá
ilahle	îːlâːɬe
ilanga	íːlaːnga
ilantshi	îːláːɲtʃi
ilayisense	iːlajíseːnse
ilayisi	iːlájiːsi
ilembe	íːleːmbé
ilisho	íːliːʃó
ilobolo	îːloɓóːlo
ilokhuzane	ilokʰuzaːne
ilokwe	îːlóːɠwe
iloli	íːloːlí
ilulwane	îːlulwâːne
ilungelo	iːlúngeːlo
imadlana	ímaɮáːna
imali	ímaːlí
imamba	ímâːmba
imayela	iːmájeːla
imbabala	ímbaɓaːlá
imbala	ímbâːla
imbali	ímbaːli
imbambe	ímbaːmbe
imbasa	ímbaːsa
imbazo	ímbaːzo
imbenge	ímbéːnge
imbewu	ímbêːwu
imbila	ímbiːla
imbiza	ímbiːzá
imbizo	ímbíːzo
imbodla	ímboːɮá
imbongi	ímboːngi
imbongolo	imbóngoːlo
imboni	ímbóːni
imbovane	ímbováːne
imbube	ímbuːɓé
imbungulu	ímbúnguːlú
imbuya	ímbuːja
imbuzana	ímbuzáːna
imbuzane	imbúzaːne
imbuzi	ímbûːzi
imbuzikazi	ímbuziɠâːzi
imelika	iːméliːɠa
imfene	ímfeːne
imfihlo	ímfîːɬo
imfologo	imfóloːgo
imfoloko	imfóloːɠo
imfolozi	ímfóloːzí
imfuluwenza	ímfuluwéːnza
imfundo	ímfúːndo
imfuyo	ímfúːjo
imini	ímíːni
iminithi	iːmíniːtʰi
imoto	ímóːto
impahla	ímpaːɬa
impakama	ímpaɠáːma
impakathi	ímpáɠaːtʰí
impala	ímpaːla
impalampala	impalámpaːla
impambosi	ímpámboːsi
impande	ímpâːnde
impangele	ímpangêːle
impela	íᵐpʼéːla
impelesi	impéleːsi
impempe	ímpéːmpe
impendulo	impénduːlo
impi	îːmpí
impilo	ímpiːlo
impisi	ímpîːsi
impofu	ímpôːfu
impohlo	ímpoːɬo
impongo	ímpóːngo
impophoma	impópʰoːma
impoqo	ímpoːǃo
impuco	ímpuːǀo
impukane	ímpuɠáːne
impumalanga	ímpumálaːnga
impumalanga	ímpumálaːnga
impumulo	impúmuːlo
impungushe	ímpungûːʃe
impunzi	ímpûːnzi
impuphu	ímpuːpʰu
impusela	ímpúseːlá
imvama	ímvaːmá
imvamisa	ímvamiːsá
imvana	ímváːna
imvelo	ímveːlo
imvemvane	ímvemvâːné
imvubu	ímvuːɓú
imvu	îːmvú
imvukazi	ímvuɠâːzi
imvukusi	ímvuɠuːsí
imvula	ímvûːla
imvume	ímvúːme
imvumo	ímvúːmo
inalithi	iːnáliːtʰi
incazo	íᵑǀaːzo
inceku	íᵑǀeːɠu
incingo	íᵑǀiːngo
incombo	íᵑǀoːmbó
incuncu	íᵑǀuːᵑǀu
incwadi	íᵑǀwaːdí
incwancwa	íᵑǀwáːᵑǀwa
incwincwi	íᵑǀwiːᵑǀwi
indaba	índaːɓa
indabushe	índaɓúːʃe
indandatho	indándaːtʰo
indawo	índâːwo
indebe	índeːɓé
indima	índiːmá
indingilizi	índingilíːzi
indishi	índíːʃi
indlala	íⁿɮʱaːla
indlalifa	ínɮalîːfa
indlamini	ínɮamîːni
indlamu	ínɮaːmú
indlazi	ínɮaːzi
indlebe	ínɮeːɓé
indle	îːnɮé
indleko	ínɮêːɠo
indlela	ínɮeːla
indlobho	ínɮoːbó
indlondlo	íⁿɮʱóːⁿɮʱo
indlovu	íⁿɮʱoːvu
indlovukazi	inɮovuɠâːzi
indlozi	ínɮôːzi
indlu	íːnɮu
indlulamithi	ínɮulámiːtʰí
indlwana	ínɮwaːná
indoda	índoːda
indodakazi	indodaɠâːzi
indodana	indódaːna
induku	índuːɠu
induna	índúːna
indwandwe	índwâːndwe
indwangu	índwaːngú
inenevana	inenévaːna
inenevu	inéneːvu
ingadi	íngáːdi
ingalangala	ingalángaːla
ingalo	íngaːlo
ingane	íngáːne
inganeko	inganêːɠo
inganekwane	inganéɠwaːne
ingcanga	íᵑǀʱaːnga
ingcebo	íᵑǀʱeːɓo
ingcosa	íᵑǀʱoːsa
ingcwaba	îːᵑǀʱwâːɓa
ingcwali	íᵑǀʱwaːli
ingcweti	íᵑǀʱweːtí
ingebe	íngêːɓe
ingede	íngéːde
ingisi	îːngíːsi
ingobe	îːngóːɓe
ingoma	íngoːma
ingonyama	ingoɲâːma
ingoqokazi	íngoǃóɠâːzi
ingozi	íngoːzi
ingqalasizinda	iᵑǃʱalasiziːnda
ingqofa	íᵑǃʱoːfa
ingqomfi	íᵑǃʱoːmfí
ingqondo	íᵑǃʱoːndo
ingqumbi	íᵑǃʱuːmbi
ingqunge	íᵑǃʱúːnge
ingquza	íᵑǃʱuːza
ingubo	ínguːɓo
ingulube	ingulûːɓe
ingulule	ínguluːlé
ingungumbane	ingungúmbaːne
ingwane	íngwaːne
ingwedli	íngweːɮi
ingwe	íːngwe
ingwenya	íᵑgʷeːɲa
ingxabano	íᵑǁʱaɓáːno
ingxenye	íᵑǁʱéːɲe
ingxi	íːᵑǁʱi
ingxobongo	íᵑǁʱoɓóːngo
ingxotha	íᵑǁʱoːtʰa
ingxoxo	íᵑǁʱoːǁo
ingxubano	iᵑǁʱuɓâːno
ingxubevange	íᵑǁʱuɓévaːngé
inhlaba	ínɬâːɓa
inhlabathi	ínɬaɓâːtʰi
inhlahla	ínɬaːɬa
inhlaka	ínɬaːɠá
inhlakanipho	inɬaɠániːpʰo
inhlalakahle	ínɬalaɠaːɬé
inhlalo	ínɬaːlo
inhlamvu	ínɬâːmvu
inhlamvukazi	ínɬamvuɠâːzi
inhlangano	inɬángaːno
inhlanhla	ínɬaːnɬa
inhlansi	ínɬáːnsi
inhlanzi	ínɬaːnzi
inhlaziyo	ínɬazíːjo
inhlekisa	inɬéɠiːsa
inhlelo	ínɬeːlo
inhliziyo	ínɬizíːjo
inhlobo	ínɬoːɓo
inhloko	ínɬóːɠo
inhloli	ínɬôːli
inhloso	ínɬóːso
inhlwathi	ínɬwaːtʰi
iningi	îːnîːngi
iningizimu	íningízîːmu
inja	îːɲdʒá
injemane	íɲdʒemaːné
injingwenikazi	iɲdʒingweníɠaːzi
injobo	íɲdʒôːɓo
injolikazi	íɲdʒolíɠaːzi
injongo	íɲdʒóːngo
injula	íɲdʒuːla
inkabi	ínkâːɓi
inkala	ínkaːla
inkambo	ínkáːmbo
inkampane	inkámpaːne
inkanyezi	ínkaɲéːzi
inkathazo	ínkatʰáːzo
inkathi	ínkaːtʰí
inkawu	ínkâːwu
inkehlo	ínkeːɬo
inkinga	ínkíːnga
inkohlisa	inkóɬiːsa
inkomba	ínkóːmba
inkomo	ínkoːmó
inkontileka	inkontileːɠa
inkosana	ínkosâːna
inkosazana	ínkosázaːna
inkosi	ínkôːsi
inkosikazi	ínkosíɠaːzi
inkotha	ínkóːtʰa
inkuba	ínkúːɓa
inkukhu	ínkúːkʰu
inkululeko	ínkulúleːɠo
inkulungwane	ínkulúngwaːné
inkumbulo	ínkumbúːlo
inkundla	ínkûːnɮa
inkungu	ínkuːngú
inkunzana	ínkunzáːna
inkunzi	ínkûːnzi
inkwali	ínkwaːlí
inkwashu	iᵑkʷaːʃu
inkwazi	ínkwâːzí
inkwindi	ínkwíːndi
inqaba	íᵑǃâːɓa
inqama	íᵑǃaːma
inqe	îːᵑǃé
inqina	íᵑǃiːna
inqindi	íᵑǃiːndi
inqola	íᵑǃóːla
inqolobana	íᵑǃolóɓaːna
inqolobane	íᵑǃolóɓaːne
inqulu	íᵑǃuːlu
inqumba	íᵑǃuːmba
inqwaba	íᵑǃwaːɓa
insangu	ínsaːngú
insele	ínseːle
insephe	ínseːpʰé
insimba	ínsîːmba
insimbi	ínsîːmbi
insimu	ínsîːmu
insipho	ínsiːpʰo
insizwa	ínsíːzwa
inso	îːnsó
insundu	ínsûːndu
inswelakalo	ínsweláɠaːlo
inswelo	ínswéːlo
intaka	íntaːɠa
intambo	íntaːmbo
intamo	íntaːmo
intandane	íntandâːne
intando	íntâːndo
intela	ínteːla
intengo	íntéːngo
intethe	ínteːtʰe
intini	íntiːní
into	îːntó
intombazane	íntombazâːne
intombi	íntoːmbí
intonga	íntoːnga
intsha	îːɲtʃá
intshe	îːɲtʃé
intshonalanga	íɲtʃonálaːnga
intshontsho	íːɲtʃoːɲtʃo
intshumayelo	íɲtʃumájeːlo
intshushiso	iɲtʃúʃiːso
intulo	íntúːlo
intuthane	íntútʰaːné
intuthu	íntuːtʰú
intwala	íntwáːla
intwasahlobo	intwasáɬoːɓo
intwentshe	íntweːɲtʃe
inungu	ínûːngú
inxa	iᵑǁâː
inxaso	íᵑǁáːso
inxeba	íːᵑǁeːɓa
inxele	îːᵑǁêːle
inxokovane	íᵑǁoɠóvaːne
inyakatho	iɲáɠaːtʰo
inyala	íɲaːla
inyama	íɲaːma
inyamazane	iɲamázaːne
inyanga	íɲaːnga
inyanga	íɲaːngá
inyathi	íɲâːtʰi
inyendle	íɲeːnɮé
inyoka	íɲôːɠa
inyonga	íɲôːnga
inyongo	íɲóːngo
inyoni	íɲoːni
inyosi	íɲôːsi
inyumba	íɲuːmba
inzima	ínziːma
inzondo	ínzóːndo
inzulu	ínzuːlú
iphahla	íːpʰaːɬa
iphakathi	îːpʰáɠaːtʰí
iphalamende	íːpʰalaméːnde
iphango	íːpʰaːngo
iphaphu	íːpʰaːpʰú
iphara	iːpʰaːra
iphasika	îːpʰasíːɠa
iphela	íːpʰeːla
iphepha	íːpʰeːpʰa
iphiko	íːpʰiːɠo
iphoyisa	îːpʰójiːsá
iphupho	íːpʰuːpʰo
iphutha	íːpʰuːtʰá
iphuzu	íːpʰuːzú
ipipi	îːpíːpi
ipiyano	îːpijáːno
ipulangwe	îːpuláːngwe
ipulazi	îːpuláːzi
iqabi	íːǃaːɓí
iqakala	iːǃáɠaːla
iqanda	íːǃaːndá
iqaqa	íːǃaːǃá
iqatha	îːǃâːtʰa
iqembu	íːǃeːmbú
iqeqeba	íːǃeǃéːɓa
iqhawe	îːǃʰáːwe
iqhezu	íːǃʰeːzú
iqhina	íːǃʰiːna
iqhinga	íːǃʰiːnga
iqhude	îːǃʰúːde
iqhwabazi	iːǃʰwáɓaːzi
iqhwa	íːǃʰwa
iqhwana	íːǃʰwaːna
iqili	îːǃíːli
iqiniso	îːǃinîːso
iqola	îːǃóːla
iqoqo	îːǃôːǃo
iqwahhashi	íːǃwaɦáːʃi
iresiphi	iːrésiːpʰi
irobhothi	iːróboːtʰi
isabelo	isáɓeːlo
isabizwana	ísaɓizwâːna
isala	ísaːla
isalukazi	ísaluɠáːzi
isambane	isámbaːne
isanda	isáːnda
isandiso	isándiːso
isandla	isáːnɮa
isando	isáːndo
isandu	ísaːndú
isangoma	isángoːma
isapha	îːsáːpʰa
isebi	ísêːɓi
isele	íːseːle
isende	íːseːnde
isendwishi	iːséndwiːʃi
isenzo	iséːnzo
ishaka	íːʃaːɠa
ishayina	îːʃajíːna
ishinga	íːʃiːnga
ishiya	îːʃîːja
ishongololo	íːʃongolôːlo
ishumi	îːʃûːmi
ishuminyaka	îːʃumiɲâːɠa
ishungu	îːʃúːngu
ishwa	íːʃwa
isibabule	isiɓáɓuːle
isibaya	ísiɓâːja
isibhakela	ísibaɠêːla
isibhaxelo	ísibaǁêːlo
isibhedlela	isibéɮeːla
isibhokodo	isiboɠôːdo
isibhoza	isíboːza
isibhunu	ísibûːnu
isibiba	isíɓiːɓa
isibi	ísiːɓí
isibili	isíɓiːlí
isibindi	ísiɓîːndi
isibingelelo	isiɓingelêːlo
isibomvu	isíɓoːmvú
isibongo	isíɓoːngo
isibungu	isíɓuːngú
isibunu	ísiɓúːnu
isicathulo	isiǀátʰuːlo
isicebi	isíǀeːɓi
isichazamazwi	isíǀʰazamaːzwí
isicholo	isíǀʰoːló
isichotho	isíǀʰoːtʰo
isichwe	ísiːǀʰwé
isici	ísiːǀí
isicunulo	isiǀúnuːlo
isidakwa	isídaːɠwá
isidididi	isidídiːdi
isidingo	isídiːngó
isidla	ísiːɮá
isidleke	isíɮeːɠé
isidlele	isíɮeːle
isidlo	ísiːɮó
isidlokolo	isiɮoɠôːlo
isidudla	ísidúːɮa
isidula	ísidúːla
isidumbu	isíduːmbú
isidwaba	isídwaːɓa
isidwebo	ísidwéːɓo
isifazane	ísifazáːne
isifingqo	isífiːᵑǃʱo
isifo	ísiːfó
isifuba	ísifûːɓa
isifulentshi	ísifuléːɲtʃi
isifunda	ísifûːnda
isifundo	ísifúːndo
isiga	ísiːgá
isigcawu	isíᶢǀʱaːwú
isigcibisholo	isiᶢǀʱiɓíʃoːlo
isigcino	isíᶢǀʱiːno
isigebengu	isígeɓéːngu
isigedla	isígeːɮa
isigedlekazi	isigeɮeɠâːzi
isigege	isígeːge
isigidigidi	isigidígiːdi
isigidi	isígiːdi
isigigaba	isigígaːɓa
isigingci	ísigíːᵑǀʱi
isigodi	isígoːdí
isigqi	isíːᶢǃʱi
isigqiki	isíᶢǃʱiːɠí
isigqila	isíᶢǃʱiːlá
isigqizo	isíᶢǃʱiːzo
isigqoko	isíᶢǃʱoːɠo
isigubhu	ísigúːbu
isigwaca	isígwaːǀa
isigwadlulo	isigwáɮuːlo
isigwayi	isígwaːjí
isigwedlo	isígweːɮo
isigwegwe	ísigwéːgwe
isigxobo	isíᶢǁʱoːɓo
isihlabathi	ísiɬaɓâːtʰi
isihlahla	isíɬaːɬa
isihla	ísiːɬá
isihlakaniphi	isiɬaɠániːpʰi
isihlalo	isíɬaːlo
isihlangu	isíɬaːngú
isihlanu	ísiɬáːnu
isihlathi	ísiɬâːtʰi
isihlelo	isíɬeːlo
isihlephu	isíɬeːpʰú
isihlobo	isíɬoːɓo
isihloko	ísiɬôːɠo
isihlungu	ísiɬûːngu
isi	íːsi
isijingi	isídʒiːngí
isijula	isídʒuːla
isikebhe	ísikéːbe
isikhala	isíkʰaːla
isikhali	ísikʰáːli
isikhashana	isíkʰaʃáːna
isikhathi	isíkʰaːtʰí
isikhindi	ísikʰíːndi
isikhombisa	isíkʰombíːsa
isikhotha	isíkʰoːtʰá
isikhulu	ísikʰûːlu
isikhumba	isíkʰuːmba
isikhumbuzo	ísikʰumbúːzo
isikhundla	ísikʰûːnɮa
isikhuphashe	isikʰúpʰaːʃe
isikhwama	ísikʰwáːma
isikhwehlela	ísikʰwéɬeːlá
isikhwenene	isikʰwenêːne
isikhwili	isíkʰwiːlí
isiko	îːsíːɠo
isikole	ísikóːle
isikweleti	isikwéleːti
isikweletu	isikwéleːtu
isikwenetu	isikwéneːtu
isileti	isíleːti
isilevu	isíleːvu
isilima	ísilîːma
isilisa	ísilíːsa
isiliva	îːsilíːva
isilo	isíːlo
isilonda	isíloːnda
isilungu	isíluːngu
isilwane	isílwaːne
isilwi	isíːlwi
isimame	isímʱaːmʱé
isimangaliso	isimangalîːso
isimba	íːsiːmbá
isimemo	ísimêːmo
isimo	ísiːmó
isinci	isíːᵑǀi
isinciphiso	ísiᵑǀipʰíːso
isine	isíːne
isingane	isíngaːne
isingci	isíːᵑǀʱi
isingisi	ísingíːsi
isinguni	isínguːní
isinkwa	isíːnkwa
isinkwe	ísiːnkwé
isinqe	ísiːᵑǃé
isinqumo	ísiᵑǃúːmo
isintu	isíːntu
isinxele	ísiᵑǁêːle
isinye	ísiːɲé
isinzima	isínziːma
isiphambano	isípʰambáːno
isiphapha	isípʰaːpʰa
isiphawulo	isipʰáwuːlo
isiphethe	isípʰeːtʰe
isiphetho	isípʰeːtʰo
isiphika	isípʰiːɠa
isipho	ísiːpʰó
isiphukuphuku	isipʰuɠúpʰuːɠu
isiphundu	isípʰuːndu
isiphuzi	ísipʰúːzi
isipinashi	isipínaːʃi
isipunu	ísipúːnu
isiqalo	ísiǃâːlo
isiqephu	isíǃeːpʰú
isiqhaza	isíǃʰaːza
isiqhebeza	isiǃʰéɓeːza
isiqhephu	isíǃʰeːpʰú
isiqhimu	ísiǃʰíːmu
isiqhingana	ísiǃʰíngaːna
isiqhingi	ísiǃʰíːngi
isiqimu	ísiǃíːmu
isiqinti	isíǃiːnti
isiqithi	isíǃiːtʰi
isiqopha	isíǃoːpʰa
isiqoqo	ísiǃôːǃo
isiquba	ísiǃúːɓa
isisebenzi	ísiseɓéːnzi
isishayina	ísiʃajíːna
isishiyagalolunye	ísiʃíjagaloluːɲe
isishiyagalombili	ísiʃíjagalombiːlí
isishuqulu	ísiʃúǃuːlú
isishushiso	isiʃúʃiːso
isisu	isíːsu
isisuthu	ísisûːtʰu
isiswazi	isíswaːzi
isiswebhu	ísiswéːbu
isitambu	ísitáːmbu
isiteleka	isíteléːɠa
isitha	íːsiːtʰa
isitha	ísiːtʰá
isithando	isítʰaːndo
isithandwa	ísitʰâːndwa
isithathu	ísitʰâːtʰu
isithelo	isítʰeːlo
isithembiso	ísitʰémbiːso
isithixo	isítʰiːǁo
isithole	isítʰoːle
isithombe	ísitʰóːmbe
isithunywa	ísitʰúːɲwa
isithupha	isítʰuːpʰa
isithutha	isítʰuːtʰá
isithuthuthu	isitʰútʰuːtʰu
isithwalambiza	ísitʰwálambiːzá
isithwathwa	isítʰwaːtʰwa
isitimela	isitímeːla
isitini	ísitíːni
isitofu	ísitóːfu
isitsha	isíːtʃa
isitshalo	ísitʃáːlo
isitshwana	ísitʃwáːna
isitswana	ísitswáːna
isitulo	ísitúːlo
isivalo	isívaːlo
isivande	ísiváːnde
isivimbo	isíviːmbo
isixaxa	isíǁaːǁa
isixazululo	isiǁazulûːlo
isixhosa	isíǁʰoːsa
isixubho	isíǁuːbo
isixuku	ísiǁûːɠu
isixula	ísiǁúːla
isiziba	isíziːɓa
isizulu	isízuːlu
isizwe	isíːzwe
iso	îːsó
isoka	íːsoːɠa
isondo	îːsôːndo
isono	ísôːno
isonto	íːsoːnto
isonto	íːsoːnto
isosa	îːsóːsa
isu	íːsu
isulumani	îːsulúmaːni
isundu	îːsûːndu
iswazi	íːswaːzi
itafula	iːtáfuːla
ithambo	îːtʰâːmbo
ithanga	íːtʰaːnga
ithanga	íːtʰaːngá
itheketheke	iːtʰeɠétʰeːɠe
itheku	îːtʰêːɠu
ithemba	îːtʰéːmba
ithikithi	iːtʰíɠiːtʰi
ithuba	íːtʰuːɓa
ithumbu	íːtʰuːmbu
ithunga	îːtʰûːnga
ithusi	îːtʰúːsi
ithwasa	îːtʰwáːsa
itiye	îːtíːje
itshe	íːtʃe
itshitshi	îːtʃíːtʃi
itswayi	íːtswaːjí
iva	íːva
ivaka	îːvâːɠa
ivesi	îːvéːsi
ivila	íːviːla
ivoti	îːvóːti
ivukusi	íːvuɠuːsí
ivukuzi	íːvuɠuːzí
iwa	îːwá
iwayini	iːwájiːni
iwodi	îːwóːdi
ixhaphozi	iːǁʰápʰoːzi
ixhegu	íːǁʰeːgu
ixhiba	íːǁʰiːɓa
ixhumela	iːǁʰúmeːla
ixilongo	îːǁilóːngo
ixolo	îːǁôːlo
ixoxo	íːǁoːǁo
ixuku	îːǁûːɠu
iyadi	îːjáːdi
iyezi	íːjeːzí
izaba	ízaːɓá
izabulo	ízaɓúːlo
izala	íːzaːla
izambane	iːzámbaːne
izembe	íːzeːmbe
izigqoko	ìzíᶢǃʱɔ̀ːɠò
izihlalo	iziɬâːlo
iziko	îːzîːɠo
izimu	îːzîːmu
izinga	íːziːnga
izinhloni	ízinɬôːni
izinkabi	ízìŋkâːɓì
izinkamba	ìzìŋkâːmbà
izinsizwa	ízìnsíːzwà
izintini	izintîní
izintombi	ìzìntôːmbí
izinyo	îːzîːɲo
izipho	íːziːpʰo
izitha	íːziːtʰá
izolo	íːzoːlo
izu	îːzûː
izulu	íːzuːlu
izwamoya	îːzwamôːja
izwe	íːzwe
izwekazi	íːzweɠâːzi
izwi	îːzwí
jana	dʒaːna
kade	káːde
kahle	ɠaːɬé
kahleni	ɠaɬéːni
kakhulu	ɠakʰûːlu
kambe	káːmbe
kamnandi	ɠam̩náːndi
kanjani	ɠáɲdʒaːní
kanti	kantîː
kanye	ɠaːɲe
ke	ɠe
ke	ɠé
khama	kʰaːma
khiqiza	kʰiǃíːza
khona	kʰoːná
khulu	kʰûːlu
khwehlela	kʰweɬéːla
khweza	kʰwéːza
khwezela	kʰwezéːla
kleza	kxeːza
konje	kóːɲdʒe
kude	ɠúːde
kusasa	ɠusaːsa
kwazulu	ɠwázuːlu
kweleta	kweleːta
laba	láɓa
labaya	laːɓajâː
labo	láːɓo
lahla	láːɬa
la	lá
lalakahle	lálaɠaːɬé
lala	láːla
lalanikahle	lalániɠaːɬé
lapha	láːpʰa
lapho	láːpʰo
lawaya	laːwajâː
lawo	láːwo
le	lé
leli	léli
leliya	leːlijâː
lelo	léːlo
lenga	leːnga
lesi	lési
lesiya	leːsijâː
leso	léːso
leyaya	leːjajâː
leyo	léːjo
lezi	lézi
leziya	leːzijâː
lezo	léːzo
libala	liɓaːla
loba	loːɓa
lobo	lóːɓo
lobu	lóɓu
lobuya	loːɓujâː
lokho	lóːkʰo
lokhu	lókʰu
lokhuya	loːkʰujâː
lo	lo
lo	ló
lolo	lóːlo
lolu	lólu
loluya	loːlujâː
lona	loːná
lowaya	loːwajâː
lowo	lóːwo
luhlaza	luɬâːza
luma	lûːma
lwa	lwa
madlala	maɮʱaːla
mahhala	maɦáːla
manje	maːːndʒe
maye	mʱájʱêː
mema	meːma
mhla	m̩ɬa
mhlawumbe	m̩ɬawûːmbe
mhlophe	m̩ɬôːpʰe
mina	miːná
muntu	mùːntù
musa	mʱúːsa
nakanjani	naɠáɲdʒaːní
namhlanje	nám̩ɬáːɲdʒé
nceda	ᵑǀeːda
ncedisa	ᵑǀediːsa
ncelisa	ᵑǀelíːsa
ncibilika	ᵑǀiɓilíːɠa
ncika	ᵑǀîːɠa
ncintisana	ᵑǀintisáːna
ncipha	ᵑǀîːpʰa
nciphisa	ᵑǀipʰíːsa
ncokola	ᵑǀoɠoːla
ndiza	ndiːza
ndlovu	ⁿɮʱoːvu
ngaphandle	ngapʰâːnɮé
ngcola	ᵑǀʱoːla
ngcolisa	ᵑǀʱolíːsa
ngcwaba	ᵑǀʱwâːɓa
ngeshwa	ngéːʃwa
ngikhona	ngikʰoːná
ngiyabonga	ngijaɓoːnga
ngiyakuthanda	ngijaɠutʰáːnda
ngiyaphila	ngijapʰiːla
ngoba	ngóːɓa
ngokuba	ngoɠúːɓa
ngomuso	ngomûːsó
ngqongqoza	ᵑǃʱoᵑǃʱóːza
nihambekahle	níhambeɠaːɬé
nilalekahle	nílaleɠaːɬé
nina	niːná
ningi	nîːngi
nisalekahle	nísaleɠaːɬé
njalo	ɲdʒáːlo
njani	ɲdʒaːní
nke	nke
noma	nóːma
nqaba	ᵑǃâːɓa
nqabela	ᵑǃaɓéːla
nqaka	ᵑǃaːɠa
nqamuka	ᵑǃamúːɠa
nqamula	ᵑǃamúːla
nqekuza	ᵑǃeɠúːza
nqikaza	ᵑǃiɠáːza
nqoba	ᵑǃôːɓa
nquma	ᵑǃúːma
nqunu	ᵑǃúːnu
nqwabela	ᵑǃwaɓéːla
nxa	ᵑǁâː
nxazonke	ᵑǁazóːnke
nxephepha	ᵑǁepʰéːpʰa
nyakenye	ɲaɠêːɲe
nyenyeza	ɲeɲeːza
oda	ʔoːda
phaka	pʰaːɠa
phakathi	pʰáɠaːtʰí
phambili	pʰámbiːli
phansi	pʰâːnsí
phela	pʰêːla
phephisa	pʰepʰíːsa
phesheya	pʰéʃéːja
phezolo	pʰézoːlo
phezulu	pʰézuːlu
phezu	pʰéːzu
phinde	pʰíːnde
phola	pʰóːla
qabatheka	ǃaɓatʰéːɠa
qabuka	ǃaɓúːɠa
qabula	ǃaɓúːla
qagela	ǃagéːla
qalaza	ǃaláːza
qala	ǃâːla
qamba	ǃâːmba
qamela	ǃameːla
qaphela	ǃapʰéːla
qaqamba	ǃaǃaːmba
qaqa	ǃaːǃa
qathaka	ǃatʰáːɠa
qatha	ǃaːtʰa
qedakala	ǃedaɠáːla
qeda	ǃêːda
qede	ǃêːde
qeqebula	ǃeǃeɓúːla
qhakaza	ǃʰaɠáːza
qhamuka	ǃʰamuːɠa
qhamu	ǃʰamu
qhaqhazela	ǃʰaǃʰazeːla
qhaqha	ǃʰaːǃʰa
qhasha	ǃʰaːʃa
qhathanisa	ǃʰatʰaníːsa
qhebeza	ǃʰeɓeːza
qhela	ǃʰeːla
qhelisa	ǃʰelíːsa
qhephuka	ǃʰepʰuːɠa
qhesha	ǃʰeːʃa
qhina	ǃʰiːna
qhiyama	ǃʰijaːma
qhubeka	ǃʰuɓéːɠa
qhuma	ǃʰuːma
qhutha	ǃʰuːtʰa
qhuthula	ǃʰutʰúːla
qhwaga	ǃʰwaːga
qhwaya	ǃʰwaːja
qhweba	ǃʰweːɓa
qinisela	ǃiniséːla
qoba	ǃoːɓa
qoka	ǃoːɠa
qoma	ǃoːma
qomisa	ǃomíːsa
qonda	ǃoːnda
qondisa	ǃondíːsa
qoqa	ǃôːǃa
quba	ǃúːɓa
quleka	ǃuléːɠa
qumba	ǃuːmba
qwashaza	ǃwaʃáːza
qwasha	ǃwaːʃa
salakahle	sálaɠaːɬé
salanikahle	salániɠaːɬé
sanibonani	saniɓonáːni
sanibona	saniɓóːna
sawubona	sawuɓóːna
sebenza	seɓéːnza
shaqa	ʃaːǃa
shaqa	ʃaǃa
shaqeka	ʃaǃeːɠa
shwabana	ʃwaɓáːna
singa	siːnga
soka	soːɠa
sombuluka	sombuluːɠa
sombulula	sombuluːla
sombu	sombu
sona	soːná
swaca	swaːǀa
swakama	swaɠáːma
teleka	teleːɠa
thathu	tʰâːtʰu
thetha	tʰêːtʰa
thina	tʰiːná
thukuthela	tʰuɠutʰeːla
thula	tʰúːla
thwala	tʰʷáːla
ubaba	úɓaːɓá
ubabekazi	úɓaɓéɠaːzi
ubala	ûːɓâːla
ubambo	úːɓaːmbo
ubani	úɓaːní
ubasi	úɓáːsi
ubhadi	úbaːdí
ubhaka	úbáːɠa
ubhanana	úbanáːna
ubhavu	úbáːvu
ubhejane	ubédʒaːne
ubheseni	ubesêːni
ubhiya	úbiːjá
ubhiye	úbiːjé
ubhobhobho	ubóboːbo
ubhoko	úːboːɠo
ubhontshisi	uboɲtʃîːsi
ubhoshobana	úboʃóɓaːna
ubhova	úboːvá
ubhozo	úboːzo
ubhusha	úbuːʃá
ubhusha	úbúːʃa
ubisi	ûːɓîːsi
ubolo	úːɓoːlo
ubomvu	úːɓoːmvú
uboya	úɓoːjá
ububanzi	uɓúɓaːnzí
ububhibhi	uɓúbiːbi
ububi	úɓuːɓí
ububomvu	uɓúɓoːmvú
ubuchopho	uɓúǀʰoːpʰo
ubuciko	úɓuǀîːɠo
ubudala	úɓudáːla
ubude	uɓúːde
ubudlelwane	úɓuɮelwâːne
ubudoda	uɓúdoːda
ubugqila	uɓúᶢǃʱiːlá
ubugwala	uɓúgwaːlá
ubuhlalu	uɓúɬaːlú
ubuhlanya	uɓúɬaːɲa
ubuhlanzo	úɓuɬâːnzo
ubuhleli	uɓúɬeːli
ubuhle	úɓuːɬé
ubuhlobo	uɓúɬoːɓo
ubuhlungu	úɓuɬûːngu
ubukhali	úɓukʰáːli
ubukhosazana	úɓukʰosázaːna
ubukhosikazi	úɓukʰosíɠaːzi
ubukhulu	úɓukʰûːlu
ubukhuphekhuphe	uɓukʰupʰékʰuːpʰe
ubulembu	uɓúleːmbu
ubuluhlaza	úɓuluɬâːza
ubumhlophe	úɓum̩ɬôːpʰe
ubumnene	úɓum̩nêːne
ubumnyama	úɓum̩ɲáːma
ubumpi	úɓuːmpí
ubumpofu	úɓumpôːfu
ubumpohlo	uɓúmpoːɬo
ubumtoti	úɓum̩tôːti
ubuncane	úɓuᵑǀáːne
ubundlalifa	úɓunɮalîːfa
ubungane	uɓúngaːne
ubungane	úɓungáːne
ubungcono	úɓuᵑǀʱóːno
ubungqa	uɓúːᵑǃʱa
ubungqolokosho	uɓuᵑǃʱolóɠoːʃo
ubungqo	uɓúːᵑǃʱo
ubuningi	úɓunîːngi
ubunjani	uɓúɲdʒaːní
ubunqunu	úɓuᵑǃúːnu
ubunsomi	úɓunsôːmi
ubuntu	uɓúːntu
ubuntwana	uɓúntwaːna
ubunxele	úɓuᵑǁêːle
ubunyakanyaka	uɓuɲaɠáɲaːɠa
ubunye	uɓúːɲe
ubuphansi	úɓupʰâːnsi
ubuqhawe	úɓuǃʰáːwe
ubuqotho	uɓúǃoːtʰo
ubusha	úɓuːʃá
ubusika	úɓusîːɠa
ubuso	úɓuːsó
ubusuku	úɓusûːɠu
ubuthakathaka	úɓutʰáɠatʰáːɠa
ubutha	úɓuːtʰá
ubuthi	úɓuːtʰí
ubuthongo	uɓútʰoːngo
ubuthuntu	uɓútʰuːntu
ubuthutha	uɓútʰuːtʰá
ubuvaka	úɓuvâːɠa
ubuvila	uɓúviːla
ubuxhegu	uɓúǁʰeːgu
ubuzimu	úɓuzîːmu
ubuzwe	uɓúːzwe
uchakide	úǀʰaɠíːde
ucingo	úːǀiːngó
ucwecwe	úːǀweːǀwé
udaba	úːdaːɓa
udaka	úːdaːɠa
udlame	ûːɮ̈áːme
udlawu	úːɮaːwu
udokotela	udoɠóteːla
udoli	údoːlí
udondolo	úːdondôːlo
udonga	úːdoːngá
udoti	údóːti
udwi	údwîː
ufezela	úfezéːla
ufudu	ûːfûːdu
ufu	úːfu
ugadi	úgáːdi
ugalo	úːgaːlo
ugamthilini	úgamtʰilíːni
uganandela	úganandéːla
ugazi	úːgaːzí
ugesi	úgéːsi
ugigi	úgíːgi
ugogo	úgóːgo
ugologo	úgolóːgo
ugqozi	ûːᶢǃʱôːzi
ugu	úːgu
ugwadule	ûːgwadûːle
ugwava	úgwaːvá
ugwayi	úgwaːjí
ugxa	úːᶢǁʱa
uhabhu	ûːháːbu
uhambekahle	úhambeɠaːɬé
uhambo	ûːháːmbo
uhele	ûːhêːle
uhhafu	úɦáːfu
uhlaka	úːɬaːɠá
uhlamvu	ûːɬâːmvu
uhlangothi	ûːɬangóːtʰi
uhlanya	úːɬaːɲa
uhla	úːɬa
uhlaza	ûːɬâːza
uhleko	úːɬeːɠo
uhlelo	úːɬeːlo
uhlobo	úːɬoːɓo
uhlu	úːɬu
uhulumeni	úhuluméːni
ujamu	údʒáːmu
ujehova	údʒehóːva
ujeke	údʒéːɠe
ujele	údʒêːle
ujesu	údʒéːsu
ujinja	údʒíːɲdʒa
ujusi	údʒúːsi
uju	úːdʒu
ukhali	úkʰaːlí
ukhamba	úːkʰaːmba
ukhetho	úːkʰeːtʰo
ukhisimusi	ukʰisímuːsi
ukhokho	úkʰóːkʰo
ukholwase	úkʰólwaːse
ukhongolose	úkʰongolôːse
ukhonkolo	ukʰónkoːlo
ukhophe	úːkʰoːpʰe
ukhozi	ûːkʰôːzi
ukhuni	ûːkʰûːni
ukhwathu	úːkʰwaːtʰu
ukhweshe	úːkʰweːʃe
ukhweshe	úkʰweːʃe
ukoko	úkóːko
ukotini	ukótiːni
ukubulala	úɠuɓuláːla
ukucwila	uɠúǀwiːla
ukudla	úɠuːɮʱá
ukudoba	úɠudôːɓa
ukudweba	úɠudwéːɓa
ukufa	úɠuːfá
ukugeza	uɠúgeːza
ukugqwala	uɠúᶢǃʱwaːla
ukugula	uɠúguːla
ukugxeka	uɠúᶢǁʱeːɠa
ukuhlamba	uɠúɬaːmba
ukuhlikihla	uɠuɬíɠiːɬa
ukuhlwa	uɠúːɬwa
ukukhanya	uɠúkʰaːɲa
ukulwa	uɠúːlwa
ukumangala	uɠumángaːla
ukuma	úɠuːmá
ukuna	uɠúːna
ukuncoma	uɠúᵑǀoːma
ukunene	úɠunêːne
ukungcola	uɠúᵑǀʱoːla
ukungenisa	úɠungeníːsa
ukungqubuzana	uɠuᵑǃʱuɓúzaːna
ukunqoba	úɠuᵑǃôːɓa
ukunto	úɠuːntó
ukuntshontsha	uɠúɲtʃoːɲtʃa
ukunxele	úɠuᵑǁêːle
ukunyenyeza	uɠuɲéɲeːza
ukunyenyeza	uɠúɲeɲéːza
ukupela	úɠupéːla
ukuphakama	úɠupʰaɠáːma
ukupheka	uɠúpʰeːɠa
ukuphela	úɠupʰéːla
ukuphoqa	uɠúpʰoːǃa
ukuphutha	uɠúpʰuːtʰa
ukuqala	úɠuǃâːla
ukuqaphela	uɠuǃápʰeːla
ukuqhuma	uɠúǃʰuːma
ukuqoma	uɠúǃoːma
ukusa	uɠúːsa
ukusa	úɠuːsá
ukushisa	úɠuʃíːsa
ukuthula	úɠutʰúːla
ukuze	uɠúːze
ukuzibulala	úɠuziɓúláːla
ukuzigqaja	uɠúziᶢǃʱáːdʒa
ukwindla	úɠwiːnɮá
ukwi	ûːkwí
ulalekahle	úlaleɠaːɬé
uletisi	úlétiːsi
ulimi	ûːlîːmi
ulwandle	ûːlwâːnɮe
ulwazi	úːlwaːzí
ulwesibili	úlwesíɓiːlí
ulwesihlanu	úlwésiɬáːnu
ulwesine	úlwesíːne
ulwesithathu	úlwésitʰâːtʰu
ulwezi	úːlweːzi
ulwezi	úlweːzí
umabelo	umáɓeːlo
umabi	umáːɓi
umabo	umáːɓo
umafikazisina	umáfiɠazisíːna
umakhelwane	úmakʰélwaːne
umakhi	úmâːkʰi
umalukazi	umáluɠáːzi
umalume	úmalûːme
umama	úmʱáːma
umame	úmaːmé
umandulo	umánduːlo
umaquba	úmaǃúːɓa
umashiqela	úmaʃiǃêːla
umasingana	umasíngaːna
umata	úmáːta
uma	úːma
umbala	úm̩ɓâːla
umbaso	uḿ̩ɓaːso
umbayimbayi	úmbajimbáːji
umbhali	úm̩bâːli
umbhalo	úm̩bâːlo
umbhede	úm̩béːde
umbhicongo	uḿ̩biǀóːngo
umbhidli	uḿ̩biːɮi
umbhubhudlo	úm̩bubúːɮo
umbiko	úm̩ɓíːɠo
umboko	úm̩ɓôːɠo
umbombo	uḿ̩ɓoːmbó
umbono	úm̩ɓôːno
umbulali	úm̩ɓuláːli
umcebo	uḿ̩ǀeːɓo
umcubungulo	um̩ǀuɓúnguːlo
umculi	uḿ̩ǀuːli
umculo	uḿ̩ǀuːlo
umcwaningi	uḿ̩ǀwaníːngi
umcwebo	uḿ̩ǀweːɓo
umdabu	uḿ̩daːɓu
umdanso	uḿ̩daːnso
umdidi	úm̩díːdi
umdlali	úm̩ɮáːli
umdlalo	úm̩ɮâːlo
umdlwenguli	úm̩ɮwénguːli
umduzu	uḿ̩duːzu
umdwebo	úm̩dwéːɓo
umdweshu	úm̩dwéːʃu
umebo	úmêːɓo
umelusi	uméluːsi
umendo	uméːndo
umenzi	uméːnzi
umenzi	uméːnzi
umese	úmʱeːse
umfana	úm̩fáːna
umfanyana	úm̩fáɲaːna
umfazi	úm̩fâːzi
umfelokazi	uḿ̩feloɠâːzi
umfino	úm̩fíːno
umfokazana	úm̩foɠázaːna
umfokazi	úm̩fóɠaːzi
umfudlana	um̩fúɮaːna
umfula	uḿ̩fuːla
umfumfu	úmfuːmfú
umfundisi	úm̩fundíːsi
umfundisi	úm̩fúndiːsi
umfundi	úm̩fúːndi
umfuyi	úm̩fúːji
umgankla	úm̩gáːnkla
umganu	uḿ̩gaːnú
umgcagco	uḿ̩ᶢǀʱaːᶢǀʱo
umgede	úm̩géːde
umgibeli	úm̩giɓéːli
umgodi	uḿ̩goːdí
umgqibelo	uḿ̩ᶢǃʱiɓéːlo
umgqomo	úmᶢǃʱôːmo
umgqulo	úm̩ᶢǃʱûːlo
umgungundlovu	um̩gungúnɮoːvu
umgwamanda	uḿ̩gwamaːndá
umgwaqana	um̩gwaǃâːna
umgwaqo	uḿ̩gwaːǃo
umgwebi	uḿ̩gweːɓi
umgwenya	úm̩gwêːɲa
umgxala	uḿ̩ᶢǁʱaːlá
umhlabathi	úm̩ɬaɓâːtʰi
umhlaba	uḿ̩ɬaːɓa
umhlaba	úm̩ɬâːɓa
umhlaba	úm̩ɬâːɓa
umhlane	uḿ̩ɬaːné
umhlangano	um̩ɬángaːno
umhlanga	uḿ̩ɬaːnga
umhlathi	úm̩ɬâːtʰi
umhlaza	úm̩ɬâːza
umhleli	uḿ̩ɬeːli
umhlengi	uḿ̩ɬeːngi
umhlobo	uḿ̩ɬoːɓo
umhloli	úm̩ɬóːli
umhlophekazi	úm̩ɬopʰéɠaːzi
umhlophe	úm̩ɬôːpʰe
umhlukazi	úm̩ɬúɠaːzi
umhluzi	uḿ̩ɬuːzí
umhlwazi	úm̩ɬwáːzi
umhuzulo	um̩húzuːlo
umhwebi	uḿ̩hweːɓi
umhwebo	uḿ̩hweːɓo
umisi	úmíːsi
umjaho	uḿ̩dʒaːho
umjondolo	um̩dʒóndoːlo
umjovo	uḿ̩dʒoːvo
umjuluko	um̩dʒulûːɠo
umkhabo	uḿ̩kʰaːɓo
umkhathi	uḿ̩kʰaːtʰí
umkhawulo	uḿ̩kʰawúːlo
umkhaya	úm̩kʰâːja
umkhemese	umkʰémeːse
umkhetho	uḿ̩kʰeːtʰo
umkhomazi	uḿ̩kʰomáːzi
umkhombo	uḿ̩kʰoːmbo
umkhomo	uḿ̩kʰoːmó
umkhono	úm̩kʰôːno
umkhonto	úm̩kʰóːnto
umkhovu	úm̩kʰóːvu
umkhuba	úm̩kʰúːɓa
umkhulu	úm̩kʰûːlu
umkhumbimkhathi	úm̩kʰumbiḿ̩kʰaːtʰí
umkhumbi	úm̩kʰûːmbi
umkhwekazi	úm̩kʰwéɠaːzi
umkhwelo	úm̩kʰwéːlo
umkhwenyana	úm̩kʰwéɲaːna
umklomelo	um̩kxómeːlo
umlambo	uḿ̩laːmbo
umlamu	úm̩lâːmu
umlenze	uḿ̩leːnze
umlilo	uḿ̩liːlo
umlimi	uḿ̩liːmi
umlisa	úm̩líːsa
umlobi	úm̩lóːɓi
umlobokazi	úm̩loɓoɠâːzi
umlomo	uḿ̩loːmo
umlotha	uḿ̩loːtʰa
umlungu	uḿ̩luːngu
ummbila	úm̩mbíːla
ummese	uḿ̩meːsé
umncintiswano	um̩ᵑǀintíswaːno
umndeni	uḿ̩ndeːni
umnenke	uḿ̩neːnke
umngane	uḿ̩ngaːne
umngcwabo	úm̩ᵑǀʱwâːɓo
umngqithi	uḿ̩ᵑǃʱiːtʰi
umngquphane	úm̩ᵑǃʱupʰâːne
umnguni	uḿ̩nguːní
umnqobi	úmᵑǃôːɓi
umnqumo	uḿ̩ᵑǃuːmo
umntwana	uḿ̩ntwaːna
umnyama	úm̩ɲáːma
umnyango	uḿ̩ɲaːngo
umnyelele	um̩ɲéleːle
umoba	úmoːɓá
umona	úmoːná
umonya	úːmoːɲá
umoya	úmôːja
umpetshisi	um̩pétʃiːsi
umphakathi	úm̩pʰáɠaːtʰí
umphako	úm̩pʰâːɠo
umphambili	úm̩pʰámbiːli
umphansi	úm̩pʰâːnsi
umphefumulo	um̩pʰefúmuːlo
umpheki	uḿ̩pʰeːɠi
umphimbo	úm̩pʰîːmbo
umphumela	úm̩pʰúmeːlá
umqala	uḿ̩ǃaːla
umqali	úm̩ǃâːli
umqamelo	um̩ǃámeːlo
umqhele	uḿ̩ǃʰeːle
umqolo	úm̩ǃôːlo
umqondo	uḿ̩ǃoːndo
umqophi	uḿ̩ǃoːpʰi
umqotho	uḿ̩ǃoːtʰo
umquba	uḿ̩ǃuːɓa
umqwakuza	um̩ǃwáɠuːza
umrawu	úm̩râːwu
umsebenzisi	uḿ̩seɓenzíːsi
umsebenzi	úm̩seɓéːnzi
umsebenzi	úm̩seɓêːnzi
umshado	uḿ̩ʃaːdo
umshana	úm̩ʃáːna
umshini	úm̩ʃíːni
umshiya	úm̩ʃîːja
umshumayeli	uḿ̩ʃumájeːli
umshushisi	um̩ʃúʃiːsi
umshushiso	um̩ʃúʃiːso
umshwana	uḿ̩ʃwaːna
umsila	úm̩sîːla
umsindo	úm̩síːndo
umsolwa	uḿ̩soːlwa
umsombuluko	um̩sombulûːɠo
umsuka	uḿ̩suːɠá
umsundu	úm̩sûːndu
umsuthu	úm̩sûːtʰu
umswakama	úm̩swáɠaːmá
umtata	uḿ̩taːtá
umthambo	úm̩tʰáːmbo
umthamo	úm̩tʰáːmo
umthandi	uḿ̩tʰaːndi
umthandi	úm̩tʰâːndi
umthembu	úm̩tʰêːmbu
umthetho	úm̩tʰêːtʰo
umthofu	uḿ̩tʰoːfu
umthombo	úm̩tʰôːmbo
umthunzi	úm̩tʰûːnzi
umthuqu	uḿ̩tʰuːǃu
umthwalo	úm̩tʰwáːlo
umtoti	úm̩tôːti
umtshwana	úm̩tʃwáːna
umtswana	úm̩tswáːna
umtube	úm̩túːɓe
umudwa	úmuːdwá
umufi	úmuːfí
umufo	úmuːfó
umuga	úmuːgá
umugqa	umúːᶢǃʱa
umuhla	úmûːɬa
umuhlwa	úmuːɬwá
umukhwa	úmuːkʰwá
umukhwe	úmuːkʰwé
umumba	úmuːmbá
umumbi	umúːmbi
umumo	úmuːmó
umunca	úːmuːᵑǀa
umunqa	umúːᵑǃa
umunswi	úmuːnswí
umuntungumuntungabantu	umuntungumuntungaɓaːntu
umuntu	umúːntu
umunwe	umúːnwe
umunyu	umúːɲu
umusa	úmuːsá
umusho	umúːʃo
umusi	úmuːsí
umuso	úmuːsó
umuthi	úmuːtʰí
umuthwa	úmuːtʰwá
umuva	úmuːvá
umuvi	umúːvi
umuwa	úmuːwá
umuzi	umúːzi
umuzwa	úmuːzwá
umvimba	uḿ̩viːmba
umvingqi	úmvíːᵑǃʱi
umvithi	uḿ̩viːtʰi
umvoti	úm̩vóːti
umvubu	uḿ̩vuːɓú
umvundla	úm̩vûːnɮa
umvuno	úm̩vûːno
umvuzi	uḿ̩vuːzi
umvuzo	uḿ̩vuːzo
umxhapho	uḿ̩ǁʰaːpʰo
umxhosa	uḿ̩ǁʰoːsa
umyeni	uḿ̩jeːni
umzala	úm̩záːla
umzali	úm̩záːli
umzamo	uḿ̩zaːmo
umzekelo	um̩zeɠêːlo
umzimba	úm̩zîːmba
umzingeli	úm̩zingéːli
umzukulu	uḿ̩zuɠûːlu
umzulu	uḿ̩zuːlu
umzuzu	uḿ̩zuːzú
umzuzwana	uḿ̩zuzwáːna
uncedo	úːᵑǀeːdo
uncibijane	úᵑǀiɓídʒaːné
uncwaba	úᵑǀwáːɓa
undasa	úndaːsá
unesi	únéːsi
ungcede	úᵑǀʱéːde
ungqi	ǔːᵑǃʱi
ungqongqoshe	uᵑǃʱóᵑǃʱoːʃe
ungqo	ǔːᵑǃʱo
ungulazibuya	úngulaziɓûːja
ungwaqa	úngwaːǃa
unhlaba	únɬâːɓa
unhlangulana	unɬangulâːna
unhlangula	unɬánguːla
unhlolanja	únɬólaːɲdʒá
unina	úniːna
unkamisa	únkamíːsa
unkulunkulu	únkulúnkuːlú
unobhala	unóbaːla
unogwaja	unógwaːdʒa
unohha	unʱóːɦa
unondwebu	únondwéːɓu
unqangi	úᵑǃâːngi
unswinswinswi	únswinswíːnswi
untulikazi	untulíɠaːzi
unwabu	ûːnwâːɓu
unwele	ûːnwéːle
unyaka	úɲâːɠa
unya	úːɲa
unyawo	úːɲaːwo
unyazi	úːɲaːzi
unyelele	uːɲéleːle
unyembezi	uːɲémbeːzi
unyezi	úɲeːzí
unyoko	úɲoːɠo
unzoqhwishi	únzóːǃʰwiːʃi
unzo	únzôː
upende	úpéːnde
uphahla	úːpʰaːɬa
uphaphe	úːpʰaːpʰé
uphayinaphu	úpʰajínaːpʰu
uphepha	úpʰéːpʰa
uphephela	upʰépʰeːla
uphondo	úːpʰoːndo
uqhezu	úːǃʰeːzú
uqhoqhoqho	uǃʰóǃʰoːǃʰo
uqhwishi	úǃʰwiːʃi
uqobo	úːǃoːɓo
usalekahle	úsaleɠaːɬé
usana	ûːsáːna
usapho	úːsaːpʰo
usawoti	usáwoːti
usepthemba	useptʰeːmba
ushaka	úʃaːɠa
ushizi	úʃiːzi
ushukela	uʃúɠeːla
usiba	ûːsíːɓa
usogekle	úsógeːkxe
usomandla	úsomáːnɮa
usuku	ûːsûːɠu
utamatisi	útamátiːsi
uthando	ûːtʰâːndo
uthango	ûːtʰâːngo
uthi	ûːtʰí
uthuli	iziⁿtʼûːli
uthuli	úːtʰuːli
utshana	útʃaːna
utshani	útʃâːni
utshwala	útʃwaːlá
uvalo	úːvaːlo
uve	ûːvé
uvolo	úvóːlo
uweta	úweːtá
uxamu	úǁâːmu
uxolo	úːǁoːlo
uyihlo	újiːɬó
uyise	újiːsé
uzamcolo	úzam̩ǀôːlo
uzekamanzi	úzeɠámâːnzi
uzibandlela	uziɓánɮeːla
uzibuthe	úziɓûːtʰe
uzipho	úːziːpʰo
uzulu	úzuːlu
uzwane	úːzwaːne
vuya	vuːja
wena	weːná
wololo	wólolôː
wona	woːná
xega	ǁeːga
xegisa	ǁegiːsa
xhapha	ǁʰaːpʰa
xhasa	ǁʰáːsa
xhuga	ǁʰuːga
xhuma	ǁʰuːma
xokozela	ǁoɠozéːla
xola	ǁoːla
xoxa	ǁoːǁa
xubana	ǁuɓaːna
xuba	ǁuːɓa
xubha	ǁuːba
xwaya	ǁwáːja
xwayisa	ǁwajíːsa
yebo	jʱéːɓo
yeka	jeːɠa
yena	jeːná
yona	joːná
zala	záːla
za	za
ze	ze
ze	zé
zona	zoːná
