अ	ʌ
अँ	ʌ̃
अँध्यारो	ʌ̃d̪jäɾo
अं	ʌm
अं	ʌ̃
अः	ʌɦʌ
अः	ʌː
अकास	ʌkäs
अखबार	ʌk̞ʰbär
अगस्ट	ʌg̞ʌs̠t̠
अग्नि	ʌg̞ni
अग्लो	ʌg̞lo
अघि	ʌg̞i
अङ्गुर	ʌŋgur
अङ्ग्रेजी	ʌŋgredzi
अचार	ʌtsär
अञ्चल	ʌn̻tsʌl
अट्ठा	ʌʈ̚ʈʰä
अट्ठाईस	ʌʈ̚ʈʰäi̯s
अठचालीस	ʌʈʰtsälis
अठतीस	ʌɽt̪is
अठतीस	ʌʈʰt̪is
अठसट्ठी	ʌʈʰsʌʈ̚ʈʰi
अठहत्तर	ʌʈʰʌ̤ːt̪̚t̪ʌr
अठार	ʌʈʰäɾʌ
अठासी	ʌʈʰäsi
अठाह्र	ʌʈʰäɾʌ
अठ्तीस	ʌɽt̪is
अठ्तीस	ʌʈʰt̪is
अड्कल	ʌɽkʌl
अड्चालीस	ʌɽtsälis
अड्तीस	ʌɽt̪is
अड्सठ्ठी	ʌɽsʌʈʰʈʰi
अणु	ʌɽ̃u
अण्डा	ʌɳɖä
अतः	ʌt̪ʌː
अथवा	ʌt̪ʰʌwä
अधिकार	ʌd̪ikär
अध्यक्ष	ʌd̪d̪ek̚tsʰe
अध्यक्ष	ʌd̪ʌk̚tsʰe
अनार	ʌnär
अनावश्यक	ʌnäbʌsek
अनावश्यक	ʌnäu̯ʌsek
अनावश्यक	ʌnäwʌsek
अनि	ʌni
अनुपम	ʌnupʌm
अनुबादक	ʌnubäd̪ʌk
अनुमति	ʌnumʌt̪i
अनौठो	ʌnʌu̯ʈʰo
अन्ठाउन्न	ʌɳʈʰäu̯nːʌ
अन्ठानब्बे	ʌɳʈʰänʌb̚be
अन्डा	ʌɳɖä
अन्तरराष्ट्रिय	ʌn̪t̪ʌɾʌräs̠t̠rie
अन्तराष्ट्रिय	ʌn̪t̪ʌɾäs̠t̠rie
अन्तर्राष्ट्रिय	ʌn̪t̪ʌrːäs̠t̠rie
अन्दाजी	ʌn̪d̪ädzi
अन्य	ʌnːe
अप्ठेरो	ʌp̚ʈʰeɾo
अप्ठ्यारो	ʌp̚ʈʰeɾo
अप्ठ्यारो	ʌp̚ʈʰjäɾo
अब	ʌbʌ
अभिषेक	ʌbisek
अभिषेक्	ʌbisek
अमाजु	ʌmädzu
अमिलो	ʌmilo
अमेरिकन	ʌmeɾikʌn
अमेरिका	ʌmeɾikä
अरब	ʌɾʌb
अररो	ʌɾʌro
अर्को	ʌrko
अर्थ	ʌrt̪ʰʌ
अर्ध	ʌrd̪ʱʌ̤
अर्ब	ʌrbʌ
अलिकति	ʌlikʌt̪i
अल्गो	ʌlko
अल्गो	ʌlgo
अल्छि	ʌl̻tsʰi
अल्छी	ʌl̻tsʰi
अल्सि	ʌlsi
अल्सि	ʌl̻tsʰi
अल्सी	ʌlsi
असल	ʌsʌl
असी	ʌsi
असोज	ʌsodz
अस्ट्रेलिया	ʌs̠t̠relijä
अस्ति	ʌst̪i
अस्पताल	ʌspʌt̪äl
अस्मान	ʌsmän
अहँ	ʌɦʌ̃
अहिले	ʌi̯le
अह्राउनु	ʌɾäu̯nu
आ	ä
आँखा	ä̃k̞ʰä
आँखीभौं	ä̃k̞ʰi‿bʱʌ̤̃ũ̯
आँग	äŋ
आँग	ä̃g̞
आँट	ä̃ʈ
आँटी	ä̃ʈi
आँप	ä̃p
आआफ्नो	ääɸno
आआफ्नो	äʔäɸno
आइतबार	äi̯t̪ʌbär
आइमाई	äi̯mäi̯
आइस्ड	äi̯s̠d̠
आईतबार	äi̯t̪ʌbär
आउनु	äu̯nu
आउनुहोस्	äu̯nuos
आकाश	äkäs
आकाशे	äkäse
आखर	äk̞ʰʌr
आगन्तुक	äg̞ʌn̪t̪uk
आगो	äg̞o
आङ	äŋ
आज	ädzʌ
आठ	äʈʰ
आफ्नो	äɸno
आमा	ämä
आमाजु	ämädzu
आमाजु	ʌmädzu
आमाजू	ämädzu
आमाज्यू	ämädzju
आराम	äɾäm
आलु	älu
आवश्यक	äbʌsek
आवश्यक	äwʌsek
आवश्यकता	äbʌsek̚t̪ä
आवश्यकता	äu̯ʌsek̚t̪ä
आश्विन	äswin
आषाढ	äsäɽ
आस्मानी	äsmäni
आहा	ähä
इ	i
इँट	ĩʈ
इँट्टा	ĩʈ̚ʈä
इंडिया	iɳɖijä
इतिहास	it̪iɦäs
इन्टरनेट	iɳʈʌrneʈ
इन्द्रेनी	in̪d̪reni
इस्टोनिया	is̠t̠onijä
इस्लाम	isläm
ई	i
ईँट्टा	ĩʈ̚ʈä
ईश्वर	isːor
उ	u
उँचाइ	ũtsäi̯
उँट	ũʈ
उखु	uk̞ʰu
उचाइ	utsäi̯
उठ्नु	uʈʰɳu
उड्नु	uɽɳu
उत्तर	ut̪̚t̪ʌr
उदजन	ud̪dzʌn
उदाहरण	ud̪ä̤ːrʌɽ̃
उनचालीस	un̻tsälis
उनतीस	unʌt̪is
उनन्चालीस	unʌn̻tsälis
उनन्चास	unʌn̻tsäs
उनन्तीस	unʌn̪t̪is
उनन्पचास	unʌnpʌtsäs
उनन्सत्तरी	unʌnsʌt̪̚t̪ʌɾi
उनन्साठी	unʌnsäʈʰi
उनपचास	unpʌtsäs
उनसाठी	unsäʈʰi
उनानब्बे	unänʌb̚be
उनानसय	unänsʌe
उनान्असी	unänʌsi
उनान्सय	unänsʌe
उनासी	unäsi
उनी	uni
उनीहरू	uniɦʌɾu
उन्चालीस	un̻tsälis
उन्तीस	un̪t̪is
उन्नाइस	unːäi̯s
उन्नाईस	unːäi̯s
उन्सत्तरी	unsʌt̪̚t̪ʌɾi
उपनिषद्	upʌnisʌd̪
उप्टन्	up̚ʈʌn
उफ्रनु	uɸrʌnu
उभिनु	ubinu
उमाल्नु	umälnu
उमेर	umer
उम्रनु	umrʌnu
उम्लनु	umlʌnu
उसको	usko
उसमा	usmä
उसलाई	usläi̯
उसले	usle
उसिन्नु	usinːu
उहाँहरूको	uä̃‿ɦʌɾuko
उहाँहरूको	wä̃ː‿ɦʌɾuko
उहाहरुको	uä̃‿ɦʌɾuko
ऊ	u
ऋ	ɾi
ऋषि	ɾisi
ए	e
एउटा	eu̯ʈä
एउटै	eu̯ʈʌi̯
एक	ek
एकचालीस	ektsälis
एकतीस	ek̚t̪is
एकत्तर	ekʌt̪̚t̪ʌr
एकत्तीस	ekʌt̪̚t̪is
एकदम	ek̚d̪ʌm
एकसट्ठी	eksʌʈ̚ʈʰi
एकसठ्ठी	ekʌsʌʈʰʈʰi
एकहत्तर	ekʌ̤ːt̪̚t̪ʌr
एकाउन्न	ekäu̯nːʌ
एकानब्बे	ekänʌb̚be
एकासी	ekäsi
एक्का	ek̚kä
एक्काइस	ek̚käi̯s
एक्काईस	ek̚käi̯s
एक्काउन्न	ek̚käu̯nːʌ
एक्त्तीस	ek̚t̪t̪is
एगार	eg̞äɾʌ
एघार	eg̞ärʌ
एशिया	esijä
एस	es
एसरी	esʌɾi
एसिया	esijä
एस्तो	est̪o
ऐ	ʌi̯
ऐना	ʌi̯nä
ओ	o
ओइ	oi̯
ओठ	oʈʰ
ओढ्नु	oɽɳu
ओढ्ने	oɽɳe
ओहायो	oɦäjo
औ	ʌu̯
औंठी	ʌ̃ũ̯ʈʰi
औंला	ʌ̃ũ̯lä
औलो	ʌu̯lo
औषधी	ʌu̯sʌd̪i
क	kʌ
कटाउनु	kʌʈäu̯nu
कटि	kʌʈi
कटी	kʌʈi
कट्टी	kʌʈ̚ʈi
कट्नु	kʌʈɳu
कदर्	kʌd̪ʌr
कन्या	kʌnjä
कन्या	kʌnːjä
कपाल	kʌpäl
कपास	kʌpäs
कफी	kʌɸi
कमिज	kʌmidz
कमिला	kʌmilä
कमिलो	kʌmilo
कमीज	kʌmidz
कम्पनी	kʌmpʌni
कम्बल	kʌmbʌl
कम्मर	kʌmːʌr
करङ	kʌɾʌŋ
कराउनु	kʌɾäu̯nu
करोड	kʌɾoɽ
कर्णाली	kʌrɽ̃äli
कलम	kʌlʌm
कलेजो	kʌledzo
कसको	kʌsko
कसमा	kʌsmä
कसरी	kʌhʌɾi
कसरी	kʌsʌɾi
कसरी	kʌxʌɾi
कसलाई	kʌsläi̯
कसले	kɔlle
कसले	kɔsle
कसले	kʌlle
कसले	kʌsle
कसैले	kʌsʌi̯le
कस्को	kʌsko
कस्तो	kʌst̪o
कहाँ	kä̃ː
कहाँ	kä̆hä̃
कहाँ	kä̆ɦä̤̃
कहिले	kʌi̯le
कहिले	kʌ̤i̯le
काँः	kä̤̃ː
काँच	kä̃ts
काँध	kä̃d̪
काँसो	kä̃so
कांच	kä̃ts
काका	käkä
काकी	käki
काख	käk̞ʰ
कागज	käg̞ʌdz
कागत	käg̞ʌdz
कागत	käg̞ʌd̪
कागत	käg̞ʌt̪
कागती	käg̞ʌt̪i
काजी	kädzi
काट्नु	käʈɳu
काठमाडौँ	käʈʰmäɳɖu
काठमाडौँ	käʈʰmäɽʌ̃ũ̯
काठमाडौं	käʈʰmäɳɖu
काठमाडौं	käʈʰmäɽʌ̃ũ̯
काढ्नु	käɽɳu
कात्तिक	kät̪̚t̪ik
कापी	käpi
कापी	kʌpi
काफल	käɸʌl
काम	käm
कामना	kämʌnä
कामी	kämi
काम्लो	kämlo
कार	kär
कार्तिकेय	kärt̪ikejʌ
कार्त्तिक	kärt̪̚t̪ik
कालो	kälo
कालोपाटी	kälopäʈi
किताप	kit̪äp
किताब	kit̪äb
किताबहरू	kit̪äb‿ɦʌɾu
किन	kinʌ
किनकि	kinʌki
किनभने	kinʌbʌne
किन्नु	kinːu
किरा	kiɾä
किराना	kiɾänä
किशोर	kisor
कीरा	kiɾä
कुइरे	kui̯ɾe
कुइरो	kui̯ɾo
कुकुर	kukur
कुकुर	kuk̚kur
कुक्कुर	kuk̚kur
कुखुरा	kuk̞ʰuɾä
कुचो	kutso
कुट्नु	kuʈɳu
कुद्नु	kud̪n̪u
कुन	kun
कुनचाहिँ	kun̻tsäĩ̯
कुनै	kunʌi̯
कुमारी	kumäɾi
कुरा	kuɾä
कुरामा	kuɾämä
कुरी	kuɾi
कुशल	kusʌl
कृपया	kirpʌjä
कृपया	kɾipʌjä
के	ke
केंद्र	ken̪d̪rʌ
केई	kei̯
केको	keko
केटा	keʈä
केटी	keʈi
केमा	kemä
केरा	keɾä
केराउ	keɾäu̯
केलाई	keläi̯
केले	kele
केही	kei̯
केही	keɦi
कैले	kʌi̯le
को	ko
कोई	koi̯
कोठा	koʈʰä
कोतर्नु	kot̪ʌrnu
कोशिश	kosis
कोशी	kosi
कोही	koi̯
क्लास	kläs
क्ष	tsʰe
क्ष	tsʰʌ
क्षत्राणी	tsʰʌt̪räɽ̃i
क्षत्रिय	tsʰʌt̪rie
क्षमता	tsʰemʌt̪ä
क्षमता	tsʰʌmʌt̪ä
क्षयरोग	tsʰʌeɾog̞
क्षेत्र	tsʰet̪rʌ
क्षेत्रिनी	tsʰet̪rini
क्षेत्री	tsʰet̪ri
ख	kʰʌ
खतरनाक	kʰʌt̪ʌrnäk
खत्रिनी	kʰʌt̪rini
खत्री	kʰʌt̪ri
खनाति	kʰʌnät̪i
खनातिनि	kʰʌnät̪ini
खनातिनी	kʰʌnät̪ini
खनाती	kʰʌnät̪i
खन्	kʰʌn
खन्नु	kʰʌnːu
खबर	kʰʌbʌr
खर	kʰʌr
खरब	kʰʌɾʌb
खरानी	kʰʌɾäni
खराब	kʰʌɾäb
खरायो	kʰʌɾäjo
खरी	kʰʌɾi
खरीमट्टी	kʰʌɾimʌʈ̚ʈi
खर्ब	kʰʌrbʌ
खल्ती	kʰʌl̪t̪i
खस	kʰʌs
खस	kʰʌsʌ
खसी	kʰʌsi
खस्नु	kʰʌsnu
खा	kʰä
खाऊ	kʰäu̯
खाजा	kʰädzä
खाडल	kʰäɽʌl
खाता	kʰät̪ä
खाते	kʰät̪e
खाना	kʰänä
खानु	kʰänu
खानेकुरा	kʰänekuɾä
खाल्टो	kʰäɭʈo
खाल्डो	kʰäɭɖo
खाल्डो	kʰäɭʈo
खीर	kʰir
खुकुरी	kʰukuɾi
खुट्टा	kʰuʈ̚ʈä
खुर्सानी	kʰursäni
खुला	kʰulä
खुवाउनु	kʰuwäu̯nu
खुशी	kʰusi
खुसी	kʰusi
खेल	kʰel
खेलकुद	kʰelkud̪
खेल्नु	kʰelnu
खैरो	kʰʌi̯ɾo
खोज्नु	kʰodznu
खोर्सानी	kʰorsäni
खोल	kʰol
खोल	kʰolʌ
खोला	kʰolä
खोल्नु	kʰolnu
ग	gʌ
गँगटा	gʌ̃g̞ʌʈä
गएको	gʌeko
गगन	gʌg̞ʌn
गछ्नु	gʌtsʰnu
गणतन्त्र	gʌɽ̃ʌt̪ʌn̪t̪rʌ
गण्डकी	gʌɳɖʌki
गन्नु	gʌnːu
गमला	gʌmlä
गर	gʌɾʌ
गराउनु	gʌɾäu̯nu
गराउने	gʌɾäu̯ne
गरि	gʌɾi
गरुङ्गो	gʌɾuŋgo
गरे	gʌɾe
गरेको	gʌɾeko
गरेर	gʌɾerʌ
गर्	gʌr
गर्दा	gʌrd̪ä
गर्दै	gʌrd̪ʌi̯
गर्न	gʌrnʌ
गर्नको	gʌrnʌko
गर्नु	gʌrnu
गर्नुहोला	gʌrnuolä
गर्नुहोस्	gʌrnuos
गर्ने	gʌrne
गर्मी	gʌrmi
गल्ती	gʌl̪t̪i
गह्रुँगो	gʌɾuŋgo
गह्रुंगो	gʌɾuŋgo
गह्रुङ्गो	gʌɾuŋgo
गह्रुङ्ङो	gʌɾuŋŋo
गह्रौं	gʌɾuŋgo
गह्रौं	gʌɾʌ̃ũ̯
गा	gä
गाँउ	gä̃ũ̯
गाँठो	gä̃ʈʰo
गाई	gäi̯
गाउँ	gä̃ũ̯
गाउनु	gäu̯nu
गाऊ	gäu̯
गाजर्	gädzʌr
गाडा	gäɽä
गाढा	gäɽä
गाली	gäli
गाविस	gäbisʌ
गाविसहरू	gäbisʌɦʌɾu
गाह्रो	gäɾo
गीत	git̪
गीलो	gilo
गु	gu
गुगल	gug̞ʌl
गुजराती	gudzrät̪i
गुणसूत्र	guɽ̃ʌsut̪rʌ
गुनासो	gunäso
गुफा	guɸä
गुरु	guɾu
गुलाफी	guläɸi
गुलाबी	guläbi
गुलाम	guläm
गुलियो	gulijo
गुहु	gu
गुहु	guː
गुहु	gṳː
गू	gu
गूगल	gug̞ʌl
गैँडा	gʌ̃ĩ̯ɽä
गैंडा	gʌ̃ĩ̯ɽä
गोटी	goʈi
गोडा	goɽä
गोदावरी	god̪äwʌɾi
गोर्खा	gorkʰä
गोलो	golo
गौँत	gʌ̃ũ̯t̪
ग्यार	gjärʌ
ग्रह	grʌ̤ː
ग्रीष्म	grismʌ
घ	gʱʌ̤
घंटा	gʱʌ̤ɳʈä
घडी	gʱʌ̤ɽi
घण्टा	gʱʌ̤ɳʈä
घन्टा	gʱʌ̤ɳʈä
घर	gʱʌ̤r
घर	gʱʌ̤ɾʌ
घाँस	gʱä̤̃s
घाइते	gʱä̤i̯t̪e
घाउ	gʱä̤u̯
घाम	gʱä̤m
घिच्नु	gʱi̤tsnu
घुर्नु	gʱṳrnu
घूस	gʱṳs
घोट्नु	gʱo̤ʈɳu
घोडा	gʱo̤ɽä
घोप्नु	gʱo̤pnu
घोराही	gʱo̤ɾäi̯
घोरिनु	gʱo̤ɾinu
ङ	ŋʌ
च	tsʌ
चउन्न	tsʌu̯nːʌ
चक	tsʌk
चकटी	tsʌkʌʈi
चक्का	tsʌk̚kä
चक्कु	tsʌk̚ku
चढ्नु	tsʌɽɳu
चन्द्र	tsʌn̪d̪rʌ
चन्द्रमा	tsʌn̪d̪rʌmä
चपोरा	tsʌpoɾä
चरप्प	tsʌɾʌp̚pʌ
चरा	tsʌɾä
चराउनु	tsʌɾäu̯nu
चर्	tsʌr
चर्नु	tsʌrnu
चलचित्र	tsʌl̻tsit̪rʌ
चलन	tsʌlʌn
चल्नु	tsʌlnu
चवालीस	tsʌwälis
चश्मा	tsʌsmä
चस्मा	tsʌsmä
चाईं	tsäĩ̯
चाख	tsäk̞ʰ
चाख्नु	tsäk̞ʰnu
चाट	tsäʈ
चार	tsär
चारवटा	tsär‿wʌʈä
चालीस	tsälis
चाहनु	tsä̤ːnu
चाहिँ	tsäĩ̯
चाहिएमा	tsäi̯emä
चाहिनु	tsäi̯nu
चिउरा	tsiu̯ɾä
चिक	tsikʌ
चिक्	tsik
चिक्नु	tsiknu
चिज	tsidz
चिठि	tsiʈʰi
चिठी	tsiʈʰi
चिठी	tsiʈ̚ʈʰi
चिडी	tsiɽi
चिताउनु	tsit̪äu̯nu
चित्त	tsit̪̚t̪ʌ
चित्र	tsit̪rʌ
चिनी	tsini
चिन्नु	tsinːu
चिया	tsijä
चिसो	tsiso
चीज	tsidz
चीन	tsin
चीनियाँ	tsinijä̃
चुरोट	tsuɾoʈ
चुस्नु	tsusnu
चैत	tsʌi̯t̪
चैत्र	tsʌi̯t̪rʌ
चोक	tsok
चोर	tsor
चोर	tsoɾʌ
चोर्नु	tsornu
चौँतीस	tsʌ̃ũ̯t̪is
चौंतीस	tsʌ̃ũ̯t̪is
चौका	tsʌu̯kä
चौतारी	tsʌu̯t̪äɾi
चौध	tsʌu̯d̪ʌ
चौबीस	tsʌu̯bis
चौरत्तर	tsʌu̯ɾʌt̪̚t̪ʌr
चौरानब्बे	tsʌu̯ɾänʌb̚be
चौरासी	tsʌu̯ɾäsi
चौवन्न	tsʌu̯wʌnːʌ
चौसठ्ठी	tsʌu̯sʌʈʰʈʰi
चौहत्तर	tsʌu̯ʌt̪̚t̪ʌr
छ	tsʰʌ
छक्का	tsʰʌk̚kä
छक्क्याउनु	tsʰʌk̚kjäu̯nu
छडी	tsʰʌɽi
छत्तीस	tsʰʌt̪̚t̪is
छन्	tsʰʌn
छपन्न	tsʰʌpʌnːʌ
छप्पन्न	tsʰʌp̚pʌnːʌ
छब्बीस	tsʰʌb̚bis
छयत्तर	tsʰʌet̪̚t̪ʌr
छयसट्ठी	tsʰʌesʌʈ̚ʈʰi
छयानब्बे	tsʰʌjänʌb̚be
छयालीस	tsʰʌjälis
छयासी	tsʰʌjäsi
छल्नु	tsʰʌlnu
छहत्तर	tsʰʌ̤ːt̪̚t̪ʌr
छाउपडी	tsʰäu̯pʌɽi
छाना	tsʰänä
छानो	tsʰäno
छान्नु	tsʰänːu
छाहारि	tsʰä̤ːri
छिटो	tsʰiʈo
छिट्टो	tsʰiʈ̚ʈo
छिन	tsʰin
छिन	tsʰinʌ
छिनो	tsʰino
छिमेकी	tsʰimeki
छुँ	tsʰũ
छुट्टाउनु	tsʰuʈ̚ʈäu̯nu
छुट्ट्याउनु	tsʰuʈ̚ʈjäu̯nu
छुट्नु	tsʰuʈɳu
छुनु	tsʰunu
छुर्पी	tsʰurpi
छेत्रिनी	tsʰet̪rini
छेत्री	tsʰet̪ri
छैंसठ्ठी	tsʰʌ̃ĩ̯sʌʈʰʈʰi
छैन	tsʌi̯nʌ
छैनौ	tsʰʌi̯nʌu̯
छोग्याल	tsʰog̞jäl
छोटो	tsʰoʈo
छोप्नु	tsʰopnu
छोरा	tsʰoɾä
छोरी	tsʰoɾi
छोरो	tsʰoɾo
छोल	tsʰolʌ
छोल्	tsʰol
छोल्नु	tsʰolnu
छौ	tsʰʌu̯
ज	dzʌ
जग्गा	dzʌg̞gä
जङ्गल	dzʌŋgʌl
जनकपुर	dzʌnʌk̚pur
जनसंख्या	dzʌnʌsʌŋkʰjä
जनसङ्ख्या	dzʌnʌsʌŋkʰjä
जना	dzʌnä
जनावर	dzʌnäwʌr
जन्मदिन	dzʌnmʌd̪in
जमिन	dzʌmin
जमिनदार	dzʌmin̪d̪är
जमिन्दार	dzʌmin̪d̪är
जमीन	dzʌmin
जमीनदार	dzʌmin̪d̪är
जम्नु	dzʌmnu
जम्मा	dzʌmːä
जरा	dzʌɾä
जरूर	dzʌɾur
जरूरी	dzʌɾuri
जरो	dzʌɾo
जर्मनी	dzʌrmʌni
जल	dzʌl
जल्नु	dzʌlnu
जसको	dzʌsko
जसमा	dzʌsmä
जसलाई	dzʌsläi̯
जसले	dzʌlle
जसले	dzʌsle
जहाँ	dzä̃ː
जहाँ	dzä̆ɦä̤̃
जहाज	dzä̤ːdz
जा	dzä
जाँः	dzä̤̃ː
जाँच्नु	dzä̃tsnu
जाँठो	dzä̃ʈʰo
जाऊ	dzäu̯
जाडो	dzäɽo
जाति	dzät̪i
जानु	dzänu
जान्नु	dzänːu
जामुनी	dzämuni
जिउनु	dziu̯nu
जिब्रो	dzibro
जिल्ला	dzillä
जिल्लाका	dzilläkä
जिल्लाको	dzilläko
जिल्लाहरू	dzillä‿ɦʌɾu
जी	dzi
जीउ	dziu̯
जीवनी	dzibʌni
जुँगा	dzuŋgä
जुँगा	dzũg̞ä
जुत्ता	dzut̪̚t̪ä
जुन	dzun
जुम्रा	dzumrä
जुवाइँ	dzuwäĩ
जून	dzun
जेठ	dzeʈʰ
जेठान	dzeʈʰu
जेठान	dzeʈʰän
जेठानी	dzeʈʰäni
जेब्रा	dzebrä
जो	dzo
जोइ	dzoi̯
जोकर	dzokʌr
ज्ञ	gj
ज्ञान	gjän
ज्येष्ठ	dzjes̠t̠ʰʌ
ज्वरो	dzoɾo
ज्वाइँ	dzwäĩ
झ	dzʱʌ̤
झरी	dzʱʌ̤ɾi
झाँट	dzʱä̤̃ʈ
झाक्री	dzʱä̤kri
झाडु	dzʱä̤ɽu
झुम्का	dzʱṳmkä
झोला	dzʱo̤lä
झ्याल	dzʱjäl
ञ	jʌ̃
ञ	nʌ
ञकार	jʌ̃kär
ट	ʈʌ
टपरी	ʈʌpʌɾi
टाउको	ʈäu̯ko
टाढा	ʈäɽä
टिकट	ʈikʌʈ
टीका	ʈikä
टील	ʈil
टेबुल	ʈebul
टोक्नु	ʈoknu
टोपी	ʈopi
ट्याक्सी	ʈjäksi
ठ	ʈʰʌ
ठकुरी	ʈʰʌkuɾi
ठन्कनु	ʈʰʌnkʌnu
ठन्काउनु	ʈʰʌnkäu̯nu
ठाउँ	ʈʰäũ
ठीक	ʈʰik
ठीकै	ʈʰikʌi̯
ठुलो	ʈʰulo
ठूलो	ʈʰulo
ठोक्	ʈʰok
ठोक्नु	ʈʰoknu
ड	ɖʌ
डङका	ɖʌŋkä
डच	ɖʌts
डढ्नु	ɖʌɽɳu
डराउनु	ɖʌɾäu̯nu
डलर	ɖʌlʌr
डा	ɖäk̚ʈʌr
डाँका	ɖä̃kä
डाका	ɖäkä
डाक्टर	ɖäk̚ʈʌr
डाक्टरी	ɖäk̚ʈʌɾi
डिसेम्बर	ɖisembʌr
डुङ्गा	ɖuŋgä
डुल्नु	ɖulnu
डेनमार्क	ɖenmärk
ढ	ɖʱʌ̤
ढल्नु	ɖʱʌ̤lnu
ढाँचा	ɖʱä̤̃tsä
ढाक्नु	ɖʱä̤knu
ढाड	ɖʱä̤ɽ
ढाल्नु	ɖʱä̤lnu
ढिँडो	ɖʱĩɽo
ढिलो	ɖʱi̤lo
ढुकुर	ɖʱṳkur
ढुङ्गा	ɖʱṳŋgä
ढोका	ɖʱo̤kä
ण	ɳʌ
ण	ɽ̃ʌ
ण	ʌ̃ɳ
त	t̪ʌ
तँ	t̪ʌ̃
तँमा	t̪ʌ̃mä
तँलाई	t̪ʌ̃läi̯
तकिया	t̪ʌkijä
तताउनु	t̪ʌt̪äu̯nu
तथा	t̪ʌt̪ʰä
तथापि	t̪ʌt̪ʰäpi
तथ्याङ्क	t̪ʌt̪ʰjäŋkʌ
तन्ना	t̪ʌnːä
तपाईँलाई	t̪ʌpä̃ĩ̯läi̯
तपाईं	t̪ʌpäĩ̯
तपाईंको	t̪ʌpäĩ̯ko
तपाईंमा	t̪ʌpäĩ̯mä
तपाईंलाई	t̪ʌpä̃ĩ̯läi̯
तपाईंले	t̪ʌpä̃ĩ̯le
तर	t̪ʌr
तर	t̪ʌrʌ
तरकारी	t̪ʌrkäɾi
तर्फबाट	t̪ʌrpʰʌ‿bäʈʌ
तस्बिर	t̪ʌsbir
तातो	t̪ät̪o
तात्नु	t̪ät̪n̪u
तान्नु	t̪änːu
ताप	t̪äp
तापक्रम	t̪äp̚krʌm
तारा	t̪äɾä
ताल	t̪äl
तास	t̪äs
तिक्का	t̪ik̚kä
तिखो	t̪ik̞ʰo
तितो	t̪it̪o
तिब्बत	t̪ib̚bʌt̪
तिमी	t̪imi
तिमीमा	t̪imimä
तिमीलाई	t̪imiläi̯
तिमीले	t̪imile
तिम्रो	t̪imro
तिर	t̪ir
तिर	t̪iɾʌ
तिरत्तर	t̪iɾʌt̪̚t̪ʌr
तिरानब्बे	t̪iɾänʌb̚be
तिरासी	t̪iɾäsi
तिर्चालिस	t̪irtsälis
तिर्नु	t̪irnu
तिर्पन्न	t̪irpʌnːʌ
तिर्सट्ठी	t̪irsʌʈ̚ʈʰi
तिर्सठ्ठी	t̪irsʌʈ̚ʈʰi
तिहार	t̪iär
तिहार	t̪iɦär
ती	t̪i
तीन	t̪in
तीर	t̪ir
तीस	t̪is
तुतुरो	t̪ut̪uɾo
तुरी	t̪uɾi
तेईं	t̪eĩ̯
तेईस	t̪ei̯s
तेजारत	t̪edzäɾʌt̪
तेत्तीस	t̪et̪̚t̪is
तेरो	t̪eɾo
तेर्सिनु	t̪ersinu
तेस्रो	t̪esro
तेह्र	t̪eɾʌ
तैँले	t̪ʌ̃ĩ̯le
तैरिनु	t̪ʌi̯ɾinu
त्यसको	t̪esko
त्यसमा	t̪esmä
त्यसलाई	t̪esläi̯
त्यसले	t̪esle
त्यहाँ	t̪jä̃
त्यहाँ	t̪jä̃ː
त्यहाँ	t̪jä̆ɦä̤̃
त्याँः	t̪jä̃ː
त्यो	t̪jo
त्र	t̪rʌ
त्रिचालीस	t̪ritsälis
त्रिपन्न	t̪ripʌnːʌ
त्रियानब्बे	t̪rijänʌb̚be
त्रियासी	t̪rijäsi
त्रिसट्ठी	t̪risʌʈ̚ʈʰi
त्रिहत्तर	t̪riɦʌt̪̚t̪ʌr
थ	t̪ʰʌ
थप्दै	t̪ʰʌp̚d̪ʌi̯
थप्न	t̪ʰʌpnʌ
थप्नु	t̪ʰʌpnu
थर	t̪ʰʌr
थानु	t̪ʰänu
थापा	t̪ʰäpä
थाल	t̪ʰäl
थाह	t̪ʰä̤ː
थाहा	t̪ʰäʔä
थाहा	t̪ʰä̤ː
थिचेर	t̪ʰitseɾʌ
थिच्नु	t̪ʰitsnu
थियो	t̪ʰijo
थुक्नु	t̪ʰuknu
थुरी	t̪ʰuɾi
द	d̪ʌ
दक्षिण	d̪ʌktsʰĩɽ̃
दक्षिण	d̪ʌk̚kʰin
दक्षिण	d̪ʌk̚tsʰjiɽ̃
दक्षिण	d̪ʌt̚tsʰiɽ̃
दगुर्नु	d̪ʌg̞urnu
दबाउनु	d̪ʌbäu̯nu
दल्नु	d̪ʌlnu
दश	d̪ʌs
दशैं	d̪ʌsʌ̃ĩ̯
दस	d̪ʌs
दसैँ	d̪ʌsʌ̃ĩ̯
दहल	d̪ʌ̤ːl
दाँज्नु	d̪ä̃dznu
दाँत	d̪ä̃t̪
दाइ	d̪äi̯
दाई	d̪äi̯
दाजु	d̪ädzju
दाजु	d̪ädzu
दाडिम	d̪äɽim
दाना	d̪änä
दारिम	d̪äɾim
दारी	d̪äɾi
दार्जिलिङ	d̪ärdziliŋ
दाहिने	d̪äi̯ne
दाह्री	d̪äɾi
दिउँसो	d̪iũso
दिक्क	d̪ik̚kʌ
दिदी	d̪id̪i
दिन	d̪in
दिन	d̪inʌ
दिनको	d̪inko
दिनु	d̪inu
दिन्छ	d̪in̻tsʰʌ
दिल्ली	d̪illi
दिसा	d̪isä
दुःख	d̪uk̚kʰʌ
दुःख	d̪uk̞ʰʌ
दुई	d̪ui̯
दुईवटा	d̪ui̯wʌʈä
दुक्का	d̪uk̚kä
दुख	d̪ukʰʌ
दुखी	d̪uk̞ʰi
दुख्नु	d̪uk̞ʰnu
दुतावास	d̪ut̪äbäs
दुद	d̪ud̪
दुध	d̪ud̪
दुना	d̪unä
दुनु	d̪unu
दुनो	d̪uno
दुलहा	d̪ulä̤ː
दुलही	d̪ulʌi̯
दुश्मन	d̪usmʌn
दुहुनु	d̪uu̯nu
दुहुनु	d̪uːnu
दूतावास	d̪ut̪äbäs
दूध	d̪ud̪
दे	d̪e
देउखुरी	d̪eu̯k̞ʰuɾi
देउरानी	d̪eu̯ɾäni
देओर	d̪eor
देखाउनु	d̪ek̞ʰäu̯nu
देखि	d̪ek̞ʰi
देखिनु	d̪ek̞ʰinu
देख्नु	d̪ek̞ʰnu
देवनागरी	d̪ebʌnäg̞ʌɾi
देवर	d̪ewʌr
देवरानी	d̪eu̯ɾäni
देवरानी	d̪ewräni
देश	d̪es
देसी	d̪esi
दोकान	d̪okän
दौडनु	d̪ʌu̯ɽinu
दौडनु	d̪ʌu̯ɽʌnu
द्यौरानी	d̪eu̯ɾäni
ध	d̪ʱʌ̤
धकेल्नु	d̪ʱʌ̤kelnu
धत्तेरि	d̪ʱʌ̤t̪̚t̪eɾi
धत्तेरी	d̪ʱʌ̤t̪̚t̪eɾi
धनगढी	d̪ʱʌ̤ngʌɽi
धन्यवाद	d̪ʱʌ̤nːebäd̪
धरान	d̪ʱʌ̤ɾän
धराप	d̪ʱʌ̤ɾäp
धरापिलो	d̪ʱʌ̤ɾäpilo
धर्ती	d̪ʱʌ̤rt̪i
धर्म	d̪ʱʌ̤rmʌ
धुनु	d̪ʱṳnu
धुलो	d̪ʱṳlo
धुवाँ	d̪ʱṳwä̃
धेरै	d̪ʱe̤ɾʌi̯
धोतिनी	d̪ʱo̤t̪ini
धोती	d̪ʱo̤t̪i
ध्वाँसे	d̪ʱwä̃se
न	nʌ
नक्सा	nʌksä
नगर	nʌg̞ʌr
नगर	nʌ‿gʌɾʌ
नगर्	nʌg̞ʌr
नङ	nʌŋ
नजिक	nʌdzik
नदी	nʌd̪i
नन्द	nʌn̪d̪ʌ
नब्बे	nʌb̚be
नमस्कार	nʌmʌskär
नमस्ते	nʌmʌst̪e
नयन	nʌen
नयाँ	nʌjä̃
नरक	nʌɾʌk
नराम्रो	nʌɾämro
नर्क	nʌrkʌ
नर्स	nʌrs
नवलपुर	nʌu̯ʌlpur
नहल	nʌ̤ːl
नाइटो	näi̯ʈo
नाउँ	näũ
नाक	näk
नाच	näts
नाच	nätsʌ
नाच्नु	nätsnu
नाति	nät̪i
नातिना	nät̪inä
नातिनी	nät̪ini
नाती	nät̪i
नानी	näni
नाम	näm
नि	ni
निचर्नु	nitsʌrnu
निचोर्नु	nitsornu
निद्रा	nid̪rä
निम्ति	nimt̪i
निलो	nilo
निस्कनु	niskʌnu
नीलो	nilo
नुन	nun
नुहाउनु	nuäu̯nu
नेपाल	nepäl
नेपालका	nepälkä
नेपालको	nepälko
नेपालगंज	nepälgʌn̻dz
नेपालगञ्ज	nepälgʌn̻dz
नेपालमा	nepälmä
नेपाली	nepäli
नै	nʌi̯
नैनु	nʌi̯nu
नौ	nʌu̯
न्यानो	njäno
प	pʌ
पंजा	pʌn̻dzä
पकाउनु	pʌkäu̯nu
पकौडा	pʌkʌu̯ɽä
पक्का	pʌk̚kä
पखाला	pʌk̞ʰälä
पचत्तर	pʌtsʌt̪̚t̪ʌr
पचपन्न	pʌtspʌnːʌ
पचहत्तर	pʌtsʌ̤ːt̪̚t̪ʌr
पचास	pʌtsäs
पचासी	pʌtsäsi
पच्चीस	pʌt̚tsis
पछि	pʌtsʰi
पञ्चानब्बे	pʌn̻tsänʌb̚be
पढ	pʌɖʱʌ̤
पढाउनु	pʌɽäu̯nu
पढ्	pʌɽ
पढ्नु	pʌɽɳu
पढ्नुहोस्	pʌɽɳuos
पत्र	pʌt̪rʌ
पद	pʌd̪
पनाति	pʌnät̪i
पनातिनि	pʌnät̪ini
पनि	pʌni
पन्चानब्बे	pʌn̻tsänʌb̚be
पन्छी	pʌn̻tsʰi
पन्जा	pʌn̻dzä
पन्द्र	pʌn̪d̪rʌ
पन्ध्र	pʌn̪d̪rʌ
पर	pʌɾʌ
पराल	pʌɾäl
परासी	pʌɾäsi
परिचय	pʌɾitsʌe
परिपुर्न	pʌɾipurnʌ
परिपूर्ण	pʌɾipurɽ̃ʌ
परिबार	pʌɾibär
परिवार	pʌɾiwär
परीक्षा	pʌɾik̚tsʰjä
परे	pʌɾe
परेको	pʌɾeko
परेमा	pʌɾemä
परेली	pʌɾeli
पर्खनु	pʌrkʰʌnu
पर्दा	pʌrd̪ä
पर्नु	pʌrnu
पल्टिनु	pʌɭʈinu
पश्चिम	pʌstsim
पसल	pʌsʌl
पस्नु	pʌsnu
पहाड	pä̤ːɽ
पहिला	pʌi̯lä
पहिले	pʌi̯le
पहिलो	pʌi̯lo
पहेँलो	pʌɦẽlo
पहेंलो	pʌɦẽlo
पाँच	pä̃ts
पाइनु	päi̯nu
पाइने	päi̯ne
पाउ	päu̯
पाउनु	päu̯nu
पाक्नु	päknu
पाखुरा	päk̞ʰuɾä
पाठ	päʈʰ
पात	pät̪
पाद्नु	päd̪n̪u
पान	pän
पानी	päni
पानु	pänu
पार्वती	pärbʌt̪i
पाल	päl
पाल्नु	pälnu
पाहुना	päu̯nä
पिउनु	piu̯nu
पिट्नु	piʈɳu
पिठो	piʈʰo
पिता	pit̪ä
पिपीलिका	pipilikä
पिरो	piɾo
पुग्नु	pug̞nu
पुछ्नु	pusnu
पुछ्नु	putsʰnu
पुती	put̪i
पुनः	punʌː
पुरातत्त्वशास्त्र	puɾät̪ʌt̪̚t̪osäst̪rʌ
पुरानो	puɾäno
पुर्न	purnʌ
पुष्टकारी	pus̠t̠ʌkäɾi
पुस	pus
पुस्तक	pust̪ʌk
पुस्तकालय	pust̪ʌkälʌe
पुस्नु	pusnu
पूर्ण	purɽ̃ʌ
पूर्व	purbʌ
पृथ्वी	pirt̪ʰibi
पृथ्वी	pɾit̪ʰbi
पृथ्वी	pɾit̪ʰibi
पृष्ठ	pɾis̠t̠ʰʌ
पेटी	peʈi
पैँचालीस	pʌ̃ĩ̯tsälis
पैँतालीस	pʌ̃ĩ̯t̪älis
पैँतीस	pʌ̃ĩ̯t̪is
पैँसट्ठी	pʌ̃ĩ̯sʌʈ̚ʈʰi
पैंतालीस	pʌ̃ĩ̯t̪älis
पैंतीस	pʌ̃ĩ̯t̪is
पैंसट्ठी	pʌ̃ĩ̯sʌʈ̚ʈʰi
पैंसठ्ठी	pʌ̃ĩ̯sʌʈʰʈʰi
पैसा	pʌi̯sä
पोइ	poi̯
पोखरा	pok̞ʰʌɾä
पोथी	pot̪ʰi
पोलिश	polis
पोल्नु	polnu
पोसाक	posäk
पौडिनु	pʌu̯ɽinu
पौने	pʌu̯ne
पौष	pʌu̯s
प्यारो	pjäɾo
प्रकाशाणु	prʌkäsäɽ̃u
प्रकृति	prʌkɾit̪i
प्रचंड	prʌtsʌɳɖʌ
प्रबिधि	prʌbid̪i
प्रभा	prʌbä
प्रमुख	prʌmuk̞ʰ
प्रयोग	prʌjog̞
प्रयोगकर्ता	prʌjog̞kʌrt̪ä
प्रयोगस्थल	prʌjog̞st̪ʰʌl
प्रविधि	prʌbid̪i
प्रश्न	prʌsnʌ
प्रश्नहरु	prʌsnʌ̤ːru
प्रश्नहरू	prʌsnʌ̤ːru
प्रहरी	prʌʔʌɾi
प्रहरी	prʌ̤ːri
प्राय	präe
प्रेम	prem
फ	pʰʌ
फकाउनु	pʰʌkäu̯nu
फरक	pʰʌɾʌk
फर्सी	pʰʌrsi
फल	pʰʌl
फल	pʰʌlʌ
फलफूल	pʰʌlpʰul
फल्नु	pʰʌlnu
फागुन	pʰäg̞un
फाल्गुन	pʰälgun
फाल्नु	pʰälnu
फुक्नु	pʰuknu
फुपाजु	pʰupädzu
फुपाज्यू	pʰupädzju
फुपु	pʰupu
फुपू	pʰupu
फुल	pʰul
फुसी	pʰusi
फुस्रो	pʰusro
फूल	pʰul
फेब्रुअरी	pʰebruʌɾi
फेरि	pʰeɾi
फेर्नु	pʰernu
फ्याँक्नु	pʰjä̃knu
ब	bʌ
बग्नु	bʌg̞nu
बच्चा	bʌt̚tsä
बजाउनु	bʌdzäu̯nu
बजार	bʌdzär
बजे	bʌdze
बढाउन	bʌɽäu̯nʌ
बढाउनु	bʌɽäu̯nu
बताउनु	bʌt̪äu̯nu
बताउने	bʌt̪äu̯ne
बत्तीस	bʌt̪̚t̪is
बदर	bʌd̪ʌr
बदाम्	bʌd̪äm
बदाम्	bʌd̪ʌm
बधू	bʌd̪u
बन	bʌn
बन	bʌnʌ
बना	bʌnä
बनाउनु	bʌnäu̯nu
बनाउनुहोला	bʌnäu̯nuolä
बनाऔ	bʌnäʌu̯
बनाऔँ	bʌnäʌ̃ũ̯
बनाऔं	bʌnäʌũ̯
बनेर	bʌneɾʌ
बन्द	bʌn̪d̪ʌ
बन्नु	bʌnːu
बबल	bʌbʌl
बयसट्ठी	bʌesʌʈ̚ʈʰi
बयसट्ठी	bʌi̯sʌʈ̚ʈʰi
बयानब्बे	bʌjänʌb̚be
बयालीस	bʌjälis
बयासी	bʌjäsi
बर	bʌr
बरफ	bʌɾʌɸ
बरि	bʌɾi
बर्खा	bʌrkʰä
बर्ग	bʌrgʌ
बर्ष	bʌrsʌ
बस	bʌs
बस	bʌsʌ
बसन्त	bʌsʌn̪t̪ʌ
बस्	bʌs
बस्ती	bʌst̪i
बस्तु	bʌst̪u
बस्नु	bʌsnu
बस‍	bʌsʌ
बहत्तर	bʌ̤ːt̪̚t̪ʌr
बहिनी	bʌi̯ni
बा	bä
बाँकी	bä̃ki
बाँच्नु	bä̃tsnu
बाँड्नु	bä̃ɽɳu
बाँध्नु	bä̃d̪n̪u
बाईस	bäi̯s
बाउ	bäu̯
बाउन्न	bäu̯nːʌ
बाकस	bäkʌs
बाख्रा	bäk̞ʰrä
बागमती	bäg̞mʌt̪i
बाघ	bäg̞
बाटो	bäʈo
बाथ	bät̪ʰ
बादल	bäd̪ʌl
बादशाह	bäd̪sä̤ː
बादशाह	bäsːä
बान्नु	bänːu
बाबा	bäbä
बाबु	bäbu
बारेमा	bäɾemä
बालुवा	bäluwä
बाहिर	bäi̯ɾʌ
बाहुन	bäun
बाह्र	bäɾʌ
बिकास	bikäs
बिगार्नु	big̞ärnu
बिजुली	bidzuli
बिज्ञान	big̞gjän
बिदा	bid̪ä
बिन्ति	bin̪t̪i
बिपना	bipʌnä
बिफर्	biɸʌr
बिबाह	bibä̤ː
बिभिन्न	bibinːʌ
बिमाख्	bimäk̞ʰ
बियर	bier
बियर	bijʌɾ
बिया	bijä
बिराटनगर	biɾäʈɳʌg̞ʌr
बिरामी	biɾämi
बिरालो	biɾälo
बिरुवा	biɾuwä
बिसौनी	bisʌu̯ni
बिस्तारै	bist̪äɾʌi̯
बिस्तारो	bist̪äɾo
बिहा	biɦä
बिहा	biʔä
बिहान	biɦänʌ
बिहिबार	bi̤ːbär
बिहीबार	bii̯bär
बीउ	biu̯
बीर	bir
बीस	bis
बुझ्नु	budznu
बुटवल	buʈol
बुटवल	buʈʌwʌl
बुटि	buʈi
बुढा	buɽä
बुढी	buɽi
बुढो	buɽo
बुद्ध	bud̪̚d̪ʌ
बुद्ध	bud̪̚d̪ʱʌ̤
बुद्धिचाल	bud̪̚d̪ʱi̤tsäl
बुधबार	bud̪ʌbär
बुन्नु	bunːu
बुबा	bubä
बुवा	buwä
बुवा	buä
बुहारी	buäɾi
बूढा	buɽä
बूढी	buɽi
बूढो	buɽo
बेइजिङ	bei̯dziŋ
बेलुका	belukä
बेहुला	beu̯lä
बेहुली	beu̯li
बैंक	beŋk
बैंक	bʌi̯ŋk
बैगनी	bʌi̯g̞ʌni
बैगुने	bʌi̯g̞une
बैजनी	bʌi̯dzʌni
बैनि	bʌi̯ni
बैसट्ठी	bʌi̯sʌʈ̚ʈʰi
बैसठ्ठी	bʌi̯sʌʈ̚ʈʰi
बोका	bokä
बोको	boko
बोट	boʈ
बोधो	bod̪o
बोल्नु	bolnu
ब्रह्मदेश	brʌmːʌd̪es
ब्रह्माण्ड	brʌmːäɳɖʌ
ब्वाँसो	bwä̃so
भ	bʱʌ̤
भए	bʱʌ̤e
भएका	bʱʌːkä
भएका	bʱʌ̤ekä
भएको	bʱʌːko
भएको	bʱʌ̤eko
भएमा	bʱʌ̤emä
भएर	bʱʌːɾʌ
भएर	bʱʌ̤eɾʌ
भक्तपुर	bʱʌ̤k̚t̪ʌpur
भतिज	bʱʌ̤t̪idz
भतिजा	bʱʌ̤t̪idzä
भतिजी	bʱʌ̤t̪idzi
भतिजो	bʱʌ̤t̪idzo
भतीजा	bʱʌ̤t̪idzä
भतीजी	bʱʌ̤t̪idzi
भदौ	bʱʌ̤d̪ʌu̯
भनिनु	bʱʌ̤ninu
भनिन्छ	bʱʌ̤nin̻tsʰʌ
भने	bʱʌ̤ne
भनेको	bʱʌ̤neko
भनेर	bʱʌ̤neɾʌ
भन्दा	bʱʌ̤n̪d̪ä
भन्नु	bʱʌ̤nːu
भन्ने	bʱʌ̤nːe
भरतपुर	bʱʌ̤ɾʌt̪̚pur
भाँच्नु	bʱä̤̃tsnu
भाइ	bʱä̤i̯
भाउजु	bʱä̤u̯dzu
भाउजू	bʱä̤u̯dzu
भाउज्यू	bʱä̤u̯dzju
भाडा	bʱä̤ɽä
भाद्र	bʱä̤d̪rʌ
भानिज	bʱä̤nidz
भान्जा	bʱä̤n̻dzä
भान्जी	bʱä̤n̻dzi
भान्जो	bʱä̤n̻dzo
भारत	bʱä̤ɾʌt̪
भालू	bʱä̤lu
भाषा	bʱä̤sä
भिजेको	bʱi̤dzeko
भिडियो	bʱi̤ɽijo
भित्र	bʱi̤t̪rʌ
भिना	bʱi̤nä
भिनाजु	bʱi̤nädzu
भिनाज्यू	bʱi̤nädzju
भिसा	bʱi̤sä
भीर	bʱi̤r
भुइँ	bʱũĩ̯
भुइँ	bʱʌ̤̃ĩ̯
भुईँचालो	bʱṳ̃ĩ̯tsälo
भुटान	bʱṳʈän
भुत्रो	bʱṳt̪ro
भूगोल	bʱṳg̞ol
भेट्नु	bʱe̤ʈɳu
भेना	bʱe̤nä
भैँसी	bʱʌ̤̃ĩ̯si
भैंसी	bʱʌ̤̃ĩ̯si
भोक	bʱo̤k
भोलि	bʱo̤li
म	mʌ
मःम	mʌmʌ
मःमः	mʌmʌ
मकै	mʌkʌi̯
मङ्गल	mʌŋgʌl
मङ्गलबार	mʌŋgʌlbär
मङ्सिर	mʌŋsir
मजेन्टा	mʌdzeɳʈä
मज्जा	mʌdzdzä
मदत्	mʌd̪ʌt̪
मधेश	mʌd̪es
मन	mʌn
मन्त्र	mʌn̪t̪rʌ
मन्त्रिणी	mʌn̪t̪riɽ̃i
मन्त्रिनी	mʌn̪t̪rini
मन्त्री	mʌn̪t̪ri
ममः	mʌmʌ
ममा	mʌmä
ममि	mʌmi
ममो	mʌmo
मर	mʌɾʌ
मरमरम्मत	mʌɾʌmʌɾʌmːʌt̪
मरमर्मत	mʌɾʌmʌrmʌt̪
मरम्मत	mʌɾʌmːʌt̪
मराठी	mʌɾäʈʰi
मरुभूमि	mʌɾubumi
मर्	mʌr
मर्नु	mʌrnu
मर्मत	mʌrmʌt̪
मलाई	mʌläi̯
महिना	mʌi̯nä
महिला	mʌilä
माँड	mä̃ɽ
माइजु	mäi̯dzu
माइजू	mäi̯dzu
माइज्यू	mäi̯dzju
माकुरा	mäkuɾä
माखो	mäk̞ʰo
माघ	mäg̞
माचिक्नी	mätsikni
माछा	mätsʰä
माझ्नु	mädznu
माता	mät̪ä
मानव	mänʌb
मानवता	mänʌb̚t̪ä
मानविकी	mänʌbiki
मानिस	mänis
मानिसहरू	mänisɦʌɾu
माने	mäne
मान्छे	män̻tsʰe
मान्नु	mänːu
माफ	mäɸ
मामा	mämä
मार्	mär
मार्ग	märgʌ
मार्नु	märnu
माला	mälä
मासु	mäsu
मास्नु	mäsnu
मिच्नु	mitsnu
मिठो	miʈʰo
मिति	mit̪i
मित्र	mit̪rʌ
मित्रता	mit̪rʌt̪ä
मिनेट	mineʈ
मिलाउँदै	miläũd̪ʌi̯
मिलेर	mileɾʌ
मिल्नु	milnu
मिस्सी	misːi
मुख	muk̞ʰ
मुख्य	mukkʰe
मुजी	mudzi
मुटु	muʈu
मुत्नु	mut̪n̪u
मुद्रा	mud̪rä
मेच	mets
मेटाउनु	meʈäu̯nu
मेटी	meʈi
मेट्नु	meʈɳu
मेरो	meɾo
मैले	mʌi̯le
मैलो	mʌi̯lo
मोःमो	momo
मोःमोः	momo
मोजा	modzä
मोटरसाइकल	moʈʌrsäi̯kʌl
मोटो	moʈo
मोड्नु	moɽɳu
मोमो	momo
मोमोः	momo
मोर	moɾʌ
मोर्	mor
मोर्नु	mornu
मौरी	mʌu̯ɾi
मौसम	mʌu̯sʌm
म्वाइँ	mwäĩ
यदि	ed̪i
यस	es
यसको	esko
यसमा	esmä
यसरी	esʌɾi
यसलाई	elläi̯
यसलाई	esläi̯
यसले	elle
यसले	esle
यसै	esʌi̯
यस्तो	est̪o
यहाँ	jä̃ː
यहाँ	jä̆ɦä̤̃
यहाँ	ɦjä̤̃
यहाँ	ɦjä̤̃ː
यहाँका	jä̃ːkä
यहाँको	jä̃ːko
यहाँमा	ɦjä̃ːmä
यहाँलाई	jä̃ːläi̯
यहाँले	jä̃ːle
यही	ei̯
यही	i̯ei̯
यही	jei̯
या	jä
यातायात	jät̪äjät̪
यानाति	jänät̪i
यी	i
युबक	jubʌk
युवक	juwʌk
यूरोप	juɾop
यो	jo
योगदान	jog̞d̪än
योगदानको	jog̞ʌd̪änko
योगदानहरू	jog̞ʌd̪änɦʌɾu
र	rʌ
रंडी	rʌɳɖi
रक्त	rʌk̚t̪ʌ
रक्सी	rɒksi
रक्सी	rʌksi
रगत	rʌg̞ʌt̪
रङ	rʌŋ
रङ्ग	rʌŋ
रङ्ग	rʌŋgʌ
रङ्गीचङ्गी	rʌŋgitsʌŋgi
रचना	rʌtsʌnä
रच्नु	rʌtsnu
रण्डी	rʌɳɖi
रत्न	rʌt̪n̪ʌ
रन्डी	rʌɳɖi
रमाइलो	rʌmäi̯lo
रमाईलो	rʌmäi̯lo
रस	rʌs
रसी	rʌsi
रहनु	rʌ̤ːnu
रहेका	rʌɦekä
रहेको	rʌɦeko
राँबो	rä̃bo
राकस	räkʌs
राख्नु	räk̞ʰnu
राजा	rädzä
रात	rät̪
रातो	rät̪o
रानी	räni
रामो	rämo
राम्ररी	rämrʌɾi
राम्रो	rämro
राष्ट्र	räs̠t̠rʌ
राष्ट्रपति	räs̠t̠rʌpʌt̪i
राष्ट्रिय	räs̠t̠rie
राष्ट्रीय	räs̠t̠rie
रित्तो	rit̪̚t̪o
रुख	ruk̞ʰ
रुनु	runu
रुप	rup
रुपियाँ	rupijä̃
रूख	ruk̞ʰ
रूप	rup
रूपमा	rupmä
रोक्नु	roknu
रोग	rog̞
रोटी	roʈi
रोपनी	ropʌni
ल	lʌ
लक्ष्मी	lʌksmi
लक्ष्मी	lʌk̚tsʰjmi
लक्ष्मी	lʌt̚tsʰimi
लगाउनु	lʌg̞äu̯nu
लगानी	lʌg̞äni
लघ्वातु	lʌg̞wät̪u
लट्ठी	lʌʈ̚ʈʰi
लड्नु	lʌɽɳu
लपक्क	lʌpʌk̚kʌ
लसुन	lʌsun
लाँडो	lä̃ɽo
लाई	läi̯
लाउनु	läu̯nu
लाख	läk̞ʰ
लागि	läg̞i
लाग्नु	läg̞nu
लाठी	läʈʰi
लाडो	läɽo
लामा	lämä
लामो	lämo
लिएको	lieko
लिङ्क	liŋk
लिनु	linu
लुकाउनु	lukäu̯nu
लुक्नु	luknu
लुगा	lug̞ä
लुम्बिनी	lumbini
ले	le
लेख	lekʰʌ
लेख	lek̞ʰ
लेखमा	lek̞ʰmä
लेखहरु	lek̞ʰ‿ɦʌɾu
लेखहरू	lek̞ʰɦʌɾu
लेखिएको	lek̞ʰieko
लेखिदिन्छ	lek̞ʰid̪in̻tsʰʌ
लेखिनु	lek̞ʰinu
लेख्	lek̞ʰ
लेख्न	lek̞ʰnʌ
लेख्नु	lek̞ʰnu
लैङ्गिक	lʌi̯ŋgik
लोग्ने	log̞ne
ल्वाङ	lwäŋ
व	wʌ
वटा	oʈä
वडा	oɽä
वडा	wʌɽä
वन	bʌn
वन्य	bʌnːe
वर्ग	bʌrgʌ
वर्णमाला	bʌrnʌmälä
वर्णमाला	bʌrɽ̃ʌmälä
वर्षा	bʌrsä
वसन्त	bʌsʌn̪t̪ʌ
वहाँ	wä̃ː
वहाँ	wä̆ɦä̤̃
वहाँ	wä̤̃ː
वहाँ	ɦwä̤̃ː
वहाँको	wä̃ːko
वहाँमा	wä̃ːmä
वहाँलाई	wä̃ːläi̯
वहाँले	wä̃ːle
वाक्नु	wäknu
वार्ता	bärt̪ä
वार्तालाप	bärt̪äläp
विकास	bikäs
विकि	biki
विकिपीडिया	wikipiɽijä
विजयादशमी	bidzʌjäd̪ʌsʌmi
विज्ञान	big̞gjän
विडूर	biɽur
विदेश	bid̪es
विद्यार्थी	bid̪̚d̪järt̪ʰi
विनोद	binod̪
विभिन्न	bibinːʌ
विराटनगर	biɾäʈɳʌg̞ʌr
विवाह	bibä̤ː
विश्व	bisːo
विश्वकप	bisːokʌp
विश्वका	bisːokä
विषयका	bisʌekä
विषयमा	bisʌemä
विषयसूचि	bisʌesutsi
विषयसूची	bisʌesutsi
विषाणु	bisäɽ̃u
वीरेन्द्रनगर	biɾen̪d̪rʌnʌg̞ʌr
वृश्चिक	bɾistsik
वेदना	bed̪ʌnä
वैशाख	bʌi̯säk̞ʰ
व्यक्तिलाई	bek̚t̪iläi̯
व्यवस्था	bebʌst̪ʰä
व्यापार	bepär
व्यापार	bjäpär
व्रत	brʌt̪ʌ
व्रत	bʌrt̪ʌ
श	sʌ
श	ʃʌ
शनिबार	sʌnibär
शब्दकोश	sʌb̚d̪ʌkos
शब्दकोष	sʌb̚d̪ʌkos
शरद	sʌɾʌd̪
शहर	sʌ̤ːr
शास्त्र	säst̪rʌ
शाह	sä̆ɦä̤
शाह	sä̤ː
शिकार	sikär
शिक्षक	sik̚tsʰek
शिक्षक	sit̚tsʰʲʌk
शिक्षा	sik̚tsʰjä
शिक्षा	sit̚tsʰjä
शिशिर	sisir
शुक्रबार	sukrʌbär
शुभकामना	subʱkämʌnä
शून्य	sunːe
शून्य	sunːä
शौचालय	sʌu̯tsälʌe
श्रावण	sräu̯ʌɽ̃
श्रावण	sräwʌɽ̃
श्री	sri
श्रीमती	srimʌt̪i
श्रीमान	srimän
ष	kʰʌ
ष	sʌ
षड्यन्त्र	sʌɽen̪t̪rʌ
स	sʌ
सँग	sʌŋgʌ
सँग	sʌŋʌ
सँग	sʌ̃gʌ
संग	sʌŋgʌ
संगति	sʌŋgʌt̪i
संगीत	sʌŋgit̪
संदर्भ	sʌn̪d̪ʌrbʱʌ̤
संवाद	sʌmbäd̪
संस्कृत	sʌnskɾit̪
संस्कृत	sʌ̃skɾit̪
संस्कृति	sʌnskɾit̪i
संस्कृति	sʌ̃skɾit̪i
संस्था	sʌnst̪ʰä
संस्था	sʌ̃st̪ʰä
सकिन्छ	sʌkin̻tsʰʌ
सक्छ	sʌktsʰʌ
सक्नु	sʌknu
सक्नुहुन्छ	sʌknṳːn̻tsʰʌ
सखर	sʌk̞ʰʌr
सगरमाथा	sʌg̞ʌrmät̪ʰä
सङ्गति	sʌŋgʌt̪i
सजिलो	sʌdzilo
सडक	sʌɽʌk
सड्नु	sʌɽɳu
सड्सठ्ठी	sʌɽsʌʈʰʈʰi
सतचालीस	sʌt̪tsälis
सतसट्ठी	sʌt̪ʌsʌʈ̚ʈʰi
सतहत्तर	sʌt̪ʌ̤ːt̪̚t̪ʌr
सतासी	sʌt̪äsi
सत्तरी	sʌt̪̚t̪ʌɾi
सत्ता	sʌt̪̚t̪ä
सत्ताईस	sʌt̪̚t̪äi̯s
सत्र	sʌt̪rʌ
सन्चै	sʌn̻tsʌi̯
सन्ताउन्न	sʌn̪t̪äu̯nːʌ
सन्तानब्बे	sʌn̪t̪änʌb̚be
सन्देश	sʌn̪d̪es
सन्सरबार्	sʌnitsʌrbär
सन्सरबार्	sʌnsʌrbär
सन्सरबार्	sʌn̻tsʌrbär
सपना	sʌpʌnä
सफा	sʌɸä
सब	sʌb
सबै	sʌbʌi̯
सबैको	sʌbʌi̯ko
समय	sʌmʌe
समस्त	sʌmʌst̪ʌ
समस्या	sʌmʌsːjä
समस्याको	sʌmʌsjäko
समात्नु	sʌmät̪n̪u
समाधान	sʌmäd̪än
समिति	sʌmit̪i
समुदायको	sʌmud̪äeko
समुद्र	sʌmud̪rʌ
सम्धिनी	sʌmd̪ʱi̤ni
सम्धी	sʌmd̪ʱi̤
सम्पर्क	sʌmpʌrkʌ
सम्पादन	sʌmpäd̪ʌn
सम्बन्धी	sʌmbʌn̪d̪i
सम्बन्धी	sʌmbʌn̪d̪ʱi̤
सम्म	sʌmːʌ
सय	sʌe
सरकार	sʌrkär
सरिफा	sʌɾiɸä
सरोज	sʌɾodz
सलल	sʌlʌlʌ
सलिफा	sʌliɸä
ससुरा	sʌsuɾä
ससुरो	sʌsuɾo
सहनु	sʌ̤ːnu
सहपाठी	sʌ̤ːpäʈʰi
सहयोग	sʌʔʌjog̞
सहयोग	sʌ̤ːjog̞
सहायता	sä̤ːet̪ä
सहायताका	sä̤ːet̪äkä
सहि	sʌi̯
साँप	sä̃p
सांझ	sä̃dz
सांझ	sä̃dzʌ
साइकल	säi̯kʌl
साउन	säun
साचो	sätso
साट्दै	säʈ̚d̪ʌi̯
साट्नु	säʈɳu
साठी	säʈʰi
साढे	säɽe
सात	sät̪
साता	sät̪ä
सातौं	sät̪ʌ̃ũ̯
साथी	sät̪ʰi
सानो	sjäno
सानो	säno
साप	säp
सामग्रीहरू	sämʌg̞riɦʌɾu
सामान्य	sämänːe
सामुदायिक	sämud̪äik
साला	sälä
साली	säli
साले	säle
सालो	sälo
सासु	säsu
सासू	säsu
साहित्य	säi̯t̪e
सिंह	siŋɦʌ
सिंह	sĩɦʌ
सिउनु	siu̯nu
सिकाउनु	sikäu̯nu
सिकार	sikär
सिक्किम	sik̚kim
सिक्नु	siknu
सिधो	sid̪o
सिपाही	sipäi̯
सिम्रिक	simrik
सिरानी	siɾäni
सिराने	siɾäne
सिलाउनु	siläu̯nu
सिसाकलम	sisäkʌlʌm
सीपाही	sipäi̯
सुँघ्नु	suŋnu
सुँघ्नु	sũg̞nu
सुक्खा	suk̚kʰä
सुझाव	sudzäb
सुझाव	sudzäu̯
सुत्नु	sut̪n̪u
सुदूरपश्चिम	sud̪uɾʌpʌstsim
सुन	sun
सुन	sunʌ
सुन्तला	sun̪t̪ʌlä
सुन्दर	sun̪d̪ʌr
सुन्ना	sunːä
सुन्निनु	sunːinu
सुन्नु	sunːu
सुन्नुहोस्	sunːuos
सुहाउनु	suäu̯nu
सूर्जे	surdze
सूर्य	surːe
सेतो	set̪o
सेप्टेम्बर	sep̚ʈembʌr
सैँतीस	sʌ̃ĩ̯t̪is
सैंतालीस	sʌ̃ĩ̯t̪älis
सैंतीस	sʌ̃ĩ̯t̪is
सैनिक	sʌi̯nik
सोच	sots
सोच	sotsʌ
सोच्नु	sotsnu
सोधपुछ	sod̪̚putsʰ
सोधिने	sod̪ine
सोध्नु	sod̪n̪u
सोमबार	sombär
सोमबार	sʌmbär
सोमबार	sʌ̃ũ̯bär
सोहोर्नु	so̤ːrnu
सोह्र	soɾʌ
स्कुल	skul
स्थिति	st̪ʰit̪i
स्याउ	sjäu̯
स्वत	sot̪ʌː
स्वतन्त्र	sot̪ʌn̪t̪rʌ
स्वशिक्षा	sosik̚tsʰjä
स्वागत	swägʌt̪
स्वादिलो	swäd̪ilo
स्वास्नि	swäsni
स्वास्नी	swäsni
ह	ɦʌ
हकार	ɦʌkäɾʌ
हकार्नु	ɦʌkärnu
हग्नु	ɦʌg̞nu
हजम	ɦʌdzʌm
हजाम	ɦʌdzäm
हजार	ɦʌdzär
हजुर	ɦʌdzur
हजुरआमा	ɦʌdzurämä
हजुरबा	ɦʌdzurbä
हजुरबुवा	ɦʌdzurbuä
हत्तेरी	ɦʌt̪̚t̪eɾi
हत्तेरीका	ɦʌt̪̚t̪eɾikä
हप्ता	ɦʌp̚t̪ä
हब्शी	ɦʌbsi
हब्सी	ɦʌbsi
हरा	ɦʌɾä
हराउनु	ɦʌɾäu̯nu
हरियो	ɦʌɾijo
हरेक	ɦʌɾek
हलुको	ɦʌluko
हलो	ɦʌlo
हवाईजहाज	ɦʌwäi̯dzä̤ːdz
हस	ɦʌs
हस्कनु	ɦʌskʌnu
हस्तमैथुन	ɦʌst̪ʌmʌi̯t̪ʰun
हाँक्नु	ɦä̃knu
हाँसो	ɦä̃so
हाँस्नु	ɦä̃snu
हाइड्रोजन	ɦäi̯ɽrodzʌn
हात	ɦät̪
हात्ती	ɦät̪̚t̪i
हान्नु	ɦänːu
हामी	ɦämi
हामीमा	ɦämimä
हामीलाई	ɦämiläi̯
हामीले	ɦämile
हाम्रो	ɦämro
हार्नु	ɦärnu
हावा	ɦäwä
हिँड्नु	ɦĩɽɳu
हिंड्नु	ɦĩɽɳu
हिउँ	ɦiũ
हिउँद	ɦiũd̪
हिजो	ɦidzo
हिज्जे	ɦidzdze
हिन्दी	ɦin̪d̪i
हिमाल	ɦimäl
हिमालय	ɦimälʌe
हिलो	ɦilo
हुँ	ɦum
हुँ	ɦũ
हुँदैन	ɦũd̪ʌi̯nʌ
हुकुम	ɦukum
हुनु	ɦunu
हुनुहुन्छ	ɦunu‿ɦun̻tsʰʌ
हुनुहुन्न	ɦunu‿ɦunːʌ
हुने	ɦune
हुनेछ	ɦunetsʰʌ
हुन्	ɦun
हुन्छ	ɦun̻tsʰʌ
हुन्छन्	ɦun̻tsʰʌn
हृदय	ɾid̪ʌe
हेटौडा	ɦeʈʌu̯ɽä
हेप्नु	ɦepnu
हेर्नु	ɦernu
हेर्नुहोस्	ɦernuos
हो	ɦo
होइन	ɦoi̯nʌ
होइन	ɦʌi̯nʌ
होइनौ	ɦoi̯nʌu̯
होइनौ	ɦʌi̯nʌu̯
होईन	ɦoi̯nʌ
होचो	ɦotso
होटल	ɦoʈʌl
होला	ɦolä
होली	ɦoli
हौ	ɦʌu̯
ह्याँ	ɦjä̃
ह्यात्तेरिका	ɦjät̪̚t̪eɾikä
ह्यात्तेरीका	ɦjät̪̚t̪eɾikä
ह्रस्व	rʌsːo
ह्वाँः	ɦwä̃ː
एक	ek
कि	ki
नि	ni
निको	niko
मेरो	meɾo
यो	jo
होस्	ɦos
