abacada	ʔàːbàːtʃàːdâː
abada	ʔàbə̀dâː
abarba	ʔàbàɽbáː
abdulhamid	ʔàbdɪ̀lhàmɪ̂d
abdulƙadir	ʔàbdɪ̀lkʼáːdɪ̀r
abdullahi	ʔàbdɪ̀lláːhɪ̀
abdurrahim	ʔábdɪ́ɽrə́hɪ́ŋ
abdussalamu	ʔàbdɪ̀ssə̀láːmʊ̀
abdu	ʔábdɪ̀
abjadi	ʔábdʒə̀díː
aboki	ʔàbóːcíː
abubakar	ʔàbúːbə́kàr
abu	ʔábʊ́
abu	ʔàbʊ̀
acca	ãtʃtʃə́
acca	ʔáttʃàː
adabi	ʔádə̀bíː
adabo	ʔádàːbóː
adadi	ʔádə̀díː
adamu	ʔàːdə̀mʊ́
adam	ʔádàŋ
adawa	ʔàdáːwàː
addaba	ʔàddə́bàː
addini	ʔàddíːnìː
addu'a	ʔàddɪ́ʔàː
adire	ʔàdɪ̀ré
aduwa	ʔádʊ́wàː
adu	ʔádɪ́
afirka	ʔáɸɪ́rkə̀
afrilu	ʔàɸríːlɪ̀
agade	ʔàgə̀dè
agogo	ʔàgʷóːgʷó
agola	ʔágʷòːlə̀
agushi	ʔàgʷʊ́ʃíː
agusta	ʔàgʷʊ́stàː
agwado	ʔàgʷàːdóː
agwagwa	ʔàgʷàːgʷáː
ahmad	ʔáːmàd
aibi	ʔáibɪ̀
aibu	ʔáibʊ̀
aidin	ʔàidɪ̂ŋ
aiki	ʔáicìː
aiki	ʔàicɪ́
ailan	ʔáilàŋ
ainun	ʔáinɪ̀ŋ
a'ishatu	ʔáːʔɪ̀ʃə́tɪ̀
ajali	ʔádʒə̀líː
ajami	ʔàdʒə̀mɪ́
ajuza	ʔàdʒúːzàː
akala	ʔákàːlə̀
akara	ʔàkə̀ɽə̀
akasidan	ʔákə́sɪ̀dâŋ
akawali	ʔákə́wə̀líː
akawal	ʔákə́wàl
akawu	ʔàkàːwʊ́
akure	ʔàkʷʊ́ɽé
akushi	ʔákʷʊ̀ʃíː
akuya	ʔàkʷíjàː
akwasa	ʔákʷə́sáː
akwati	ʔàkʷàːtɪ̀
aƙalla	ʔàkʼállə̀
aƙida	ʔàcʼíːdàː
alabe	ʔàlə́bèː
alabo	ʔàlə̀bóː
al'ada	ʔàlʔáːdàː
alade	ʔàlə́dèː
al'ajabi	ʔàlʔádʒə̀bíː
al'amari	ʔàlʔámə̀ríː
alama	ʔàláːmàː
alaramma	ʔálə̀rámmə̀
alatu	ʔáːláːtɪ̀
al'aura	ʔàlʔáuràː
alawa	ʔàláːwàː
albaras	ʔàlbə́ràs
albarka	ʔàlbárkàː
albarushi	ʔàlbə̀rúːʃìː
albasa	ʔàlbə́sàː
albashi	ʔàlbâːʃíː
albishir	ʔàlbɪ́ʃɪ̀r
alfadari	ʔàlɸə́də́ríː
alfahari	ʔàlɸə́hàríː
alfijir	ʔàlɸɪ́dʒɪ̀r
algaita	ʔàlgéitàː
algashi	ʔálgə̀ʃíː
alhaji	ʔàlhádʒíː
alhaki	ʔàlhácíː
alhali	ʔàlháːlíː
alhamdulillahi	ʔàlhámdɪ̀lɪ̀lláːhɪ̀
alhamis	ʔàlhàmɪ̂s
alhanzir	ʔàlhànzɪ̂r
alheri	ʔàlhéːrìː
alhudahuda	ʔàlhʊ́də̀hʊ́də̀
alif	ʔálɪ̀ɸ
ali	ʔàlɪ́
aljabara	ʔàldʒə́bə́ràː
aljani	ʔàldʒə́níː
aljanna	ʔàldʒánnàː
aljan	ʔàldʒáŋ
alkadari	ʔàlkə́də̀ríː
alkali	ʔàlkáːlíː
alkama	ʔàlkə́màː
alkarya	ʔàlkárjàː
alkawari	ʔàlkə́wə̀ríː
alkyabba	ʔàlcɛ́bbàː
alƙahira	ʔàlkʼáːhɪ̀rə́
alƙalami	ʔàlkʼə́lə̀míː
alƙali	ʔàlkʼáːlíː
alƙur'ani	ʔàlkʷʼʊ̀rʔáːnìː
allah	ʔállàː
alli	ʔàllíː
alli	ʔâllíː
allura	ʔàllúːràː
almajiri	ʔàlmáːdʒɪ̀ríː
almakashi	ʔàlmə́kə̀ʃíː
almasihu	ʔàlmə̀síːhʊ̀
altine	ʔàltɪ̀né
al'umma	ʔàlʔʊ́mmàː
alwala	ʔàlwə̀láː
amalanke	ʔámáːlɛ́ɲcé
amale	ʔámáːlè
amana	ʔàmáːnàː
amarya	ʔámáɽjáː
amawali	ʔámáːwə̀líː
ambaliya	ʔámbàːlɪ́jàː
amfani	ʔàmɸàːníː
amina	ʔámíːnə̀
amini	ʔàmíːnìː
amin	ʔàːmɪ́ŋ
amirka	ʔámɪ̀rkə̀
amma	ʔàmmáː
amo	ʔámóː
amsa	ʔámsàː
amurka	ʔámʊ̀rkə̀
anabi	ʔánə̀bíː
anaca	ʔànə̀tʃə̀
ango	ʔáŋgʷò
anini	ʔàníːníː
ankara	ʔáŋkə̀rə̀
annabi	ʔànnə́bìː
annoba	ʔànnòːbáː
annuri	ʔànnúːrìː
anta	ʔántàː
arabiyya	ʔàrə̀bɪ́jjàː
aradu	ʔàráːdɪ̀
arba'in	ʔàrbə̀ʔɪ́ŋ
arewa	ʔáɽèːwə́
arziki	ʔárzɪ̀cíː
ar	ʔár
asabari	ʔásə́bə̀ríː
asabar	ʔàsə́bàr
asabe	ʔàsə̀bé
asali	ʔásə́líː
asara	ʔàsáːràː
asawaki	ʔàsə́wàːcíː
asham	ʔáʃáŋ
ashana	ʔàʃáːnáː
ashirin	ʔàʃɪ̀rɪ́ŋ
asibiti	ʔásɪ̀bɪ́tɪ̀
asiri	ʔàsíːríː
asiya	ʔáːsɪ́jɛ̀
aske	ʔáscèː
asubahi	ʔàsɪ̀báːhɪ̀
asuba	ʔàsɪ̀bâː
attajiri	ʔàttáːdʒɪ̀ríː
attaura	ʔàttáuráː
auduga	ʔáudɪ̀gáː
audu	ʔáudɪ̀
aure	ʔáuɽéː
awaza	ʔàwə́zàː
awa	ʔáwàː
ayaba	ʔɛ̀jɛ̀bə̀
ayari	ʔáːjɛ̀ríː
aya	ʔáːjàː
ayu	ʔɛ̀júː
azaba	ʔàzáːbàː
azahariyya	ʔàzə̀hàrɪ́jjàː
azahar	ʔàzə́hàr
azumi	ʔázɪ̀míː
azumi	ʔázɪ̀mɪ́
azurfa	ʔázɪ̀rɸáː
azzakari	ʔàzzə́kə̀ríː
ba'askare	bə̀ʔáskə́rèː
baba	báːbáː
baba	bàːbáː
baba	báːbə̀
baba	bàːbə́
babba	bàbbə́
babur	bàːbʊ́r
bado	bə́dòː
badun	bàːdɪ̀ŋ
baffa	báɸɸə̀
bafilatani	bə̀ɸɪ́láːtə̀níː
bafillace	bə̀ɸɪ́lláːtʃèː
bagadaza	bə̀gə̀dáːzə̀
bagwari	bə̀gʷáːɽíː
bahar	bə́hàr
bahasi	bə́hàsíː
bahaushe	bə̀háuʃèː
bahili	bə̀híːlìː
baho	báːhòː
baibai	bèibêi
baiti	béitìː
baitulmali	bèitɪ̀lmáːlɪ̀
baiwa	bêiwáː
baiwa	bêiwə́
bajau	bə́dʒáu
bajo	báːdʒòː
baka	bə̀káː
baka	bə́kə̀
baki	bàːcíː
bakwai	bə́kʷèi
baƙi	bə́cʼíː
baƙo	bàːkʷʼó
bala'i	bə̀láːʔìː
balaraba	bə̀láːrə́bə̀
balarabe	bə̀láːrə́bè
balarabe	bə̀láːrə́bèː
balas	bə́làs
bal	bâl
bana	bə́nə́
banda	bàndáː
banga	bàŋgáː
bangaskiya	báŋgáscɪ́jáː
bango	báŋgʷóː
bappa	báppə̀
bara	bàːráː
bara	bàːɽə́
bara	bə́ràː
bara	bə́ɽàː
bararo	bə̀rə̀róː
barau	bə̀ɽáu
barbarci	báɽbáɽtʃíː
barewa	bə̀ɽéːwáː
bargo	bàrgʷóː
barka	bárkàː
barkono	bàrkʷòːnóː
barno	bàrnó
basakkwace	bə̀sákʷkʷə́tʃèː
basasa	báːsáːsàː
bas	bâs
basukur	báːsɪ́kʷʊ̀r
batir	báːtɪ̀r
batta	báttàː
bature	bə̀túːrèː
bauta	bàutáː
bawa	báːwàː
bawa	báːwə̀
baya	báːjáː
baya	báːjɛ́
bayan	báːjɛ́ŋ
bedi	béːdìː
bel	bál
bello	bállò
bici	bɪ́tʃɪ̀
bidi'a	bɪ́dɪ́ʔàː
bif	bɪ̂p
bika	bɪ̀káː
bil	bɪ̂l
bincike	bɪ̀ntʃɪ̀céː
bindi	bɪ́ndìː
bindiga	bɪ́ndɪ́gàː
bini	bìːnɪ́
binta	bɪ́ntə̀
binuwai	bɪ́nʊ́wèi
birgediya	bɪ̀rɟéːdɪ́jàː
birjik	bɪ̀rdʒɪ́k
birni	bɪ́rníː
birtaniya	bɪ̀rtáːnɪ́jɛ̀
bisa	bɪ́sáː
bishar̃a	bɪ̀ʃáːràː
bishiya	bɪ́ʃɪ́jàː
bisimilla	bɪ̀sɪ́mɪ́llàː
bisimillahi	bɪ̀sɪ́mɪ̀lláːhìː
biya	bɪ́jáː
biya	bɪ́jɛ̀
biyar	bɪ̀jɛ́r
biyayya	bɪ̀jɛ́jjàː
biyu	bɪ́jʊ́
biza	bíːzàː
boca	bóːtʃàː
boɗoɗo	bòːɗòːɗòː
boka	bóːkáː
boko	bóːkʷòː
bonono	bòːnòːnòː
bora	bóːɽàː
bori	bòːɽíː
borintinke	bòːɽɪ́ntɪ́ɲcèː
bosniya	bɔ́snɪ́jɛ̀
boyi	bòːjɪ́
budurwa	bʊ̀dɪ́ɽwáː
buɗuɗu	bʊ́ɗɪ́ɗɪ́
buguzunzum	bʊ̀gʷʊ̀zɪ̀nzɪ̀m
bukka	bʊ́kkàː
buƙata	bʊ̀kʼáːtàː
buƙwi	bʊ̀kʷʼíː
bura	búːɽáː
burɗunɗun	bʊ̀rɗɪ̀nɗɪ̀ŋ
buroka	bʊ̀róːkàː
buta	búːtàː
Ɓaɓura	ɓáːɓʊ̀ɽə̀
ɓakutu	ɓáːkʷʊ́tɪ́
ɓangwalgwal	ɓàŋgʷàlgʷàl
ɓarawo	ɓə̀ɽáːwòː
ɓauna	ɓáunáː
ɓaure	ɓáuɽéː
ɓelele	ɓèːlèːlèː
ɓulla	ɓʊ̀llə́
ɓurma	ɓʊ́ɽmə́
caɓaɓa	tʃə́ɓə́ɓə́
cadi	tʃáːdɪ̀
caka	tʃə̀káː
caka	tʃə́kə́
calawa	tʃáːláːwáː
cali	tʃáːlíː
cali	tʃàːlɪ́
canko	tʃàŋkʷóː
casa'in	tʃə̀sə̀ʔɪ́ŋ
cata	tʃáːtàː
ca	tʃáː
ca	tʃâː
cibi	tʃíːbìː
cibi	tʃɪ́bíː
cibiya	tʃíːbɪ̀jáː
cif	tʃɪ́p
cif	tʃɪ̂ɸ
cigaba	tʃîːgə̀bə́
ciki	tʃɪ́cìː
ciki	tʃɪ́cɪ́
cindo	tʃɪ́ndòː
ciroma	tʃɪ́ròːmə̀
cir	tʃɪ̂r
ci	tʃɪ́
citta	tʃɪ́ttə̀
citta	tʃɪ̀ttə́
ciwo	tʃíːwòː
coci	tʃóːtʃɪ̀
coi	tʃóɪ́
cokali	tʃóːkə̀líː
cuku	tʃɪ́kʷúː
cukwi	tʃɪ́kʷíː
cuna	tʃúːnàː
cura	tʃúːɽàː
curi	tʃúːɽìː
cwai	tʃʷéi
da'awa	də̀ʔàwáː
dabba	dábbàː
dabino	də́bíːnòː
dabo	də́bòː
daddawa	dàddə́wáː
daftari	dáɸtə̀ríː
daga	dáːgáː
daga	də́gáː
dage	də́ɟéː
dahir	dáːhɪ̀r
daimon	déimɔ̀ŋ
daina	déinàː
da'ira	dáːʔɪ̀ráː
daƙashi	də́kʼə̀ʃíː
daƙiƙa	də̀cʼíːkʼàː
daƙiƙi	də̀cʼíːcʼìː
dala	dàːlə́
dala	də́làː
dalili	də̀líːlìː
dama	dáːmáː
damagaram	də̀mə́gə̀ráŋ
dambe	dámbé
dambu	dámbúː
damisa	dàːmɪ́sàː
damuwa	dàːmʊ́wáː
danana	də́nə́nə́
danda	dàndə́
dandali	dándə̀líː
danga	dáŋgáː
dankali	dàŋkə́lìː
daraja	də́rə́dʒàː
darasi	də́rə̀síː
darduma	dàrdúːmàː
dari	də́ɽìː
darma	dármàː
darni	dàrníː
datti	dàttɪ́
dattijo	dáttíːdʒò
dauda	dáudàː
dau	dàu
daula	dáulàː
daura	dàuɽáː
dawa	dáːwàː
dawa	də́wə̀
diflomasiyya	dɪ̀ɸlòːmə̀sɪ́jjàː
diga	dɪ́gàː
dimilmilo	dɪ́mɪ́lmɪ́lòː
dimokuraɗiyya	dɪ̀mòkʷʊ̀ɽə̀ɗɪ́jjàː
dina	dɪ́nàː
dinari	díːnáːrìː
dinya	dɪ́ɲjáː
di'o	díːʔòː
disamba	dɪ̀sámbàː
diwani	díːwáːnìː
diyya	dɪ́jjàː
dogara	dòːgə́ɽàː
dogara	dòːgə́ɽə̀
dogarai	dòːgə̀ɽéi
dogari	dòːgə́ɽìː
dogo	dóːgʷó
dogo	dóːgʷóː
doki	dóːcìː
dokta	dɔ́ktàː
domin	dòːmɪ́ŋ
dorina	dòːɽɪ́náː
dososo	dòːsòːsòː
du'a'i	dɪ́ʔáːʔìː
dubu	dɪ́búː
dukiya	dúːcɪ̀jáː
dukuku	dɪ̀kʷʊ̀kʷʊ̀
duma	dɪ́máː
duma	dɪ́màː
dumɓu	dɪ́mɓúː
duna	dúːnàː
duniya	dúːnɪ́jàː
duri	dúːɽìː
duros	dɪ̀râs
dutse	dúːsʼè
dutse	dúːsʼèː
ɗa'a	ɗáːʔàː
ɗabi'a	ɗə̀bíːʔàː
ɗa	ɗáː
ɗalibi	ɗáːlɪ̀bíː
ɗan	ɗáŋ
Ɗanjuma	ɗándʒúːmə̀
Ɗanladi	ɗálláːdɪ̀
Ɗanlami	ɗállàːmîː
Ɗantala	ɗántə̀láː
ɗanye	ɗɛ́ɲjéː
ɗari	ɗáːɽíː
ɗari	ɗə̀ɽíː
ɗawafi	ɗə̀wáːɸìː
ɗawisu	ɗáːwíːsɪ̀
ɗaya	ɗɛ́jɛ́
ɗefi	ɗèːɸíː
ɗigo	ɗɪ́gʷòː
ɗim	ɗɪ̀m
ɗim	ɗɪ̂m
ɗu	ɗùː
ɗungum	ɗɪ̀ŋgʷʊ́m
edita	ʔɛ́dɪ́tə̀
eka	ʔéːkàː
el'e	ʔɛ́lʔêː
emti	ʔɛ́mtìː
en'e	ʔɛ́ŋʔèː
fabrairu	ɸàbréirɪ̀
faɗa	ɸáːɗàː
faɗa	ɸə́ɗàː
faɗa	ɸə̀ɗáː
faɗimatu	ɸáːɗɪ̀mə́tɪ̀
fahami	ɸə́hàmíː
fahari	ɸə́hàríː
fa'ida	ɸáːʔɪ́dàː
faƙiri	ɸə̀cʼíːrìː
falsafa	ɸálsə́ɸàː
fam	ɸâŋ
fangali	ɸáŋgə́líː
fanke	ɸɛ̀ɲcéː
fanni	ɸánnìː
fara'a	ɸə́rə́ʔàː
farali	ɸə́rə̀líː
faransanci	ɸə́ránsántʃíː
faransa	ɸə̀ránsə̀
fara	ɸàːɽáː
farce	ɸáɽtʃèː
farilla	ɸə̀rɪ́llàː
fari	ɸáːɽɪ̀
fari	ɸə́ɽíː
farisa	ɸáːrɪ́sə̀
farko	ɸáɽkʷóː
fartanya	ɸártɛ́ɲjàː
faruku	ɸàːrɪ́kʷʊ̀
faruƙu	ɸàːrɪ́kʷʼʊ̀
fasali	ɸə́sə̀líː
fasa'ofis	ɸə́sə̀ʔóːɸɪ̀s
fasfo	ɸàsɸó
fashe	ɸə́ʃé
fasiƙi	ɸáːsɪ̀cʼíː
fasinja	ɸáːsɪ́ndʒə̀
fassara	ɸássə́ràː
fatakwal	ɸə́táːkʷàl
fatanya	ɸə́tɛ́ɲjàː
fatau	ɸə́táu
fat	ɸát
fatsa	ɸə́sʼə́
fatsi	ɸə́sʼíː
fau	ɸáu
feda	ɸéːdàː
fensir	ɸɛ́nsɪ̀r
fes	ɸɛ́s
fetal	ɸèːtál
fetur̃	ɸéːtɪ̀r
fida'u	ɸɪ̀dáːʔùː
fi'ili	ɸɪ́ʔɪ̀líː
fijo	ɸɪ̀dʒôː
fiƙihu	ɸɪ́cʼɪ́hʊ̀
filafili	ɸɪ́lə̀ɸɪ́líː
filas	ɸɪ̀lâs
filato	ɸɪ̀làːtó
fili	ɸíːlíː
firamare	ɸɪ́ráːmə̀rèː
fis	ɸɪ̂s
fita	ɸɪ̀táː
fitila	ɸɪ̀tɪ́làː
fitina	ɸɪ̀tɪ́nàː
fitsari	ɸɪ́sʼáːɽíː
fom	ɸâŋ
fuɗu	ɸʊ́ɗɪ́
fula	ɸùːláː
funkaso	ɸʊ̀ŋkàːsóː
funtuwa	ɸʊ̀ntʊ́wə̀
fura	ɸʊ́ɽáː
fure	ɸʊ̀ɽéː
fururu	ɸʊ́ɽɪ́ɽɪ́
fusata	ɸʊ́sàːtáː
fusata	ɸʊ̀sáːtə̀
gabar	gə́bàr
gabas	gə́bàs
gada	gə́dàː
gada	gə̀dáː
gadara	gə̀dáːràː
gado	gə́dóː
gadu	gə̀dúː
gafara	gáːɸə́ràː
gagai	gə́gèi
gagarau	gàːgə̀ɽáu
gaggafa	gággáːɸáː
gahawa	gə́háwàː
gaibi	géibɪ̀
gaira	géirə̀
gaiwa	gêiwáː
gajere	gə̀dʒéːɽé
gajere	gə̀dʒéːɽéː
galadima	gə̀làːdíːmàː
galala	gàːlàːlàː
galau	gə̀láu
galibi	gáːlɪ̀bíː
gam	gâŋ
gamsheƙa	gàmʃèːkʼáː
gana	gáːnə̀
ganau	gə̀náu
gandu	gándúː
ganima	gə̀níːmàː
ganji	gándʒìː
ganuwa	gáːnʊ́wáː
ganye	gɛ́ɲjéː
garafuni	gə̀ɽàːɸʊ́níː
gara	gə́ràː
gari	gàːɽíː
gari	gə̀ɽíː
garki	gàɽcɪ́
garkuwa	gàɽkʷʊ́wáː
garu	gàːrúː
garwashi	gáɽwáːʃíː
gasa	gàːsáː
gaskata	gáskə̀táː
gaskata	gàskə́tə̀
gaskiya	gáscɪ́jáː
gatari	gàːtə́ɽíː
gaula	gáuláː
gawa	gáːwáː
gawasa	gə́wə́sàː
gazet	gə̀zát
gefin	ɟèːɸɪ̀ŋ
gemu	ɟéːmùː
giginya	ɟɪ́ɟɪ́ɲjàː
giginyu	ɟɪ̀ɟɪ̀ɲjʊ́
gimbiya	ɟɪ́mbɪ̀jáː
giris	ɟɪ̀rɪ̂s
girka	ɟɪ́ɽkáː
girka	ɟɪ́ɽkàː
girma	ɟɪ́ɽmáː
gitta	ɟɪ́ttàː
giwa	ɟíːwáː
giya	ɟɪ́jàː
goba	gʷóːbàː
gobir	gʷòːbɪ́r
goge	gʷòːɟéː
goma	gʷóːmə̀
gomiya	gʷòːmɪ́jáː
gona	gʷóːnáː
goro	gʷóːrò
goyo	gʷóːjóː
guba	gʷʊ́bàː
guduma	gʷʊ̀dɪ́màː
guɗa	gʷúːɗàː
gula	gʷʊ́làː
gulbi	gʷʊ́lbíː
guma	gʷʊ́màː
gumal	gʷʊ́màl
gum	gʷʊ̀m
guna	gʷʊ́nàː
gunda	gʷʊ́ndàː
gunki	gʷʊ́ɲcìː
gunus	gʷʊ̀nɪ̀s
gunya	gʷʊ́ɲjáː
gurasa	gʷʊ̀ráːsàː
gurnet	gʷʊ̀rnát
guru	gʷúːrúː
gusa	gʷʊ́sàː
gusau	gʷʊ̀sáu
gusum	gʷʊ́sɪ̀ŋ
gwaggo	gʷágʷgʷò
gwaiba	gʷéibàː
gwal	gʷâl
gwalkwas	gʷálkʷàs
gwamna	gʷámnàː
gwamnati	gʷámnə́tɪ̀
gwanda	gʷándàː
gwandu	gʷándɪ́
gwangwani	gʷáŋgʷə́níː
gwanjo	gʷàndʒóː
gwanki	gʷɛ́ɲcíː
gwaza	gʷáːzáː
gwiwa	gʷíːwàː
habasha	hábə́ʃə̀
haɓa	háɓàː
haɓɓoje	háɓɓóːdʒè
haɓe	háːɓè
hadda	háddàː
haddi	háddìː
hadisi	hàdíːsìː
hadizatu	hàdíːzə́tɪ̀
haɗama	hàɗə́màː
haɗari	háɗə̀ríː
haɗeja	háɗéːdʒə̀
haɗi	háɗìː
hafizu	háːɸɪ́zɪ̀
hafsatu	hàɸsə́tɪ̀
haihu	háihʊ̀
haihuwa	háihʊ̀wáː
haila	háilàː
hairan	háiràŋ
haja	háːdʒàː
haji	hádʒɪ̀
hajji	háddʒɪ̀
hajji	ʔàlhádʒɪ́
hakimi	háːcɪ̀míː
hakiya	hácɪ́jàː
hakkan	hákkàŋ
hakki	háccìː
haƙori	hákʷʼóːɽíː
haƙurau	hàkʷʼʊ̀ɽáu
halaka	hálə̀káː
halaka	hàlə́kə̀
halal	hàlâl
halama	hàláːmàː
hali	háːlíː
halilu	hàlíːlɪ̀
halima	hàlíːmə̀
halwa	hálwàː
hamada	hàmáːdàː
hama	hámàː
hamayya	hàmɛ́jjàː
hamdala	hámdə́làː
hamidu	hámíːdɪ̀
hamila	hàmíːlàː
hamsin	hàmsɪ́ŋ
hanci	hántʃìː
hanci	hántʃɪ́
hangum	hàŋgʷʊ́ŋ
hanhai	hàŋhái
hani'an	háːnɪ́ʔàŋ
hani	hánìː
hankali	háŋkə̀lɪ̀
hannu	hánnúː
hanta	hántàː
hanya	hɛ́ɲjàː
harafi	hárə̀ɸíː
haraji	hàráːdʒìː
haram	hàrâŋ
har	hár
harsashi	hàrsáːʃìː
harshe	háɽʃè
haruna	hárúːnə̀
hasafi	hásə̀ɸíː
hasa	hásàː
hasana	hásə̀náː
hasan	hásàŋ
hasara	hàsáːràː
hassada	hássə́dàː
hatimi	háːtɪ̀míː
hatta	hàttáː
hau	hâu
hausa	háusə́
hauwa	hàuwə́
hawa'i	hàwáːʔíː
hawainiya	hàwéinɪ̀jáː
hazbiya	házbɪ́jáː
haziƙi	háːzɪ̀cʼíː
hazo	házóː
hidima	hɪ́dɪ́máː
hijabi	hɪ̀dʒáːbìː
hijira	hɪ́dʒɪ́ráː
hikaya	hɪ̀káːjàː
hikima	hɪ́cɪ́màː
hisabi	hɪ̀sáːbìː
hoda	hóːdàː
hole	hóːlèː
holo	hóːlòː
homan	hóːmàŋ
hoto	hòːtóː
hubbare	hʊ́bbáːrè
huɗuba	hʊ́ɗɪ́bàː
huɗu	hʊ́ɗɪ́
huhu	húːhùː
huhu	hùːhúː
hukuma	hʊ̀kʷúːmàː
hukunci	hʊ́kʷʊ́ntʃɪ́
hula	hùːláː
humushi	hʊ́mùːʃíː
humusi	hʊ́mùːsíː
huntu	hʊ́ntúː
hura	húːɽàː
hurriyya	hʊ̀rrɪ́jjàː
husaina	hʊ́sèináː
husaini	hʊ̀séinɪ̀
husufi	hʊ̀súːɸìː
hutsu	húːsʼúː
hutu	húːtúː
ibada	ʔɪ̀báːdàː
ibilis	ʔɪ̀bɪ̀lɪ̂s
iblis	ʔɪ̀blɪ̂s
ibrahim	ʔɪ̀bráːhɪ̀ŋ
ice	ʔɪ́tʃèː
idan	ʔɪ̀dáŋ
idda	ʔɪ́ddàː
idi	ʔíːdìː
ido	ʔɪ́dòː
igiya	ʔɪ́ɟɪ́jàː
igwa	ʔɪ̀gʷáː
ijara	ʔɪ̀dʒáːràː
ikko	ʔɪ̀kʷkʷó
iko	ʔíːkʷòː
iƙir̃ar̃i	ʔɪ̀cʼɪ̀ráːrìː
ilimi	ʔɪ́lɪ̀míː
illa	ʔɪ́lláː
illa	ʔɪ́llàː
ilmi	ʔɪ́lmìː
ilmi	ʔɪ̂lmíː
imani	ʔíːmáːnìː
inabi	ʔɪ́nə̀bíː
indiya	ʔɪ́ndɪ́jɛ̀
inganta	ʔɪ́ŋgàntáː
inganta	ʔɪ̀ŋgántə̀
ingarma	ʔɪ̀ŋgármàː
ingila	ʔíːɲɟɪ̀lə̀
ingilishi	ʔɪ́ɲɟɪ̀líːʃìː
inna	ʔɪ́nnə̀
iraƙi	ʔɪ̀râːcʼɪ̀
iraƙ	ʔɪ̀râkʼ
isa	ʔíːsáː
ishara	ʔɪ̀ʃáːràː
isha	ʔìːʃáː
ishe	ʔɪ́ʃèː
isiyaku	ʔɪ́sɪ́jáːkʷʊ̀
iska	ʔɪ́skàː
isƙandariya	ʔɪ̀skʼándə̀rɪ́jɛ̀
isma'ilu	ʔɪ̀smáːʔíːlɪ̀
isra'ila	ʔɪ̀sráːʔíːlə̀
istihara	ʔɪ́stɪ̀háːràː
italiya	ʔɪ̀táːlɪ́jɛ̀
ita	ʔɪ́tə́
iyali	ʔɪ̀jáːlìː
izifi	ʔɪ́zɪ̀ɸíː
izini	ʔɪ́zɪ̀níː
izni	ʔɪ́znìː
jace	dʒàːtʃéː
jadawali	dʒə́də́wə̀líː
ja	dʒáː
jafa'i	dʒə̀ɸáːʔìː
jahadi	dʒə̀háːdìː
jahili	dʒáːhɪ̀líː
jahun	dʒáːhʊ̀ŋ
jaka	dʒə̀káː
jaki	dʒàːcíː
jama'a	dʒə̀mə́ʔà
jamhuriya	dʒàmhúːrɪ́jàː
jami'a	dʒáːmɪ́ʔàː
jami'a	dʒáːmɪ̀ʔáː
jam'i	dʒámʔìː
jami'i	dʒáːmɪ̀ʔíː
jam'iyya	dʒàmʔɪ́jjàː
jamusanci	dʒáːmʊ́sántʃíː
jamus	dʒáːmʊ̀s
janaba	dʒə̀nə́bàː
janairu	dʒə̀néirɪ̀
jana'iza	dʒə̀náːʔɪ́zàː
janar	dʒə́nàr
japan	dʒə̀pâŋ
jarida	dʒə̀ríːdàː
jarrabawa	dʒárrə̀bâːwáː
jatau	dʒàːtáu
jawabi	dʒə̀wáːbìː
jawo	dʒáːwóː
jawur	dʒàːwʊ́r
jaza'i	dʒə̀záːʔìː
jazur	dʒàːzɪ́r
jega	dʒèːgə́
jeri	dʒéːɽìː
jibirilu	dʒɪ̀bɪ̀ríːlɪ̀
jibiya	dʒɪ́bɪ́jɛ̀
jidali	dʒɪ̀dáːlìː
ji	dʒɪ́
jif	dʒɪ̂ɸ
jihadi	dʒɪ̀háːdìː
jiha	dʒɪ́hàː
jika	dʒɪ́kə̀
jiki	dʒɪ̀cíː
jima'i	dʒɪ̀máːʔìː
jimɓirɓir	dʒɪ̀mɓɪ̀rɓɪ̀r
jim	dʒɪ́ŋ
jimilla	dʒɪ̀mɪ́llàː
jimina	dʒɪ̀mɪ́náː
jimla	dʒɪ́mlàː
jini	dʒɪ́níː
jinjimi	dʒɪ́ndʒɪ́míː
jinsi	dʒɪ́nsìː
jirgi	dʒɪ́ɽɟíː
jos	dʒàs
jugum	dʒɪ̀gʷʊ́m
jumma'a	dʒɪ́mmə́ʔàː
jummai	dʒɪ́mméi
juwa	dʒʊ̀wáː
juzu'i	dʒɪ́zɪ̀ʔíː
kabari	kə́bə̀ríː
kabewa	kə̀béːwàː
kabila	kə̀bíːlàː
kaca	kə́tʃàː
kaciya	kàːtʃɪ́jàː
kada	kə́dáː
kadari	kə́də̀ríː
kaduna	kə́dúːnə́
kaɗanya	kə́ɗɛ́ɲjàː
kaɗo	káːɗò
kafaɗa	kàːɸə́ɗàː
kafa	kə́ɸáː
kafa	kə́ɸàː
kafe	kə́ɸèː
kafin	kàːɸɪ̀ŋ
kafiri	káːɸɪ̀ríː
kaf	káp
kafur	káːɸʊ̀r
kahuhu	kə́hʊ́hʊ́
kaidi	kéidìː
kaigama	kéigə́mə̀
kai	kâi
kai	kéi
kairo	kéirɔ̀
kaita	kéitə́
kaiwa	kéiwáː
ka	káː
kaka	kàːkáː
kaka	kàːkə́
kakaki	kàːkàːcíː
kalami	kə̀láːmìː
kallo	kállóː
kalma	kálmàː
kaltibeta	káltɪ̀béːtàː
kamala	kə̀máːlàː
kamaru	kə̀mə̀rɪ́
kambi	kámbíː
kamfas	kámɸàs
kamili	káːmɪ̀líː
kamin	kàːmɪ̀n,kàːmɪ́ŋ
kam	kám
kanar	kə́nàr
kandu	kándúː
kango	káŋgʷóː
kankana	káŋkə́náː
kanki	kɛ́ɲcìː
kanne	kánnèː
kano	kə́nó
kanta	kántáː
kanta	kántàː
kanti	kàntíː
kanumfari	kə̀nɪ́mɸə̀ríː
karahiya	kə̀ráːhɪ́jàː
karama	kə̀ráːmàː
karanta	kə́ràntáː
kare	kə̀ɽéː
karimi	kə̀ríːmìː
karkanda	kárkàndə̀
karuwa	káːrʊ̀wə̀
kasat	káːsàt
kasko	káskʷóː
kasu	kə̀sɪ́
kasuwa	kàːsʊ́wáː
kasuwanci	káːsʊ́wántʃìː
katagum	kə́táːgʷʊ̀ŋ
katibi	káːtɪ̀bíː
katifa	kə̀tíːɸàː
kati	káːtìː
katsina	kə̀sʼɪ́nə̀
kauci	káutʃìː
kawu	káːwʊ̀
kawu	kàːwʊ́
kazaf	kə́zàɸ
kaza	kàːzáː
kazaure	kə̀záuɽé
keso	céːsòː
kibiya	cɪ́bɪ́jàː
kibiya	cɪ́bɪ́jɛ̀
kifa	cɪ́ɸàː
kife	cɪ́ɸèː
kifi	cíːɸíː
kili	cɪ̀lîː
kilishi	cɪ́lɪ̀ʃíː
kimsa	cɪ́msàː
kindirmo	cɪ̀ndɪ̀rmóː
kirsimati	cɪ́rsɪ̀mə́tɪ̀
kirtif	cɪ̀ɽtɪ́p
kishiya	cíːʃɪ̀jáː
kissa	cɪ́ssə̀
kiyama	cɪ̀jáːmàː
kofi	kʷóːɸìː
kofi	kʷòːɸíː
kofur	kʷóːɸʊ̀r
kogi	kʷòːɟíː
koka	kʷóːkàː
koko	kʷóːkʷó
koko	kʷòːkʷóː
kolo	kʷóːlóː
koma	kʷóːmáː
komi	kʷóːmíː
komo	kʷóːmóː
kore	kʷóːrèː
kori	kʷóːrìː
kos	kʷâs
kotu	kʷóːtɪ̀
kowa	kʷóːwáː
kowanne	kʷóːwànnéː
kubbi	kʷʊ́bbɪ̀
kuɓewa	kʷʊ́ɓèːwáː
kucaki	kʷʊ̀tʃáːcíː
kudaku	kʷúːdə́kʷʊ́,kʷúːdə̀kʷúː
kudu	kʷʊ́dɪ̀
kuɗi	kʷʊ́ɗíː
kufai	kʷʊ́ɸéi
kuge	kʷʊ̀ɟéː
kujera	kʷʊ́dʒèːɽáː
kukuma	kʷúːkʷúːmàː
kullum	kʷʊ́llɪ́ŋ
kumallo	kʷʊ̀mállóː
kumama	kʷʊ̀máːmáː
kunama	kʷʊ̀náːmàː
kuni	kʷʊ̀nîː
kunkuru	kʷʊ̀ŋkʷʊ́ɽúː
kunne	kʷʊ́nné
kunne	kʷʊ̂nnéː
kunya	kʷʊ́ɲjáː
kunya	kʷʊ́ɲjàː
kura	kʷúːɽə́
kurkuku	kʷʊ̂rkʷʊ́kʷùː
kurma	kʷʊ́ɽmáː
kurmi	kʷʊ́ɽmìː
kurwa	kʷʊ̀ɽwáː
kusa	kʷʊ́sə́
kuskus	kʷʊ́skʷʊ̀s
kwabo	kʷə́bòː
kwaɗo	kʷàːɗóː
kwaɗo	kʷə́ɗò
kwala	kʷə́làː
kwalekwale	kʷə̀lékʷə̀lé
kwal	kʷâl
kwamanda	kʷə̀mándàː
kwamfyuta	kʷàmɸʲúːtàː
kwana	kʷáːnáː
kwana	kʷáːnə́
kwana	kʷə́nàː
kwango	kʷáŋgʷò
kwano	kʷáːnòː
kwara	kʷáːɽə̀
kwaram	kʷə́ɽàm
kwatsam	kʷə́sʼàm
kwiyat	kʷɪ̀jɛ̂t
kyaftin	cɛ́ɸtɪ̀ŋ
kyanada	cɛ́nə́də̀
kyanwa	cɛ̂mwáː
kyat	cɛ̂t
kyau	cɛ̂u
kyauro	cɛ́uɽóː
ƙabila	kʼə̀bíːlàː
ƙadangare	kʼə̀dáŋgə́ɽèː
ƙaddara	kʼáddə̀ráː
ƙaddara	kʼàddə́ràː
ƙafa	kʼə́ɸàː
ƙaho	kʼə̀hóː
ƙa'ida	kʼáːʔɪ́dàː
ƙa'imi	kʼáːʔɪ̀míː
ƙala	kʼáːlàː
ƙal	kʼál
ƙamus	kʼáːmʊ̀s
ƙanana	kʼə́náːnàː
ƙandas	kʼándás
ƙanƙane	kʼàŋkʼə́nèː
ƙarami	kʼə̀ɽə́míː
ƙarƙaf	kʼàɽkʼáp
ƙarni	kʼárnìː
ƙasa	kʼə́sáː
ƙasa	kʼə́sə̀
ƙashi	kʼə̀ʃíː
ƙasida	kʼə̀síːdàː
ƙas	kʼás
ƙato	kʼáːtòː
ƙaura	kʼáuɽáː
ƙauye	kʼáujèː
ƙazaf	kʼə́zàɸ
ƙazami	kʼə̀záːmíː
ƙazanta	kʼə̀zântáː
ƙerere	cʼèːɽèːɽèː
ƙififiya	cʼɪ́ɸɪ́ɸɪ́jɛ́
ƙiƙam	cʼìːkʼàm
ƙirin	cʼɪ́ɽɪ́ŋ
ƙirji	cʼɪ̀ɽdʒíː
ƙissa	cʼɪ́ssàː
ƙiyasi	cʼɪ̀jáːsìː
ƙoda	kʷʼóːdàː
ƙoƙari	kʷʼòːkʼə́ɽɪ́
ƙoƙiƙoƙi	kʷʼóːcɪ̀kʷʼóːcʼɪ̀
ƙorama	kʷʼòːɽə́màː
ƙosai	kʷʼóːséi
Ƙosau	kʷʼòːsáu
ƙube	kʷʼúːbè
Ƙudus	kʷʼʊ́dɪ̀s
ƙugiya	kʷʼúːɟɪ̀jáː
ƙuƙut	kʷʼʊ́kʷʼʊ́t
ƙulumi	kʷʼúːlɪ́míː
ƙumba	kʷʼʊ̀mbáː
ƙundu	kʷʼʊ̀ndúː
ƙuri'a	kʷʼʊ̀rɪ́ʔàː
ƙursunsun	kʷʼʊ̀ɽsɪ̀nsɪ̀ŋ
ƙurungu	kʷʼʊ̀ɽɪ́ŋgʷʊ̀
ƙut	kʷʼʊ́t
ƙwai	kʷʼéi
ƙwaro	kʷʼàːɽóː
la'ada	lə̀ʔádàː
la'alla	lə̀ʔállàː
la'asariyya	lə̀ʔàsə́rɪ́jjàː
la'asar	lə̀ʔásàr
laba	láːbàː
labari	làːbáːrìː
labudda	làːbʊ́ddə̀
lacca	láttʃàː
ladabi	lə́də̀bìː
lada	láːdáː
ladani	làːdáːnìː
ladan	làːdâŋ
ladi	láːdɪ̀
lafazi	lə́ɸə̀zíː
lafi	láːɸìː
lafiya	láːɸɪ́jàː
lahadi	lə́hàdɪ̀
lahira	láːhɪ́ràː
laifi	lêiɸíː
la'ifi	lə̀ʔíːɸìː
laima	léimàː
laita	léitàː
laka	láːkáː
laka	lə́káː
lakwaja	lə́kʷə́dʒə̀
lale	láːlèː
lalle	lálléː
lalle	lállèː
lalo	láːlòː
lamba	lámbàː
lambu	làmbúː
lami	làːmîː
lamiri	lə̀míːrìː
lam	láŋ
landan	lándàŋ
laraba	làːrə̀báː
lardi	lárdìː
larura	lə̀rúːràː
lasin	láːsɪ̀ŋ
lasisi	láːsíːsìː
laskofur	lâskʷóːɸʊ̀r
latsa	láːsʼàː
launi	láunìː
lauya	láujàː
lawur	láːwʊ́ɽ
laya	láːjàː
lazza	lázzàː
legas	léːgàs
lemo	lèːmóː
lif	lɪ̂ɸ
likita	lɪ́cɪ́tə̀
limam	lìːmâŋ
liman	lìːmâŋ
linjila	lɪ̀ndʒíːláː
linzami	lɪ̀nzáːmìː
lisha	lìːʃáː
lissafi	lɪ̀ssáːɸìː
litinin	lìːtɪ̀nɪ̂ŋ
littafi	lɪ́ttáːɸìː
loga	lóːgàː
lokaci	lóːkə̀tʃíː
lori	lóːrìː
lubayya	lɪ̀bɛ́jjɛ̀
lugga	lɪ́ggàː
luƙwi	lɪ́kʷʼíː
lula	lúːlàː
lu	lûː
lumana	lɪ̀máːnàː
luwaɗi	lʊ̀wáːɗìː
ma'aikata	mə́ʔáikə́táː
ma'amala	mə̀ʔáːmə́làː
ma'ana	mə̀ʔànáː
mabiyi	mə́bɪ̀jíː
mace	mə̀tʃèː
maciji	mə́tʃìːdʒíː
madina	mə̀díːnə̀
madubi	mə́dúːbíː
maɗaba'a	mə́ɗáːbə́ʔáː
maɗaci	mə́ɗàːtʃíː
mafaka	mə́ɸə́káː
mafari	mə́ɸə́ɽíː
magaji	mə́gàːdʒíː
magaji	mə́gàːdʒɪ́
magajiya	mə́gáːdʒɪ̀jáː
magana	mə̀gə́nàː
magani	màːzóː
magariba	mə̀gə̀rɪ́bàː
magini	mə́ɟìːníː
mago	mə́gʷó
mahalli	mə̀hâllíː
mahawara	mə̀háːwə́ràː
mahmudu	màːmúːdɪ̀
maiduguri	mèidɪ́gʷʊ̀rɪ́
maiɗaki	mèiɗáːcɪ̀
maigado	mèigə́dó
maigari	mèigə̀ɽɪ́
maikuɗi	mèikʷʊ́ɗɪ́
mai	mâi
maina	méinə̀
mairiga	mèiɽìːgə̀
maiso	méisóː
maitama	mèitə́mə́
maita	mêitáː
maiwada	mèiwə̀dáː
majalisa	mə̀dʒə̀lɪ́sàː
majami'a	mə̀dʒáːmɪ́ʔàː
majanuni	mə̀dʒə̀núːnìː
makabarta	mə́kə́bártáː
makaɗi	mə́kə́ɗíː
makaɗi	mə́kə̀ɗíː
makama	mə́káːmáː
makama	mə́kàːmáː
maka	mə́kə̀
makara	mə̀kə̀ɽáː
makaranta	mə́kə́rántáː
makari	mə́kə́ɽíː
makero	mə̀céːɽòː
makiyaya	mə́cɪ́jáːjáː
makiyayi	mə́cɪ̀jàːjíː
makka	mákkə̀
mako	máːkʷòː
makwanci	mə́kʷántʃíː
maƙala	mə̀kʼáːlàː
maƙari	mə́kʼáːɽíː
maƙil	màːcʼɪ́l
maƙiyi	mə́cʼɪ̀jíː
maƙoƙo	màːkʷʼóːkʷʼòː
maƙoshi	mə́kʷʼóːʃíː
maƙwabci	mə́kʷʼàbtʃíː
mala'ika	mə̀láːʔɪ́kàː
malama	máːlə̀máː
malami	máːlə̀míː
malam	máːlàŋ
mamaki	màːmáːcìː
mama	màːmə́
mamaye	màːmɛ̀jéː
mandiri	màndíːrìː
mangariba	màŋgə̀rɪ́bàː
manhaja	máŋhádʒàː
manja	mándʒə̀
manjo	mándʒɔ̀
mantau	màntáu
manzo	mànzóː
maraba	mə́ràːbə́
maraba	mə́ɽə́báː
maraɗi	mə́ɽáːɗɪ́
maraya	máːɽɛ̀jáː
maraya	mə̀ɽáːjàː
maraya	mə́ɽáːjɛ́
marhabin	màrhábɪ̀ŋ
marili	mə̀ríːlìː
marini	mə́ɽɪ̀níː
mariri	màːɽíːɽíː
maris	máːrɪ̀s
marke	máɽcéː
maroko	mə̀róːkʷò
maroƙi	mə́ɽòːcʼíː
maru	máːɽɪ̀
maryamu	márjɛ́mʊ̀
masaƙi	mə́sàːcʼíː
masallaci	mə́sálláːtʃíː
masaniya	mə́sə́nɪ̀jáː
masara	mə́sə̀ráː
masarauta	mə́sə́ɽáutáː
masar	mə́sàr
masassaƙi	mə́sássə́cʼíː
masassaƙi	mə́sàssə̀cʼíː
masauki	mə́sáucíː
masaya	mə́sáːjáː
masaya	mə́sɛ́jáː
mashahuri	mə̀ʃə̀húːrìː
mashaidi	mə́ʃèidíː
mashar̃ci	mə́ʃártʃíː
mashawar̃ta	mə́ʃáːwártáː
mashi	máːʃìː
mashin	mə̀ʃɪ̂ŋ
masinja	máːsɪ́ndʒə̀
masoro	mə̀sóːɽó
matalauci	mə́tə̀làutʃíː
mata	máːtáː
mata	màːtáː
matsala	mə̀sʼə́làː
matukar̃	mə́tɪ́kár
matuƙa	mə́tɪ́kʼáː
maya	màːjáː
mayani	mɛ́jáːníː
maye	màːjéː
mayu	máːjùː
maza	mə́záː
maza	mə́zə́
mazauni	mə́záuníː
mazauni	mə́zàuníː
mazo	màːzóː
mele	méːléː
mena	méːnàː
mesa	méːsàː
mesin	méːsɪ̀ŋ
metso	mèːsʼóː
miji	mɪ́dʒìː
mim	mɪ́ŋ
minista	mɪ́nɪ́stə̀
minti	mɪ́ntìː
mirya	mɪ́ɽjɛ̀
misali	mɪ̀sáːlìː
mishi	mɪ́ʃíː
misira	mɪ́sɪ́rə̀
miski	mɪ́scìː
miskini	mɪ̀scíːnìː
miya	mɪ́jàː
mizani	míːzáːnìː
mohammed	mʊ̀hámmàd
molo	móːlóː
mota	móːtàː
mowa	móːwàː
mu'amala	mʊ̀ʔáːmə́làː
mubazzari	mʊ̀bázzə̀ríː
muddin	mʊ́ddɪ̀ŋ
mugu	múːgʷùː
muhammadiyya	mʊ̀hàmmə̀dɪ́jjàː
muhammadu	mʊ̀hámmə́dɪ̀
muharram	mʊ̀hárràŋ
muhibba	mʊ̀hɪ́bbàː
muhimmi	mʊ̀hɪ́mmìː
muhtari	mʊ̀ktáːrɪ́
muhuri	mʊ́húːɽíː
mujaddadi	mʊ̀dʒáddə̀díː
mujalla	mʊ̀dʒállàː
mujiya	múːdʒɪ̀jáː
muƙami	mʊ̀kʼáːmìː
mula	mʊ̀lə́
mulki	mʊ́lcìː
mulukiya	mʊ́lúːcɪ́jàː
mumbari	mʊ́mbə̀ríː
mumini	múːmɪ̀níː
mu	múː
munafuki	mʊ̀náːɸʊ̀cíː
muradi	mʊ̀ráːdìː
murfi	mʊ́ɽɸíː
murhu	mʊ́ɽhùː
murjani	mʊ̀rdʒáːnìː
mur	mʊ̂r
murtuk	mʊ̀rtɪ́k
murza	mʊ́ɽzàː
murza	mʊ̀ɽzáː
murzani	mʊ̀rzáːnìː
musamman	mʊ̀sámmàŋ
musa	múːsáː
musawa	múːsáːwáː
mushe	múːʃèː
mushiriki	mʊ́ʃɪ́rɪ̀cíː
mustapha	mʊ́stə̀ɸáː
musulmi	mʊ̀sɪ̀lmíː
mutum	mʊ̀tɪ̂ŋ
mutu	mʊ́tɪ̀
mutunci	mʊ́tɪ́ntʃìː
mutuwa	mʊ́tʊ́wàː
mu'ujiza	mʊ̀ʔʊ̀dʒɪ́zàː
muzi	múːzíː
muzuru	mʊ̀zúːɽúː
na'am	nə́ʔàm
na'am	nə̀ʔám
nafila	náːɸɪ́làː
nahawu	nə́háwùː
nahiya	náːhɪ́jàː
na'ibi	náːʔɪ̀bíː
naijeriya	nèidʒéːrɪ́jàː
naira	néiràː
najeriya	nàːdʒéːrɪ́jàː
nakiya	nàːcɪ́jàː
nama	náːmàː
nasaba	nə́sə́bàː
nasara	nə́sáːràː
nasara	nə́sə́ràː
nasaru	nə̀sàːrúː
nasiha	nə̀síːhàː
nas	nâs
nau'i	náuʔìː
na'ura	nàːʔúːràː
nazari	nə́zə̀ríː
neja	néːdʒə̀
nesa	néːsə̀
ni'ima	nɪ́ʔɪ́màː
nijeriya	nìːdʒéːrɪ́jɛ̀
nil	nɪ̂l
nim	nɪ̂ŋ
ni	níː
nisa	níːsáː
nishaɗi	nɪ̀ʃáːɗìː
nono	nóːnòː
noti	nóːtìː
notis	nóːtɪ̀s
nuhu	nɪ́hʊ̀
nukus	nɪ̀kʷʊ̀s
nuna	núːnàː
nun	nɪ́ŋ
nuwamba	nʊ̀wámbàː
obin	ʔóːbɪ̀ŋ
ofis	ʔóːɸɪ̀s
oga	ʔògáː
oktoba	ʔɔ̀któːbàː
omo	ʔóːmòː
oza	ʔóːzàː
pakistan	páːcɪ́stàŋ
palasɗinu	pə̀làsɗíːnɪ̀
paris	páːrɪ̀s
pasha	páːʃə̀
pijo	pɪ̀dʒó
po	pôː
ra'ayi	rə́ʔɛ̀jíː
raɓa	ɽáːɓáː
raɗau	rə́ɗáu
rafani	ráːɸàːníː
ragama	ɽə́gə̀máː
rahama	rə́hámàː
rahila	ɽə̀híːláː
rahusa	rə̀húːsáː
ra'i	ráːʔìː
rairai	ɽèiɽéi
rairayi	ɽèiɽɛ̀jíː
rai	ɽâi
rajab	ɽə́dʒàb
raka'a	rə́kə́ʔàː
rake	ɽə̀céː
raki	ɽáːcìː
raƙumi	ɽàːkʷʼʊ́míː
ramalan	ɽə̀mə̀lâŋ
rama	ɽàːmə́
rama	ɽə́màː
ramɓasɓas	ràmɓàsɓàs
rami	ɽáːmìː
rana	ɽáːnáː
rana	ɽáːnə́
randa	ɽàndáː
rano	ɽə́nó
rasha	ɽáːʃə̀
rashawa	rə́ʃə́wáː
rawani	ɽə́wə̀níː
rawaya	ɽàːwɛ́jàː
rema	ɽéːmáː
reras	rèːrás
reza	réːzàː
riba	ríːbàː
riba	rɪ̀bə́
ridda	rɪ́ddáː
riɗi	ɽíːɗíː
riga	ɽìːgáː
rige	ɽɪ́ɟé
rijiya	ɽíːdʒíːjáː
rimi	ɽíːmíː
rimi	ɽíːmɪ́
ringim	ɽɪ́ɲɟɪ̀ŋ
rinjaye	ɽɪ́ndʒáːjèː
ri	rìː
riris	ɽɪ́ɽɪ̀s
rogo	ɽóːgʷò
rogo	ɽóːgʷòː
romo	ɽóːmóː
rubu'i	rɪ́bʊ̀ʔíː
rubuta	rɪ́bùːtáː
ruhu	rúːhʊ̀
ruƙayyatu	ɽɪ́kʼɛ̀jjɛ́tɪ̀
rula	rúːlàː
rumbu	ɽɪ̀mbúː
rumfa	ɽɪ̀mɸáː
runji	ɽɪ́ndʒìː
rututu	rɪ́tɪ́tɪ́
ru'uya	rɪ̀ʔìjáː
ruwa	ɽʊ́wáː
ruwa	ɽʊ́wə́
sa'a	sáːʔàː
sa'a	sə́ʔàː
sababi	sə́bə̀bíː
saba'in	sə̀bə̀ʔɪ́ŋ
saboda	sə́bòːdə̀
sabo	sáːbó
sabo	sáːbóː
sadaka	sə́də́kàː
sadaki	sə̀dâːcíː
sada	sáːdàː
sadau	sàːdáu
sadin	sàːdɪ̂ŋ
saɗara	sə̀ɗə́ràː
safara	sə́ɸə́ràː
safar	sə́ɸàr
safa	sàːɸáː
safa	sə̀ɸâː
safe	sáːɸé
safi	sáːɸíː
sagara	sàːgə́ɽáː
sage	sə́ɟèː
sago	sə́gʷóː
sahani	sə̀háːnìː
sahibi	sáːhɪ̀bíː
sahihi	sə̀híːhìː
sahur	sə̀hʊ̂r
sa'ida	sə̀ʔíːdàː
saiwa	sêiwáː
saja	sáːdʒàː
sakamako	sàːkə̀mə́kʷóː
sakan	sə́kàŋ
sakarai	sáːkə́réi
sake	sə̀céː
sakiya	sáːcɪ́jɛ́
sakkwato	sákʷkʷə́tó
sako	sə̀kʷóː
salama	sə̀láːmàː
salati	sə̀láːtìː
salga	sálgáː
salihi	sáːlɪ̀híː
saliyo	sàːlɪ̀jôː
salka	sàlkáː
salla	sállàː
sallau	sàlláu
salo	sə́lóː
samame	sə̀màːméː
samanja	sàːmándʒə̀
sama	sə́mə̀
samɓala	sámɓə́láː
samɓalɓal	sàmɓàlɓàl
samɓali	sámɓə́lɪ́
samɓal	sàmɓál
sana'a	sə̀nə́ʔàː
sanar̃wa	sə́nârwáː
sanata	sə́nə́tàː
sandal	sándàl
sanda	sàndə́
sanduƙi	sàndúːcʼìː
sani	sə́nìː
saniya	sáːnɪ̀jáː
sanka	sáŋkáː
sannu	sánnɪ̀
sannu	sànnɪ́
sansani	sànsə́níː
sansan	sánsàŋ
santambul	sàntàmbʊ̂l
santi	sàntɪ́
sarai	sə́réi
sarara	sə̀ɽə̀ɽə̀
sara	sàːɽáː
saratu	sáːrə́tɪ̀
sarauniya	sə́ɽáunɪ̀jáː
sardauna	sàrdáunə́
sarka	sàrkáː
sarki	sáɽcíː
sarki	sáɽcɪ́
sarƙa	sáɽkʼàː
sa	sâː
sashi	sáːʃìː
sata	sáːtàː
sati	sáːtíː
satumba	sə̀tɪ́mbàː
saudiyya	sàudɪ́jjàː
sauka	sàukáː
sauka	sàukə́
sauna	sáunàː
sau	sáu
sau	sàu
sauti	sáutìː
saye	sàːjéː
saye	sɛ̀jéː
sef	sêɸ
sha'aban	ʃə̀ʔàbâŋ
sha'ani	ʃə́ʔàníː
shaci	ʃáːtʃìː
shadda	ʃáddàː
shadda	ʃâddáː
shafa	ʃáːɸàː
shafa	ʃàːɸáː
shahada	ʃə̀háːdàː
shaho	ʃáːhòː
shai'an	ʃéiʔàŋ
shaiɗan	ʃèiɗâŋ
shaihi	ʃéihìː
sham	ʃâŋ
shanono	ʃàːnóːnò
sharaɗi	ʃə́rə̀ɗíː
sharhi	ʃárhìː
shari'a	ʃə̀rɪ́ʔàː
sharifi	ʃə̀ríːɸìː
sharif	ʃə̀rɪ̂ɸ
sharo	ʃə́rò
sharri	ʃárrìː
sharu	ʃə̀rûː
sha	ʃə́
shata	ʃə́tàː
shat	ʃât
shawar̃a	ʃáːwə́ràː
shawwal	ʃàwwâl
shayi	ʃàːjíː
shayi	ʃáːjɪ̀
shehi	ʃéːhìː
shehu	ʃéːhùː
shekara	ʃèːkə́ɽàː
shekarau	ʃèːkə̀ɽáu
sheƙeƙe	ʃèːcʼèːcʼèː
shida	ʃɪ́də̀
shifta	ʃɪ́ɸtàː
shiga	ʃɪ̀gáː
shinge	ʃɪ́ɲɟéː
shinkafa	ʃɪ̀ŋkáːɸáː
shin	ʃɪ́ŋ
shirim	ʃɪ̀ɽɪ̀m
shirka	ʃɪ́rkàː
shiru	ʃɪ́ɽúː
shirwa	ʃɪ́ɽwàː
shi	ʃɪ́
shuɗi	ʃúːɗìː
shugabanci	ʃúːgə́bántʃìː
shuka	ʃúːkàː
shuri	ʃúːɽìː
shu'umi	ʃɪ́ʔʊ̀míː
siɗik	sɪ́ɗɪ́k
sifiri	sɪ́ɸɪ̀ríː
siga	síːgàː
siket	sɪ̀cát
sila	sɪ́làː
silin	síːlɪ̀ŋ
sili	síːlìː
sin	sɪ́ŋ
sirdi	sɪ́rdìː
siriya	síːrɪ́jɛ̀
sista	sɪ́stàː
sitampi	sɪ̀támpìː
sitam	sɪ̀tâŋ
sitira	sɪ̀tɪ́ràː
sito	sɪ̀tó
sittin	sɪ̀ttɪ́ŋ
siyaki	sɪ̀jáːcíː
siyasa	sɪ̀jáːsàː
soba	sòːbə́
soci	sóːtʃɪ̀
soja	sóːdʒə̀
sol	sɔ́l
somi	sóːmìː
soso	sòːsóː
soye	sòːjéː
sufana	sɪ̀ɸáːnàː
sujjada	sɪ̀ddʒə́dàː
sukari	sɪ́kə̀ríː
sukuku	sɪ̀kʷʊ̀kʷʊ̀
sulemanu	sɪ́lèːmáːnɪ̀
sulhu	sɪ́lhùː
sum	sɪ̀m
sumul	sɪ́mʊ́l
suna	súːnáː
sunduƙi	sɪ̀ndúːcʼìː
sunna	sɪ́nnàː
sura	súːràː
sura	sùːráː
su	sùː
suya	súːjàː
ta'adda	tə́ʔàddə́
tabarau	tə̀bàːɽáu
tabarma	tàːbáɽmáː
tabbatarwa	tábbə́târwáː
tabo	tə́bòː
taɓo	tə̀ɓóː
tadawa	tə̀də́wàː
tafarki	tə́ɸáɽcìː
tafarnuwa	tə̀ɸárnʊ́wáː
tafiya	tə̀ɸɪ́jàː
tafki	táɸcìː
tafsiri	tàɸsíːrìː
taga	táːgàː
tagomashi	tə́gʷóːmə̀ʃíː
taguwa	tàːgʷʊ́wàː
taguwa	tə́gʷʊ́wàː
taimako	tèimə́kʷóː
tajiri	táːdʒɪ̀ríː
takalmi	tàːkàlmíː
takarda	tə́kàrdáː
takila	táːcɪ̀lə̀
takobi	tə́kʷòːbíː
takum	táːkʷʊ̀ŋ
takunkumi	tàːkʷʊ́ŋkʷʊ̀míː
takwas	tə́kʷàs
talaka	tə́lə̀kə̀
talata	tə̀láːtə̀
talatin	tə̀làːtɪ́ŋ
talatu	tə̀láːtɪ̀
taliki	táːlɪ̀cíː
tallafa	tálláːɸə̀
tallafa	tàllə́ɸàː
talla	tàllə̀
talle	tálléː
talotalo	tə̀lótə̀ló
tamanin	tə̀màːnɪ́ŋ
tama	tə́máː
tambari	támbə̀ɽíː
tambaya	tàmbɛ́jàː
tambutu	tàmbúːtɪ̀,támbúːtɪ̀
tanaka	tàːnáːkàː
tana	táːnáː
tandu	tándúː
tanimu	tə̀níːmʊ̀
tankarki	tàŋkáɽcìː
tano	tə̀nôː
tantabara	tàntə́bə̀ráː
tantakwashi	tàntə́kʷə̀ʃíː
tanti	tántìː
tarabulus	tə́ráːbʊ́lɪ̀s
tara	táːɽàː
tara	tàːɽáː
tara	tə́rə̀
tara	tə̀ɽáː
tarbiyya	tàrbɪ́jjàː
tarihi	táːríːhìː
tarnatsa	tárnə́sʼáː
taru	táːɽúː
tasalla	tə́sállə̀
tasa	táːsàː
tasiri	táːsíːɽìː
tasi	tàːsîː
taska	táskàː
tasku	táskʷʊ̀
taswira	tàːswíːràː
tattabara	tàttə́bə̀ráː
tattasai	tàːttàːséi
tattaunawa	táttàunâːwáː
tatul	tàːtɪ́l
taubashi	táubàːʃíː
tauhidi	tàuhíːdìː
tauna	táunàː
tauraro	tàuɽáːɽòː
taure	táuɽèː
tausa	tàusáː
tautau	táutàu
tawada	tə̀wə́dàː
tef	téɸ
teku	tèːkʷʊ́
tela	téːlə̀
tifa	tíːɸàː
tif	tɪ̂ɸ
tijara	tɪ̀dʒáːràː
tik	tɪ̂k
tiƙis	tɪ́cʼɪ́s
tilas	tíːlàs
tilo	tìːlóː
tim	tɪ̂m
tim	tɪ̂ŋ
tire	tɪ̀ré
tis'in	tɪ̀sʔɪ́ŋ
ti	tîː
titi	tíːtìː
tofa	tóːɸáː
toka	tòːkáː
ton	táŋ
toshiya	tóːʃɪ́jáː
tozali	tóːzə̀líː
tozo	tóːzóː
tsabga	sʼábgàː
tsada	sʼáːdə́
tsaf	sʼáp
tsagagi	sʼə́gə́ɟíː
tsai	sʼéi
tsakani	sʼə̀káːníː
tsaka	sʼə́káː
tsaka	sʼə́kə̀
tsakiya	sʼə́cɪ́jàː
tsalala	sʼə́lə́lə́
tsamiya	sʼáːmɪ́jáː
tsanyawa	sʼɛ́ɲjáːwáː
tsari	sʼáːɽìː
tsarki	sʼáɽcíː
tsaro	sʼə̀ɽóː
tsatsa	sʼáːsʼàː
tsauni	sʼáunìː
tsawo	sʼə́wóː
tsere	sʼéːɽé
tsibiri	sʼɪ̀bɪ́ɽíː
tsigi	sʼíːɟíː
tsila	sʼíːlə́
tsintsiya	sʼɪ́nsʼɪ́ɲjáː
tsit	sʼɪ́t
tsoho	sʼóːhóː
tsokana	sʼóːkə̀náː
tsoka	sʼóːkàː
tsololo	sʼòːlòːlòː
tsundum	sʼɪ̀ndɪ́m
tsundum	sʼɪ̀ndɪ̀m
tsuntsu	sʼɪ́nsʼúː
tubali	túːbə̀líː
tubarkalla	tɪ̀bárkállàː
tuhuma	tɪ̀hʊ́màː
tukuf	tɪ́kʷʊ́p
tulu	tùːlúː
tunau	tɪ̀náu
tuni	tɪ́nìː
tuni	tɪ̀nɪ́
tunkiya	tɪ́ɲcɪ̀jáː
tun	tɪ́ŋ
tuntunmi	tɪ́ntɪ́mmíː
tuntu	tɪ́ntúː
turai	túːréi
turanci	túːrántʃíː
turare	tɪ̀ɽàːɽéː
turba	tɪ́ɽbàː
tururi	tɪ̀ɽɪ̀ɽíː
tusa	túːsàː
tuta	túːtàː
tutu	túːtɪ̀
tuwo	tʊ́wóː
uba	ʔʊ̀báː
uda	ʔúːdə̀
uku	ʔʊ́kʷʊ̀
uƙuba	ʔʊ̀kʷʼúːbàː
ulu	ʔúːlɪ̀
umaru	ʔʊ̀mə́rɪ̀
umra	ʔʊ́mráː
ungozoma	ʔʊ̀ŋgʷóːzòːmə̀
ungulu	ʔʊ̀ŋgʷʊ̀lɪ́
usaina	ʔʊ́sèináː
ushira	ʔʊ́ʃɪ̀ráː
ushiri	ʔʊ́ʃɪ̀ríː
usumanu	ʔʊ̀sɪ̀máːnɪ̀
usur	ʔʊ́sɪ̀r
uwa	ʔʊ́wáː
uwa	ʔʊ́wə́
uzuri	ʔʊ́zɪ̀ríː
wa'adi	wə́ʔàdíː
wa'azi	wə́ʔàzíː
wada	wàːdáː
wada	wə̀dáː
wagadugu	wə̀gə̀dɪ́gʷʊ̀
waga	wáːgáː
wahala	wə̀hálàː
waha	wə́hàː
wakili	wə̀cíːlìː
waƙafi	wə́kʼə̀ɸíː
waƙa	wə́kʼə́
walau	wə̀làu
wala	wáːláː
wala	wáːlàː
wali	wáːlíː
wali	wə̀lîː
waliyyi	wə̀lɪ́jjìː
walƙiya	wàlcʼɪ́jáː
wallafa	wàllə́ɸàː
wallahi	wæɫóːp
wal	wàl
wando	wàndóː
wani	wə́nɪ́
wanka	wáŋkáː
wanka	wáŋkàː
wanwar	wàmwár
wanzami	wànzáːmìː
wanzam	wànzâŋ
wanzanci	wánzántʃìː
ware	wáːɽèː
wariya	wáːɽɪ́jáː
warƙa	wárkʼàː
warwar	wàrwár
warwas	wàrwás
wasai	wə́séi
wasali	wə́sə̀líː
wasa	wàːsáː
wasiƙa	wə̀síːkʼàː
wasiyya	wə̀sɪ́jjàː
watari	wə̀tə̀ɽɪ́
wata	wə́tàː
wata	wə́tə́
wau	wáu
waziri	wə̀zíːrɪ̀,wə̀zíːrìː
wili	wíːlìː
wofi	wòːɸíː
wokaci	wóːkə̀tʃíː
wudil	wʊ̀dɪ́l
wuƙa	wʊ́kʼáː
wulik	wʊ́lɪ́k
wuluk	wʊ́lɪ́k
wul	wʊ́l
wul	wʊ̀l
wuridi	wʊ́rɪ̀díː
wuski	wʊ́scíː
wuski	wʊ́scìː
wuta	wʊ́táː
wuya	wíjàː
wuya	wìjáː
yabirbira	jàːbɪ́ɽbɪ̀ɽáː
yadda	jɛ́ddə̀
yadda	jɛ̂ddə̀
'ya	j̰áː
yakubu	jàːkʷʊ́bʊ̀
yaƙi	jáːcʼìː
yaƙubu	jàːkʷʼʊ́bʊ̀
yallaɓai	jɛ́llàːɓêi
yalwa	jɛ̀lwə́
yamai	jɛ̀mèi
yamal	jɛ́màl
yamma	jɛ̂mmáː
yamma	jɛ̂mmə́
yanki	jɛ́ɲcìː
yanzu	jɛ̀nzɪ́
yari	jɛ̀ɽíː
yarima	jɛ̀ríːmə̀
yarinya	jáːɽɪ́ɲjàː
'yar	j̰ɛ́r
yaro	jáːɽòː
yatsa	jáːsʼàː
yautai	jɛ́utéi
yawa	jɛ́wàː
yawanci	jɛ́wántʃíː
yayyafi	jɛ́jjɛ́ɸíː
yis	jɪ̂s
yuganda	jʊ̀gándə̀
yuli	júːlɪ̀
yunananci	júːnáːnántʃíː
yunan	jùːnâŋ
yuni	júːnɪ̀
yunƙuri	jʊ̀ŋkʷʼʊ́ɽíː
yusufu	júːsɪ́ɸʊ̀
Ƴ	j̰
ƴ	j̰
zabarjadi	zə́bàrdʒə́dìː
zafaran	zàːɸə̀râŋ
zafi	záːɸíː
zago	zə́gʷóː
zahiri	záːhɪ̀ríː
zaiba	zéibàː
za'ida	záːʔɪ́dàː
zainabu	zèinə́bʊ̀
zaiti	zéitìː
zaitun	zèitɪ̂ŋ
zaki	záːcìː
zakka	zàkkáː
zaƙaƙa	zə̀kʼə̀kʼə̀
zaƙami	zə́kʼə̀míː
zalunci	záːlɪ́ntʃìː
zamani	zàːmáːnìː
zamani	záːmə̀níː
zama	zə́máː
zamba	zàmbə́
zandar	zàndâr
zara	zàːráː
zara	zə̀ɽáː
zare	záːɽèː
zare	zàːɽéː
zare	zə́ɽèː
zare	zə̀ɽéː
zariya	záːɽɪ́jɛ̀
zarto	zártòː
zauna	záunàː
zau	záu
zazzau	zázzàu
zigidir	zɪ̀ɟɪ̀dɪ́r
zikiri	zɪ́cɪ̀ríː
zik	zɪ̂k
zinariya	zíːnáːrɪ̀jáː
zinari	zíːnáːrìː
zina	zɪ̀náː
zira'i	zɪ̀ráːʔìː
zi	zîː
zololo	zòːlòːlòː
zomo	zóːmóː
zubairu	zɪ̀béirɪ̀
zulhajji	zɪ́lháddʒɪ̀
zulƙida	zɪ̀lcʼíːdàː
zuma	zɪ́màː
zumurrudu	zɪ́mʊ̀rrɪ́dɪ̀
zundum	zɪ̀ndɪ́m
zunubi	zɪ̀nɪ́bìː
zuriya	zɪ̀rɪ́jàː
zuwa	zʊ́wàː
ʼY	j̰
ʼy	j̰
