a	a˧˧
á	a˦˥
à	a˧˨
ả	a˨˩˦
ạ	a˨˩˨
ác	ak˦˥
ắc	ăk˦˥
ặc	ăk˨˩˨
ác-bít	ak˦˥-bit˦˥
ắc-coóc	ăk˦˥-kɔkp˦˥
ách	at˦˥
ạch	at˨˩˨
ác-ten	ak˦˥-tɛŋ˧˧
a-di-đà	a˧˧-ji˧˧-da˧˨
â	ɤ̆˧˧
ai	aj˧˧
ái	aj˦˥
ải	aj˨˩˦
a-lê	a˧˧-le˧˧
am	am˧˧
ám	am˦˥
ăm	ăm˧˧
ẵm	ăm˨˩˦
ảm	am˨˩˦
âm	ɤ̆m˧˧
ấm	ɤ̆m˦˥
ầm	ɤ̆m˧˨
ẫm	ɤ̆m˨˩˦
ẩm	ɤ̆m˨˩˦
ậm	ɤ̆m˨˩˨
a-mi-nô	a˧˧-mi˧˧-no˧˧
am-pe	am˧˧-pɛ˧˧
an	aŋ˧˧
án	aŋ˦˥
ăn	ăŋ˧˧
ăn	ăŋ˧˧
ân	ɤ̆ŋ˧˧
ấn	ɤ̆ŋ˦˥
ẩn	ɤ̆ŋ˨˩˦
ang	aŋ˧˧
áng	aŋ˦˥
ăng	ăŋ˧˧
ắng	ăŋ˦˥
ằng	ăŋ˧˨
ẳng	ăŋ˨˩˦
anh	an˧˧
anh	an˧˧
ánh	an˦˥
ành	an˧˨
ảnh	an˨˩˦
ao	aw˧˧
áo	aw˦˥
áo	aw˦˥
áo	aw˦˥
ào	aw˧˨
ảo	aw˨˩˦
ạo	aw˨˩˨
áp	ap˦˥
ấp	ɤ̆p˦˥
ập	ɤ̆p˨˩˨
a-rập	a˧˧-ʐɤ̆p˨˩˨
ắt	ăk˦˥
át	at˦˥
ất	ɤ̆k˦˥
au	ăw˧˧
âu	ɤ̆w˧˧
âu	ɤ̆w˧˧
âu	ɤ̆w˧˧
âu	ɤ̆w˧˧
âu	ɤ̆w˧˧
âu	ɤ̆w˧˧
âu	ɤ̆w˧˧
ấu	ɤ̆w˦˥
ầu	ɤ̆w˧˨
ẩu	ɤ̆w˨˩˦
a-xê-ti-len	a˧˧-se˧˧-ti˧˧-lɛŋ˧˧
a-xít	a˧˧-sit˦˥
ay	ăj˧˧
áy	ăj˦˥
ấy	ɤ̆j˦˥
ba	ba˧˧
bá	ba˦˥
bà	ba˧˨
bã	ba˨˩˦
bả	ba˨˩˦
bạ	ba˨˩˨
bác	bak˦˥
bắc	băk˦˥
bạc	bak˨˩˨
bặc	băk˨˩˨
bấc	bɤ̆k˦˥
bậc	bɤ̆k˨˩˨
bách	bat˦˥
bạch	bat˨˩˨
bai	baj˧˧
bái	baj˦˥
bài	baj˧˨
bãi	baj˨˩˦
bải	baj˨˩˦
bại	baj˨˩˨
bam	bam˧˧
bám	bam˦˥
bàm	bam˧˨
băm	băm˧˧
bặm	băm˨˩˨
bấm	bɤ̆m˦˥
bầm	bɤ̆m˧˨
bẫm	bɤ̆m˨˩˦
bẩm	bɤ̆m˨˩˦
bậm	bɤ̆m˨˩˨
ban	baŋ˧˧
bán	baŋ˦˥
bàn	baŋ˧˨
băn	băŋ˧˧
bắn	băŋ˦˥
bằn	băŋ˧˨
bẳn	băŋ˨˩˦
bản	baŋ˨˩˦
bạn	baŋ˨˩˨
bân	bɤ̆ŋ˧˧
bấn	bɤ̆ŋ˦˥
bần	bɤ̆ŋ˧˨
bẩn	bɤ̆ŋ˨˩˦
bận	bɤ̆ŋ˨˩˨
bang	baŋ˧˧
báng	baŋ˦˥
bàng	baŋ˧˨
băng	băŋ˧˧
bắng	băŋ˦˥
bằng	băŋ˧˨
bẵng	băŋ˨˩˦
bảng	baŋ˨˩˦
bạng	baŋ˨˩˨
bặng	băŋ˨˩˨
bâng	bɤ̆ŋ˧˧
bầng	bɤ̆ŋ˧˨
băng-giô	băŋ˧˧-jo˧˧
bánh	ban˦˥
bành	ban˧˨
bảnh	ban˨˩˦
bạnh	ban˨˩˨
bao	baw˧˧
báo	baw˦˥
bào	baw˧˨
bão	baw˨˩˦
bảo	baw˨˩˦
bạo	baw˨˩˨
bắp	băp˦˥
bấp	bɤ̆p˦˥
bập	bɤ̆p˨˩˨
bắt	băk˦˥
bặt	băk˨˩˨
bát	bat˦˥
bạt	bat˨˩˨
bất	bɤ̆k˦˥
bật	bɤ̆k˨˩˨
ba-trui	ba˧˧-ʈuj˧˧
bát-tràng	bat˦˥-ʈaŋ˧˨
báu	băw˦˥
bàu	băw˧˨
bảu	băw˨˩˦
bạu	băw˨˩˨
bâu	bɤ̆w˧˧
bấu	bɤ̆w˦˥
bầu	bɤ̆w˧˨
bậu	bɤ̆w˨˩˨
ba-xí	ba˧˧-si˦˥
bay	băj˧˧
bày	băj˧˨
bảy	băj˨˩˦
bây	bɤ̆j˧˧
bấy	bɤ̆j˦˥
bầy	bɤ̆j˧˨
bẫy	bɤ̆j˨˩˦
bẩy	bɤ̆j˨˩˦
bậy	bɤ̆j˨˩˨
bê	be˧˧
bế	be˦˥
bề	be˧˨
bể	be˨˩˦
bệ	be˨˩˨
be	bɛ˧˧
bé	bɛ˦˥
bè	bɛ˧˨
bẽ	bɛ˨˩˦
bẻ	bɛ˨˩˦
bẹ	bɛ˨˩˨
béc	bɛk˦˥
bệch	bet˨˩˨
bem	bɛm˧˧
bèm	bɛm˧˨
bẻm	bɛm˨˩˦
bên	ben˧˧
bến	ben˦˥
bền	ben˧˨
bện	ben˨˩˨
bén	bɛŋ˦˥
bèn	bɛŋ˧˨
bẽn	bɛŋ˨˩˦
beng	bɛŋ˧˧
bênh	ben˧˧
bềnh	ben˧˨
bệnh	ben˨˩˨
beo	beo˧˧
béo	beo˦˥
bèo	beo˧˨
bẻo	beo˨˩˦
bếp	bep˦˥
bép	bɛp˦˥
bẹp	bɛp˨˩˨
bết	bet˦˥
bệt	bet˨˩˨
bét	bɛt˦˥
bẹt	bɛt˨˩˨
bê-tông	be˧˧-toŋm˧˧
bêu	bɛu˧˧
bều	bɛu˧˨
bệu	bɛu˨˩˨
bia	biə˧˧
bìa	biə˧˨
bịa	biə˨˩˨
bi	bi˧˧
bí	bi˦˥
bì	bi˧˨
bĩ	bi˨˩˦
bỉ	bi˨˩˦
bị	bi˨˩˨
bích	bit˦˥
bích-câu	bit˦˥-kɤ̆w˧˧
biếc	biək˦˥
biếm	bim˦˥
biên	biəŋ˧˧
biến	biəŋ˦˥
biền	biəŋ˧˨
biển	biəŋ˨˩˦
biện	biəŋ˨˩˨
biêng	biəŋ˧˧
biếng	biəŋ˦˥
biết	biək˦˥
biệt	biək˨˩˨
biếu	biəw˦˥
biểu	biəw˨˩˦
bìm	bim˧˨
bỉm	bim˨˩˦
bin	bin˧˧
bín	bin˦˥
bịn	bin˨˩˨
binh	bin˧˧
bính	bin˦˥
bình	bin˧˨
bĩnh	bin˨˩˦
bỉnh	bin˨˩˦
bíp	bip˦˥
bịp	bip˨˩˨
bít	bit˦˥
bịt	bit˨˩˨
bịt	bit˨˩˨
bíu	biw˦˥
bìu	biw˧˨
bĩu	biw˨˩˦
bơ	bɤ˧˧
bớ	bɤ˦˥
bờ	bɤ˧˨
bỡ	bɤ˨˩˦
bở	bɤ˨˩˦
bợ	bɤ˨˩˨
bô	bo˧˧
bố	bo˦˥
bồ	bo˧˨
bỗ	bo˨˩˦
bổ	bo˨˩˦
bộ	bo˨˩˨
bo	bɔ˧˧
bó	bɔ˦˥
bò	bɔ˧˨
bò	bɔ˧˨
bò	bɔ˧˨
bõ	bɔ˨˩˦
bỏ	bɔ˨˩˦
bọ	bɔ˨˩˨
bốc	bokp˦˥
bộc	bokp˨˩˨
bóc	bɔkp˦˥
bọc	bɔkp˨˩˨
bơi	bɤj˧˧
bới	bɤj˦˥
bời	bɤj˧˨
bởi	bɤj˨˩˦
bôi	boj˧˧
bối	boj˦˥
bồi	boj˧˨
bổi	boj˨˩˦
bội	boj˨˩˨
bói	bɔj˦˥
bòi	bɔj˧˨
bơm	bɤm˧˧
bờm	bɤm˧˨
bợm	bɤm˨˩˨
bôm	bom˧˧
bồm	bom˧˨
bom	bɔm˧˧
bòm	bɔm˧˨
bỏm	bɔm˨˩˦
bơn	bɤŋ˧˧
bờn	bɤŋ˧˨
bỡn	bɤŋ˨˩˦
bợn	bɤŋ˨˩˨
bôn	boŋm˧˧
bốn	boŋm˦˥
bồn	boŋm˧˨
bổn	boŋm˨˩˦
bộn	boŋm˨˩˨
bon	bɔŋm˧˧
bón	bɔŋm˦˥
bòn	bɔŋm˧˨
bỏn	bɔŋm˨˩˦
bọn	bɔŋm˨˩˨
bông	boŋm˧˧
bống	boŋm˦˥
bồng	boŋm˧˨
bỗng	boŋm˨˩˦
bổng	boŋm˨˩˦
bộng	boŋm˨˩˨
bong	bɔŋm˧˧
bóng	bɔŋm˦˥
bòng	bɔŋm˧˨
bỏng	bɔŋm˨˩˦
bọng	bɔŋm˨˩˨
bôn-sê-vích	boŋm˧˧-ʂe˧˧-jit˦˥
boóc	bɔkp˦˥
boong	bɔŋm˧˧
bớp	bɤp˦˥
bợp	bɤp˨˩˨
bốp	bop˦˥
bộp	bop˨˩˨
bóp	bɔp˦˥
bọp	bɔp˨˩˨
bớt	bɤk˦˥
bợt	bɤk˨˩˨
bột	bokp˨˩˨
bọt	bɔkp˨˩˨
búa	buə˦˥
bùa	buə˧˨
bủa	buə˨˩˦
bừa	bɯə˧˨
bữa	bɯə˨˩˦
bu	bu˧˧
bú	bu˦˥
bù	bu˧˨
bủ	bu˨˩˦
bụ	bu˨˩˨
bư	bɯ˧˧
bứ	bɯ˦˥
bự	bɯ˨˩˨
bức	bɯk˦˥
bực	bɯk˨˩˨
bui	buj˧˧
búi	buj˦˥
bùi	buj˧˨
bụi	buj˨˩˨
bum	bum˧˧
bùm	bum˧˨
bun	buŋm˧˧
bún	buŋm˦˥
bùn	buŋm˧˨
bủn	buŋm˨˩˦
bung	buŋm˧˧
búng	buŋm˦˥
bùng	buŋm˧˨
bủng	buŋm˨˩˦
bụng	buŋm˨˩˨
bưng	bɯŋ˧˧
bưng	bɯŋ˧˧
bừng	bɯŋ˧˨
bửng	bɯŋ˨˩˦
buộc	buək˨˩˨
bước	bɯək˦˥
buổi	buəj˨˩˦
bưởi	bɯəj˨˩˦
buồm	bum˧˨
bươm	bɯm˧˧
bướm	bɯm˦˥
buôn	buəŋ˧˧
buồn	buəŋ˧˨
bươn	bɯəŋ˧˧
buông	buəŋ˧˧
buồng	buəŋ˧˨
bương	bɯəŋ˧˧
bướng	bɯəŋ˦˥
buốt	buək˦˥
buột	buək˨˩˨
bươu	bɯəw˧˧
bướu	bɯəw˦˥
búp	bup˦˥
bút	bukp˦˥
bụt	bukp˨˩˨
bứt	bɯk˦˥
bưu	bɯw˧˧
bửu	bɯw˨˩˦
cách	kat˦˥
cạch	kat˨˩˨
các	kak˦˥
cắc	kăk˦˥
cạc	kak˨˩˨
cặc	kăk˨˩˨
cấc	kɤ̆k˦˥
các-tông	kak˦˥-toŋm˧˧
cai	kaj˧˧
cái	kaj˦˥
cài	kaj˧˨
cãi	kaj˨˩˦
cải	kaj˨˩˦
ca	ka˧˧
cá	ka˦˥
cà	ka˧˨
cả	ka˨˩˦
cả	ka˨˩˦
cam	kam˧˧
cám	kam˦˥
căm	kăm˧˧
cắm	kăm˦˥
cằm	kăm˧˨
cảm	kam˨˩˦
cạm	kam˨˩˨
cặm	kăm˨˩˨
câm	kɤ̆m˧˧
cấm	kɤ̆m˦˥
cầm	kɤ̆m˧˨
cẩm	kɤ̆m˨˩˦
cậm	kɤ̆m˨˩˨
cang	kaŋ˧˧
cáng	kaŋ˦˥
càng	kaŋ˧˨
càng	kaŋ˧˨
căng	kăŋ˧˧
cẳng	kăŋ˨˩˦
cảng	kaŋ˨˩˦
câng	kɤ̆ŋ˧˧
canh	kan˧˧
cánh	kan˦˥
cành	kan˧˨
cảnh	kan˨˩˦
cạnh	kan˨˩˨
can	kaŋ˧˧
cán	kaŋ˦˥
càn	kaŋ˧˨
căn	kăŋ˧˧
cắn	kăŋ˦˥
cằn	kăŋ˧˨
cẳn	kăŋ˨˩˦
cản	kaŋ˨˩˦
cạn	kaŋ˨˩˨
cặn	kăŋ˨˩˨
cân	kɤ̆ŋ˧˧
cấn	kɤ̆ŋ˦˥
cần	kɤ̆ŋ˧˨
cẩn	kɤ̆ŋ˨˩˦
cận	kɤ̆ŋ˨˩˨
cao	kaw˧˧
cáo	kaw˦˥
cào	kaw˧˨
cảo	kaw˨˩˦
cạo	kaw˨˩˨
cà-phê	ka˧˨-fe˧˧
cáp	kap˦˥
cắp	kăp˦˥
cạp	kap˨˩˨
cặp	kăp˨˩˨
cấp	kɤ̆p˦˥
cập	kɤ̆p˨˩˨
cắt	kăk˦˥
cát	kat˦˥
cất	kɤ̆k˦˥
cật	kɤ̆k˨˩˨
cau	kăw˧˧
cáu	kăw˦˥
càu	kăw˧˨
cảu	kăw˨˩˦
câu	kɤ̆w˧˧
cấu	kɤ̆w˦˥
cầu	kɤ̆w˧˨
cẩu	kɤ̆w˨˩˦
cậu	kɤ̆w˨˩˨
cay	kăj˧˧
cáy	kăj˦˥
cày	kăj˧˨
cảy	kăj˨˩˦
cạy	kăj˨˩˨
cây	kɤ̆j˧˧
cấy	kɤ̆j˦˥
cầy	kɤ̆j˧˨
cầy	kɤ̆j˧˨
cậy	kɤ̆j˨˩˨
cha	ca˧˧
chà	ca˧˨
chả	ca˨˩˦
chạ	ca˨˩˨
chác	cak˦˥
chắc	căk˦˥
chạc	cak˨˩˨
chặc	căk˨˩˨
chậc	cɤ̆k˨˩˨
chạch	cat˨˩˨
chai	caj˧˧
chài	caj˧˨
chải	caj˨˩˦
cham	cam˧˧
chàm	cam˧˨
chăm	căm˧˧
chằm	căm˧˨
chạm	cam˨˩˨
châm	cɤ̆m˧˧
chấm	cɤ̆m˦˥
chầm	cɤ̆m˧˨
chẩm	cɤ̆m˨˩˦
chậm	cɤ̆m˨˩˨
chan	caŋ˧˧
chán	caŋ˦˥
chăn	căŋ˧˧
chắn	căŋ˦˥
chằn	căŋ˧˨
chẵn	căŋ˨˩˦
chặn	căŋ˨˩˨
chân	cɤ̆ŋ˧˧
chấn	cɤ̆ŋ˦˥
chần	cɤ̆ŋ˧˨
chẩn	cɤ̆ŋ˨˩˦
chận	cɤ̆ŋ˨˩˨
chang	caŋ˧˧
chàng	caŋ˧˨
chăng	căŋ˧˧
chằng	căŋ˧˨
chẳng	căŋ˨˩˦
chảng	caŋ˨˩˦
chạng	caŋ˨˩˨
chặng	căŋ˨˩˨
châng	cɤ̆ŋ˧˧
chanh	can˧˧
chánh	can˦˥
chành	can˧˨
chảnh	can˨˩˦
chạnh	can˨˩˨
chao	caw˧˧
cháo	caw˦˥
chào	caw˧˨
chão	caw˨˩˦
chảo	caw˨˩˦
chạo	caw˨˩˨
chắp	căp˦˥
chạp	cap˨˩˨
chặp	căp˨˩˨
chấp	cɤ̆p˦˥
chập	cɤ̆p˨˩˨
chắt	căk˦˥
chặt	căk˨˩˨
chát	cat˦˥
chất	cɤ̆k˦˥
chật	cɤ̆k˨˩˨
chau	căw˧˧
cháu	căw˦˥
chàu	căw˧˨
chảu	căw˨˩˦
châu	cɤ̆w˧˧
chấu	cɤ̆w˦˥
chầu	cɤ̆w˧˨
chẫu	cɤ̆w˨˩˦
chậu	cɤ̆w˨˩˨
chay	căj˧˧
cháy	căj˦˥
chày	căj˧˨
chảy	căj˨˩˦
chạy	căj˨˩˨
chây	cɤ̆j˧˧
chấy	cɤ̆j˦˥
chầy	cɤ̆j˧˨
chê	ce˧˧
chế	ce˦˥
chề	ce˧˨
che	cɛ˧˧
chè	cɛ˧˨
chẻ	cɛ˨˩˦
chếch	cet˦˥
chệch	cet˨˩˨
chêm	cem˧˧
chềm	cem˧˨
chễm	cem˨˩˦
chem	cɛm˧˧
chém	cɛm˦˥
chèm	cɛm˧˨
chẻm	cɛm˨˩˦
chen	cɛŋ˧˧
chén	cɛŋ˦˥
chèn	cɛŋ˧˨
chẻn	cɛŋ˨˩˦
chẹn	cɛŋ˨˩˨
cheng	cɛŋ˧˧
chênh	cen˧˧
chếnh	cen˦˥
chềnh	cen˧˨
chễnh	cen˨˩˦
chểnh	cen˨˩˦
chệnh	cen˨˩˨
cheo	ceo˧˧
chéo	ceo˦˥
chèo	ceo˧˨
chẻo	ceo˨˩˦
chép	cɛp˦˥
chẹp	cɛp˨˩˨
chết	cet˦˥
chét	cɛt˦˥
chẹt	cɛt˨˩˨
chêu	cɛu˧˧
chia	ciə˧˧
chìa	ciə˧˨
chĩa	ciə˨˩˦
chích	cit˦˥
chi	ci˧˧
chí	ci˦˥
chì	ci˧˨
chỉ	ci˨˩˦
chị	ci˨˩˨
chiếc	ciək˦˥
chiêm	cim˧˧
chiếm	cim˦˥
chiên	ciəŋ˧˧
chiến	ciəŋ˦˥
chiền	ciəŋ˧˨
chiêng	ciəŋ˧˧
chiếng	ciəŋ˦˥
chiềng	ciəŋ˧˨
chiếp	cip˦˥
chiết	ciək˦˥
chiêu	ciəw˧˧
chiếu	ciəw˦˥
chiều	ciəw˧˨
chiều	ciəw˧˨
chiểu	ciəw˨˩˦
chim	cim˧˧
chìm	cim˧˨
chin	cin˧˧
chín	cin˦˥
chỉn	cin˨˩˦
chinh	cin˧˧
chính	cin˦˥
chình	cin˧˨
chĩnh	cin˨˩˦
chỉnh	cin˨˩˦
chíp	cip˦˥
chít	cit˦˥
chiu	ciw˧˧
chíu	ciw˦˥
chịu	ciw˨˩˨
choác	cwak˦˥
choạc	cwak˨˩˨
choá	cwa˦˥
choai	cwaj˧˧
choàm	cwam˧˨
choăn	cwăŋ˧˧
choang	cwaŋ˧˧
choáng	cwaŋ˦˥
choàng	cwaŋ˧˨
choạng	cwaŋ˨˩˨
choắt	cwăk˦˥
chốc	cokp˦˥
chóc	cɔkp˦˥
chọc	cɔkp˨˩˨
chơ	cɤ˧˧
chớ	cɤ˦˥
chờ	cɤ˧˨
chở	cɤ˨˩˦
chợ	cɤ˨˩˨
chô	co˧˧
chỗ	co˨˩˦
cho	cɔ˧˧
chó	cɔ˦˥
chò	cɔ˧˨
chõ	cɔ˨˩˦
choe	cwe˧˧
choen	cwen˧˧
choèn	cwen˧˨
chơi	cɤj˧˧
chới	cɤj˦˥
chối	coj˦˥
chồi	coj˧˨
chổi	coj˨˩˦
choi	cɔj˧˧
chói	cɔj˦˥
chòi	cɔj˧˨
chọi	cɔj˨˩˨
chơm	cɤm˧˧
chớm	cɤm˦˥
chờm	cɤm˧˨
chôm	com˧˧
chồm	com˧˨
chòm	cɔm˧˨
chõm	cɔm˨˩˦
chỏm	cɔm˨˩˦
chơn	cɤŋ˧˧
chờn	cɤŋ˧˨
chôn	coŋm˧˧
chốn	coŋm˦˥
chồn	coŋm˧˨
chộn	coŋm˨˩˨
chon	cɔŋm˧˧
chỏn	cɔŋm˨˩˦
chọn	cɔŋm˨˩˨
chông	coŋm˧˧
chống	coŋm˦˥
chồng	coŋm˧˨
chổng	coŋm˨˩˦
chong	cɔŋm˧˧
chóng	cɔŋm˦˥
chòng	cɔŋm˧˨
chỏng	cɔŋm˨˩˦
chớp	cɤp˦˥
chợp	cɤp˨˩˨
chộp	cop˨˩˨
chóp	cɔp˦˥
chớt	cɤk˦˥
chốt	cokp˦˥
chột	cokp˨˩˨
chót	cɔkp˦˥
chua	cuə˧˧
chúa	cuə˦˥
chúa	cuə˦˥
chùa	cuə˧˨
chưa	cɯə˧˧
chứa	cɯə˦˥
chừa	cɯə˧˨
chữa	cɯə˨˩˦
chửa	cɯə˨˩˦
chuẩn	cwɤ̆ŋ˨˩˦
chúc	cukp˦˥
chục	cukp˨˩˨
chức	cɯk˦˥
chực	cɯk˨˩˨
chu	cu˧˧
chú	cu˦˥
chù	cu˧˨
chủ	cu˨˩˦
chủ	cu˨˩˦
chư	cɯ˧˧
chứ	cɯ˦˥
chừ	cɯ˧˨
chữ	cɯ˨˩˦
chuếch	cwet˦˥
chuệch	cwet˨˩˨
chuế	cwe˦˥
chuếnh	cwen˦˥
chuểnh	cwen˨˩˦
chuệnh	cwen˨˩˨
chui	cuj˧˧
chúi	cuj˦˥
chùi	cuj˧˨
chửi	cɯj˨˩˦
chum	cum˧˧
chúm	cum˦˥
chùm	cum˧˨
chũm	cum˨˩˦
chụm	cum˨˩˨
chun	cuŋm˧˧
chùn	cuŋm˧˨
chũn	cuŋm˨˩˦
chủn	cuŋm˨˩˦
chung	cuŋm˧˧
chúng	cuŋm˦˥
chùng	cuŋm˧˨
chủng	cuŋm˨˩˦
chưng	cɯŋ˧˧
chứng	cɯŋ˦˥
chừng	cɯŋ˧˨
chững	cɯŋ˨˩˦
chuốc	cuək˦˥
chuộc	cuək˨˩˨
chước	cɯək˦˥
chuôi	cuəj˧˧
chuôi	cuəj˧˧
chuối	cuəj˦˥
chuồi	cuəj˧˨
chuỗi	cuəj˨˩˦
chuội	cuəj˨˩˨
chuôm	cum˧˧
chuồn	cuəŋ˧˨
chuông	cuəŋ˧˧
chuồng	cuəŋ˧˨
chuộng	cuəŋ˨˩˨
chương	cɯəŋ˧˧
chướng	cɯəŋ˦˥
chưởng	cɯəŋ˨˩˦
chuốt	cuək˦˥
chuột	cuək˨˩˨
chụp	cup˨˩˨
chút	cukp˦˥
chụt	cukp˨˩˨
chuyên	cwiəŋ˧˧
chuyến	cwiəŋ˦˥
chuyền	cwiəŋ˧˨
chuyển	cwiəŋ˨˩˦
chuyện	cwiəŋ˨˩˨
cốc	kokp˦˥
cốc	kokp˦˥
cộc	kokp˨˩˨
cóc	kɔkp˦˥
cọc	kɔkp˨˩˨
cô-đê	ko˧˧-de˧˧
cơi	kɤj˧˧
cời	kɤj˧˨
cởi	kɤj˨˩˦
côi	koj˧˧
cối	koj˦˥
cỗi	koj˨˩˦
cổi	koj˨˩˦
cội	koj˨˩˨
coi	kɔj˧˧
cói	kɔj˦˥
còi	kɔj˧˨
cõi	kɔj˨˩˦
cơ	kɤ˧˧
cớ	kɤ˦˥
cờ	kɤ˧˨
cô	ko˧˧
cố	ko˦˥
cồ	ko˧˨
cỗ	ko˨˩˦
cổ	ko˨˩˦
cổ	ko˨˩˦
co	kɔ˧˧
có	kɔ˦˥
cò	kɔ˧˨
cỏ	kɔ˨˩˦
cọ	kɔ˨˩˨
cơm	kɤm˧˧
côm	kom˧˧
cốm	kom˦˥
cồm	kom˧˨
com	kɔm˧˧
cóm	kɔm˦˥
còm	kɔm˧˨
cỏm	kɔm˨˩˦
cọm	kɔm˨˩˨
công	koŋm˧˧
cống	koŋm˦˥
cồng	koŋm˧˨
cổng	koŋm˨˩˦
cộng	koŋm˨˩˨
cong	kɔŋm˧˧
cóng	kɔŋm˦˥
còng	kɔŋm˧˨
cõng	kɔŋm˨˩˦
cỏng	kɔŋm˨˩˦
công-xinh	koŋm˧˧-sin˧˧
cơn	kɤŋ˧˧
cớn	kɤŋ˦˥
cờn	kɤŋ˧˨
cỡn	kɤŋ˨˩˦
côn	koŋm˧˧
cồn	koŋm˧˨
cổn	koŋm˨˩˦
con	kɔŋm˧˧
còn	kɔŋm˧˨
cỏn	kɔŋm˨˩˦
coóc	kɔkp˦˥
cốp	kop˦˥
cóp	kɔp˦˥
cọp	kɔp˨˩˨
cớt	kɤk˦˥
cợt	kɤk˨˩˨
cốt	kokp˦˥
cột	kokp˨˩˨
cót	kɔkp˦˥
cọt	kɔkp˨˩˨
cua	kuə˧˧
của	kuə˨˩˦
của	kuə˨˩˦
cưa	kɯə˧˧
cứa	kɯə˦˥
cửa	kɯə˨˩˦
cựa	kɯə˨˩˨
cúc	kukp˦˥
cục	kukp˨˩˨
cức	kɯk˦˥
cực	kɯk˨˩˨
cui	kuj˧˧
cúi	kuj˦˥
cùi	kuj˧˨
cũi	kuj˨˩˦
củi	kuj˨˩˦
cụi	kuj˨˩˨
cửi	kɯj˨˩˦
cu	ku˧˧
cú	ku˦˥
cù	ku˧˨
cũ	ku˨˩˦
củ	ku˨˩˦
cụ	ku˨˩˨
cư	kɯ˧˧
cứ	kɯ˦˥
cừ	kɯ˧˨
cử	kɯ˨˩˦
cự	kɯ˨˩˨
cum	kum˧˧
cúm	kum˦˥
cùm	kum˧˨
cụm	kum˨˩˨
cung	kuŋm˧˧
cúng	kuŋm˦˥
cùng	kuŋm˧˨
cũng	kuŋm˨˩˦
củng	kuŋm˨˩˦
cụng	kuŋm˨˩˨
cưng	kɯŋ˧˧
cứng	kɯŋ˦˥
cun	kuŋm˧˧
cùn	kuŋm˧˨
cũn	kuŋm˨˩˦
cuốc	kuək˦˥
cuộc	kuək˨˩˨
cước	kɯək˦˥
cuối	kuəj˦˥
cuội	kuəj˨˩˨
cưới	kɯəj˦˥
cười	kɯəj˧˨
cưỡi	kɯəj˨˩˦
cườm	kɯm˧˨
cuống	kuəŋ˦˥
cuồng	kuəŋ˧˨
cuộng	kuəŋ˨˩˨
cương	kɯəŋ˧˧
cường	kɯəŋ˧˨
cưỡng	kɯəŋ˨˩˦
cuốn	kuəŋ˦˥
cuồn	kuəŋ˧˨
cuộn	kuəŋ˨˩˨
cướp	kɯp˦˥
cúp	kup˦˥
cụp	kup˨˩˨
cút	kukp˦˥
cụt	kukp˨˩˨
cứt	kɯk˦˥
cưu	kɯw˧˧
cứu	kɯw˦˥
cừu	kɯw˧˨
cửu	kɯw˨˩˦
cựu	kɯw˨˩˨
đắc	dăk˦˥
đắc	dăk˦˥
đắc	dăk˦˥
đạc	dak˨˩˨
đặc	dăk˨˩˨
đách	dat˦˥
dạc	jak˨˩˨
dặc	jăk˨˩˨
đa	da˧˧
đa	da˧˧
đá	da˦˥
đà	da˧˨
đà	da˧˨
đà	da˧˨
đà	da˧˨
đã	da˨˩˦
đả	da˨˩˦
đai	daj˧˧
đái	daj˦˥
đài	daj˧˨
đãi	daj˨˩˦
đại	daj˨˩˨
đại	daj˨˩˨
đại	daj˨˩˨
đại	daj˨˩˨
đại	daj˨˩˨
đại	daj˨˩˨
đại	daj˨˩˨
đại	daj˨˩˨
đại	daj˨˩˨
dai	jaj˧˧
dái	jaj˦˥
dài	jaj˧˨
dãi	jaj˨˩˦
dải	jaj˨˩˦
dại	jaj˨˩˨
da	ja˧˧
dà	ja˧˨
dã	ja˨˩˦
dạ	ja˨˩˨
dạ	ja˨˩˨
đam	dam˧˧
đám	dam˦˥
đàm	dam˧˨
đăm	dăm˧˧
đắm	dăm˦˥
đằm	dăm˧˨
đẵm	dăm˨˩˦
đảm	dam˨˩˦
đạm	dam˨˩˨
đặm	dăm˨˩˨
đâm	dɤ̆m˧˧
đấm	dɤ̆m˦˥
đầm	dɤ̆m˧˨
đẫm	dɤ̆m˨˩˦
đậm	dɤ̆m˨˩˨
dám	jam˦˥
dăm	jăm˧˧
dắm	jăm˦˥
dạm	jam˨˩˨
dặm	jăm˨˩˨
dâm	jɤ̆m˧˧
dấm	jɤ̆m˦˥
dầm	jɤ̆m˧˨
dẫm	jɤ̆m˨˩˦
dậm	jɤ̆m˨˩˨
đan	daŋ˧˧
đan	daŋ˧˧
đan	daŋ˧˧
đàn	daŋ˧˨
đắn	dăŋ˦˥
đản	daŋ˨˩˦
đạn	daŋ˨˩˨
đần	dɤ̆ŋ˧˨
đẫn	dɤ̆ŋ˨˩˦
đận	dɤ̆ŋ˨˩˨
đang	daŋ˧˧
đáng	daŋ˦˥
đàng	daŋ˧˨
đăng	dăŋ˧˧
đăng	dăŋ˧˧
đắng	dăŋ˦˥
đằng	dăŋ˧˨
đẳng	dăŋ˨˩˦
đãng	daŋ˨˩˦
đảng	daŋ˨˩˦
đảng	daŋ˨˩˦
đảng	daŋ˨˩˦
đấng	dɤ̆ŋ˦˥
dang	jaŋ˧˧
dáng	jaŋ˦˥
dàng	jaŋ˧˨
dăng	jăŋ˧˧
dằng	jăŋ˧˨
dằng	jăŋ˧˨
dẳng	jăŋ˨˩˦
dạng	jaŋ˨˩˨
dặng	jăŋ˨˩˨
dâng	jɤ̆ŋ˧˧
đanh	dan˧˧
đánh	dan˦˥
đánh	dan˦˥
đánh	dan˦˥
đành	dan˧˨
danh	jan˧˧
dành	jan˧˨
dan	jaŋ˧˧
dán	jaŋ˦˥
dàn	jaŋ˧˨
dăn	jăŋ˧˧
dằn	jăŋ˧˨
dẳn	jăŋ˨˩˦
dãn	jaŋ˨˩˦
dạn	jaŋ˨˩˨
dặn	jăŋ˨˩˨
dân	jɤ̆ŋ˧˧
dân	jɤ̆ŋ˧˧
dấn	jɤ̆ŋ˦˥
dần	jɤ̆ŋ˧˨
dẫn	jɤ̆ŋ˨˩˦
dận	jɤ̆ŋ˨˩˨
đao	daw˧˧
đáo	daw˦˥
đào	daw˧˨
đảo	daw˨˩˦
đảo	daw˨˩˦
đạo	daw˨˩˨
đạo	daw˨˩˨
đạo	daw˨˩˨
dao	jaw˧˧
dáo	jaw˦˥
dào	jaw˧˨
dạo	jaw˨˩˨
đáp	dap˦˥
đắp	dăp˦˥
đạp	dap˨˩˨
đập	dɤ̆p˨˩˨
dấp	jɤ̆p˦˥
dập	jɤ̆p˨˩˨
đắt	dăk˦˥
đặt	dăk˨˩˨
đạt	dat˨˩˨
đất	dɤ̆k˦˥
đất	dɤ̆k˦˥
đất	dɤ̆k˦˥
dắt	jăk˦˥
dặt	jăk˨˩˨
dát	jat˦˥
dạt	jat˨˩˨
dật	jɤ̆k˨˩˨
đạt-lai	dat˨˩˨-laj˧˧
đau	dăw˧˧
đâu	dɤ̆w˧˧
đấu	dɤ̆w˦˥
đầu	dɤ̆w˧˨
đẩu	dɤ̆w˨˩˦
đậu	dɤ̆w˨˩˨
dáu	jăw˦˥
dàu	jăw˧˨
dâu	jɤ̆w˧˧
dấu	jɤ̆w˦˥
dầu	jɤ̆w˧˨
dẫu	jɤ̆w˨˩˦
dậu	jɤ̆w˨˩˨
đay	dăj˧˧
đáy	dăj˦˥
đày	dăj˧˨
đây	dɤ̆j˧˧
đấy	dɤ̆j˦˥
đầy	dɤ̆j˧˨
đẫy	dɤ̆j˨˩˦
đẩy	dɤ̆j˨˩˦
đậy	dɤ̆j˨˩˨
day	jăj˧˧
dày	jăj˧˨
dãy	jăj˨˩˦
dảy	jăj˨˩˦
dạy	jăj˨˩˨
dây	jɤ̆j˧˧
dấy	jɤ̆j˦˥
dẫy	jɤ̆j˨˩˦
dậy	jɤ̆j˨˩˨
đếch	det˦˥
đê	de˧˧
đế	de˦˥
đế	de˦˥
đế	de˦˥
đề	de˧˨
để	de˨˩˦
đệ	de˨˩˨
đệ	de˨˩˨
đe	dɛ˧˧
đè	dɛ˧˨
đẻ	dɛ˨˩˦
dê	je˧˧
dế	je˦˥
dề	je˧˨
dễ	je˨˩˦
dể	je˨˩˦
de	jɛ˧˧
dé	jɛ˦˥
dè	jɛ˧˨
dẽ	jɛ˨˩˦
dẻ	jɛ˨˩˦
đêm	dem˧˧
đếm	dem˦˥
đệm	dem˨˩˨
đem	dɛm˧˧
đèm	dɛm˧˨
đến	den˦˥
đền	den˧˨
đền	den˧˨
đền	den˧˨
đen	dɛŋ˧˧
đèn	dɛŋ˧˨
đèn	dɛŋ˧˨
đèn	dɛŋ˧˨
đẹn	dɛŋ˨˩˨
đềnh	den˧˨
đễnh	den˨˩˦
đểnh	den˨˩˦
dềnh	jen˧˨
dệnh	jen˨˩˨
dền	jen˧˨
dèn	jɛŋ˧˨
đeo	deo˧˧
đéo	deo˦˥
đèo	deo˧˨
đẽo	deo˨˩˦
deo	jeo˧˧
dẻo	jeo˨˩˦
đẹp	dɛp˨˩˨
dép	jɛp˦˥
dẹp	jɛp˨˩˨
đẹt	dɛt˨˩˨
dệt	jet˨˩˨
dẹt	jɛt˨˩˨
đều	dɛu˧˨
đểu	dɛu˨˩˦
đĩa	diə˨˩˦
đỉa	diə˨˩˦
đỉa	diə˨˩˦
địa	diə˨˩˨
địa	diə˨˩˨
địa	diə˨˩˨
đích	dit˦˥
địch	dit˨˩˨
dích	jit˦˥
dịch	jit˨˩˨
đi	di˧˧
đí	di˦˥
đì	di˧˨
đĩ	di˨˩˦
điếc	diək˦˥
diếc	jiək˦˥
diệc	jiək˨˩˨
điếm	dim˦˥
điềm	dim˧˨
điểm	dim˨˩˦
diêm	jim˧˧
diềm	jim˧˨
diễm	jim˨˩˦
diệm	jim˨˩˨
điên	diəŋ˧˧
điền	diəŋ˧˨
điển	diəŋ˨˩˦
điện	diəŋ˨˩˨
diên	jiəŋ˧˧
diễn	jiəŋ˨˩˦
diện	jiəŋ˨˩˨
điệp	dip˨˩˨
diếp	jip˦˥
diệp	jip˨˩˨
diệt	jiək˨˩˨
điêu	diəw˧˧
điêu	diəw˧˧
điêu	diəw˧˧
điêu	diəw˧˧
điêu	diəw˧˧
điếu	diəw˦˥
điều	diəw˧˨
điểu	diəw˨˩˦
điệu	diəw˨˩˨
diều	jiəw˧˨
diễu	jiəw˨˩˦
diệu	jiəw˨˩˨
di	ji˧˧
dí	ji˦˥
dì	ji˧˨
dĩ	ji˨˩˦
dỉ	ji˨˩˦
dị	ji˨˩˨
đinh	din˧˧
đính	din˦˥
đình	din˧˨
đình	din˧˨
đình	din˧˨
đình	din˧˨
đình	din˧˨
đình	din˧˨
đình	din˧˨
đình	din˧˨
đình	din˧˨
đĩnh	din˨˩˦
đỉnh	din˨˩˦
định	din˨˩˨
định	din˨˩˨
định	din˨˩˨
định	din˨˩˨
dinh	jin˧˧
dính	jin˦˥
dĩnh	jin˨˩˦
díp	jip˦˥
dịp	jip˨˩˨
đít	dit˦˥
địt	dit˨˩˨
đìu	diw˧˨
díu	jiw˦˥
dìu	jiw˧˨
dịu	jiw˨˩˨
đoạ	dwa˨˩˨
đọa	dwa˨˩˨
đoái	dwaj˦˥
doạ	jwa˨˩˨
dọa	jwa˨˩˨
đoan	dwaŋ˧˧
đoan	dwaŋ˧˧
đoan	dwaŋ˧˧
đoan	dwaŋ˧˧
đoan	dwaŋ˧˧
đoan	dwaŋ˧˧
đoan	dwaŋ˧˧
đoán	dwaŋ˦˥
đoàn	dwaŋ˧˨
đoàn	dwaŋ˧˨
đoản	dwaŋ˨˩˦
đoạn	dwaŋ˨˩˨
đoàng	dwaŋ˧˨
đoàng	dwaŋ˧˨
đoảng	dwaŋ˨˩˦
đoành	dwan˧˨
doanh	jwan˧˧
đoạt	dwat˨˩˨
đốc	dokp˦˥
đốc	dokp˦˥
đốc	dokp˦˥
độc	dokp˨˩˨
đọc	dɔkp˨˩˨
dốc	jokp˦˥
dóc	jɔkp˦˥
dọc	jɔkp˨˩˨
đốc-tơ	dokp˦˥-tɤ˧˧
đớ	dɤ˦˥
đờ	dɤ˧˨
đỡ	dɤ˨˩˦
đợ	dɤ˨˩˨
đô	do˧˧
đố	do˦˥
đồ	do˧˨
đỗ	do˨˩˦
đổ	do˨˩˦
"độ	do˨˩˨
độ	do˨˩˨
độ	do˨˩˨
độ	do˨˩˨
độ	do˨˩˨
độ	do˨˩˨
đo	dɔ˧˧
đó	dɔ˦˥
đò	dɔ˧˨
đỏ	dɔ˨˩˦
đọ	dɔ˨˩˨
đới	dɤj˦˥
đời	dɤj˧˨
đời	dɤj˧˨
đợi	dɤj˨˩˨
đôi	doj˧˧
đôi	doj˧˧
đôi	doj˧˧
đối	doj˦˥
đồi	doj˧˨
đổi	doj˨˩˦
đội	doj˨˩˨
đoi	dɔj˧˧
đói	dɔj˦˥
đòi	dɔj˧˨
đọi	dɔj˨˩˨
dơi	jɤj˧˧
dời	jɤj˧˨
dôi	joj˧˧
dối	joj˦˥
dồi	joj˧˨
dội	joj˨˩˨
doi	jɔj˧˧
dòi	jɔj˧˨
dõi	jɔj˨˩˦
dơ	jɤ˧˧
dớ	jɤ˦˥
dỡ	jɤ˨˩˦
dở	jɤ˨˩˦
dô	jo˧˧
dỗ	jo˨˩˦
do	jɔ˧˧
dó	jɔ˦˥
dò	jɔ˧˨
dọ	jɔ˨˩˨
đơm	dɤm˧˧
đởm	dɤm˨˩˦
đôm	dom˧˧
đốm	dom˦˥
đồm	dom˧˨
đom	dɔm˧˧
đóm	dɔm˦˥
đòm	dɔm˧˨
đỏm	dɔm˨˩˦
đờ-mi	dɤ˧˨-mi˧˧
dòm	jɔm˧˨
đơn	dɤŋ˧˧
đớn	dɤŋ˦˥
đờn	dɤŋ˧˨
đôn	doŋm˧˧
đôn	doŋm˧˧
đốn	doŋm˦˥
đồn	doŋm˧˨
độn	doŋm˨˩˨
đon	dɔŋm˧˧
đón	dɔŋm˦˥
đòn	dɔŋm˧˨
đông	doŋm˧˧
đông	doŋm˧˧
đông	doŋm˧˧
đông	doŋm˧˧
đông	doŋm˧˧
đống	doŋm˦˥
đồng	doŋm˧˨
đổng	doŋm˨˩˦
đổng	doŋm˨˩˦
động	doŋm˨˩˨
đong	dɔŋm˧˧
đóng	dɔŋm˦˥
đòng	dɔŋm˧˨
đỏng	dɔŋm˨˩˦
đọng	dɔŋm˨˩˨
dông	joŋm˧˧
dồng	joŋm˧˨
dộng	joŋm˨˩˨
dong	jɔŋm˧˧
dong	jɔŋm˧˧
dóng	jɔŋm˦˥
dòng	jɔŋm˧˨
dõng	jɔŋm˨˩˦
đông-nam	doŋm˧˧-nam˧˧
dớn	jɤŋ˦˥
dờn	jɤŋ˧˨
dồn	joŋm˧˨
dọn	jɔŋm˨˩˨
đớp	dɤp˦˥
đốp	dop˦˥
độp	dop˨˩˨
đốt	dokp˦˥
đột	dokp˨˩˨
dốt	jokp˦˥
dột	jokp˨˩˨
đua	duə˧˧
đùa	duə˧˨
đũa	duə˨˩˦
đũa	duə˨˩˦
đưa	dɯə˧˧
đứa	dɯə˦˥
dua	juə˧˧
dưa	jɯə˧˧
dứa	jɯə˦˥
dừa	jɯə˧˨
dựa	jɯə˨˩˨
duật	jwɤ̆k˨˩˨
đúc	dukp˦˥
đục	dukp˨˩˨
đức	dɯk˦˥
đức	dɯk˦˥
đức	dɯk˦˥
đức	dɯk˦˥
đức	dɯk˦˥
đực	dɯk˨˩˨
dục	jukp˨˩˨
dức	jɯk˦˥
đu	du˧˧
đú	du˦˥
đù	du˧˨
đủ	du˨˩˦
đụ	du˨˩˨
đứ	dɯ˦˥
đử	dɯ˨˩˦
đuềnh	dwen˧˨
đuễnh	dwen˨˩˦
đuểnh	dwen˨˩˦
duềnh	jwen˧˨
đui	duj˧˧
đùi	duj˧˨
dúi	juj˦˥
dùi	juj˧˨
du	ju˧˧
dù	ju˧˨
dũ	ju˨˩˦
dụ	ju˨˩˨
dư	jɯ˧˧
dừ	jɯ˧˨
dừ	jɯ˧˨
dữ	jɯ˨˩˦
dử	jɯ˨˩˦
dự	jɯ˨˩˨
đum	dum˧˧
đùm	dum˧˨
dúm	jum˦˥
dụm	jum˨˩˨
đun	duŋm˧˧
đún	duŋm˦˥
đùn	duŋm˧˨
đụn	duŋm˨˩˨
đung	duŋm˧˧
đúng	duŋm˦˥
đùng	duŋm˧˨
đũng	duŋm˨˩˦
đủng	duŋm˨˩˦
đụng	duŋm˨˩˨
đứng	dɯŋ˦˥
đừng	dɯŋ˧˨
đựng	dɯŋ˨˩˨
dung	juŋm˧˧
dúng	juŋm˦˥
dùng	juŋm˧˨
dũng	juŋm˨˩˦
dụng	juŋm˨˩˨
dưng	jɯŋ˧˧
dừng	jɯŋ˧˨
dửng	jɯŋ˨˩˦
dựng	jɯŋ˨˩˨
dun	juŋm˧˧
dún	juŋm˦˥
đuốc	duək˦˥
được	dɯək˨˩˨
duốc	juək˦˥
dược	jɯək˨˩˨
đuôi	duəj˧˧
đuối	duəj˦˥
đuổi	duəj˨˩˦
đười	dɯəj˧˨
duỗi	juəj˨˩˦
dưới	jɯəj˦˥
đượm	dɯm˨˩˨
đuồn	duəŋ˧˨
đườn	dɯəŋ˧˨
đương	dɯəŋ˧˧
đường	dɯəŋ˧˨
đường	dɯəŋ˧˨
đường	dɯəŋ˧˨
đường	dɯəŋ˧˨
đường	dɯəŋ˧˨
đường	dɯəŋ˧˨
đường	dɯəŋ˧˨
đường	dɯəŋ˧˨
đường	dɯəŋ˧˨
dương	jɯəŋ˧˧
dường	jɯəŋ˧˨
dưỡng	jɯəŋ˨˩˦
đút	dukp˦˥
đứt	dɯk˦˥
dút	jukp˦˥
dứt	jɯk˦˥
duyên	jwiəŋ˧˧
duyệt	jwiək˨˩˨
duy	jwi˧˧
éc	ɛk˦˥
ẹc	ɛk˨˩˨
ếch	et˦˥
ê	e˧˧
ế	e˦˥
ề	e˧˨
e	ɛ˧˧
é	ɛ˦˥
è	ɛ˧˨
ẹ	ɛ˨˩˨
êm	em˧˧
êm	em˧˧
êm	em˧˧
em	ɛm˧˧
ém	ɛm˦˥
en	ɛŋ˧˧
én	ɛŋ˦˥
ễng	en˨˩˦
eng	ɛŋ˧˧
èng	ɛŋ˧˨
ềnh	en˧˨
ễnh	en˨˩˦
eo	eo˧˧
éo	eo˦˥
èo	eo˧˨
ẽo	eo˨˩˦
ẻo	eo˨˩˦
ẹo	eo˨˩˨
ép	ɛp˦˥
ét	ɛt˦˥
êu	ɛu˧˧
gác	ɣak˦˥
gạc	ɣak˨˩˨
gặc	ɣăk˨˩˨
gạch	ɣat˨˩˨
ga	ɣa˧˧
gá	ɣa˦˥
gà	ɣa˧˨
gả	ɣa˨˩˦
gạ	ɣa˨˩˨
gai	ɣaj˧˧
gái	ɣaj˦˥
gài	ɣaj˧˨
gãi	ɣaj˨˩˦
găm	ɣăm˧˧
gắm	ɣăm˦˥
gằm	ɣăm˧˨
gặm	ɣăm˨˩˨
gâm	ɣɤ̆m˧˧
gấm	ɣɤ̆m˦˥
gầm	ɣɤ̆m˧˨
gậm	ɣɤ̆m˨˩˨
gang	ɣaŋ˧˧
găng	ɣăŋ˧˧
gắng	ɣăŋ˦˥
gặng	ɣăŋ˨˩˨
gan	ɣaŋ˧˧
gán	ɣaŋ˦˥
gàn	ɣaŋ˧˨
găn	ɣăŋ˧˧
gắn	ɣăŋ˦˥
gằn	ɣăŋ˧˨
gạn	ɣaŋ˨˩˨
gân	ɣɤ̆ŋ˧˧
gần	ɣɤ̆ŋ˧˨
ganh	ɣan˧˧
gánh	ɣan˦˥
gáo	ɣaw˦˥
gào	ɣaw˧˨
gạo	ɣaw˨˩˨
gắp	ɣăp˦˥
gặp	ɣăp˨˩˨
gấp	ɣɤ̆p˦˥
gập	ɣɤ̆p˨˩˨
gắt	ɣăk˦˥
gặt	ɣăk˨˩˨
gạt	ɣat˨˩˨
gật	ɣɤ̆k˨˩˨
gau	ɣăw˧˧
gàu	ɣăw˧˨
gâu	ɣɤ̆w˧˧
gấu	ɣɤ̆w˦˥
gầu	ɣɤ̆w˧˨
gẫu	ɣɤ̆w˨˩˦
gay	ɣăj˧˧
gáy	ɣăj˦˥
gày	ɣăj˧˨
gãy	ɣăj˨˩˦
gảy	ɣăj˨˩˦
gây	ɣɤ̆j˧˧
gấy	ɣɤ̆j˦˥
gầy	ɣɤ̆j˧˨
gẫy	ɣɤ̆j˨˩˦
gẩy	ɣɤ̆j˨˩˦
gậy	ɣɤ̆j˨˩˨
ghê	ɣe˧˧
ghế	ɣe˦˥
ghe	ɣɛ˧˧
ghé	ɣɛ˦˥
ghè	ɣɛ˧˨
ghẻ	ɣɛ˨˩˦
ghẹ	ɣɛ˨˩˨
ghen	ɣɛŋ˧˧
ghèn	ɣɛŋ˧˨
ghểnh	ɣen˨˩˦
ghẹo	ɣeo˨˩˨
ghép	ɣɛp˦˥
ghét	ɣɛt˦˥
ghiền	ɣiəŋ˧˨
ghi	ɣi˧˧
ghim	ɣim˧˧
giác	jak˦˥
giạc	jak˨˩˨
giặc	jăk˨˩˨
giấc	jɤ̆k˦˥
giai	jaj˧˧
giãi	jaj˨˩˦
giải	jaj˨˩˦
gia	ja˧˧
giá	ja˦˥
già	ja˧˨
giã	ja˨˩˦
giả	ja˨˩˦
giả	ja˨˩˦
giam	jam˧˧
giám	jam˦˥
giăm	jăm˧˧
giắm	jăm˦˥
giảm	jam˨˩˦
giấm	jɤ̆m˦˥
giầm	jɤ̆m˧˨
giẫm	jɤ̆m˨˩˦
giậm	jɤ̆m˨˩˨
giang	jaŋ˧˧
giáng	jaŋ˦˥
giàng	jaŋ˧˨
giăng	jăŋ˧˧
giắng	jăŋ˦˥
giằng	jăŋ˧˨
giảng	jaŋ˨˩˦
giạng	jaŋ˨˩˨
giành	jan˧˨
gian	jaŋ˧˧
gián	jaŋ˦˥
giàn	jaŋ˧˨
giằn	jăŋ˧˨
giãn	jaŋ˨˩˦
giản	jaŋ˨˩˦
giấn	jɤ̆ŋ˦˥
giần	jɤ̆ŋ˧˨
giận	jɤ̆ŋ˨˩˨
giao	jaw˧˧
giáo	jaw˦˥
giảo	jaw˨˩˦
giáp	jap˦˥
giấp	jɤ̆p˦˥
giập	jɤ̆p˨˩˨
giắt	jăk˦˥
giặt	jăk˨˩˨
giát	jat˦˥
giạt	jat˨˩˨
giật	jɤ̆k˨˩˨
giau	jăw˧˧
giàu	jăw˧˨
giảu	jăw˨˩˦
giâu	jɤ̆w˧˧
giấu	jɤ̆w˦˥
giầu	jɤ̆w˧˨
giậu	jɤ̆w˨˩˨
giày	jăj˧˨
giãy	jăj˨˩˦
giây	jɤ̆j˧˧
giấy	jɤ̆j˦˥
giầy	jɤ̆j˧˨
giẫy	jɤ̆j˨˩˦
giếc	jet˦˥
giẻ	jɛ˨˩˦
gièm	jɛm˧˨
giêng	jen˧˧
giếng	jen˦˥
giềng	jen˧˨
giền	jen˧˨
gieo	jeo˧˧
giéo	jeo˦˥
giẹo	jeo˨˩˨
giẹp	jɛp˨˩˨
giết	jet˦˥
giễu	jɛu˨˩˦
gì	ɣi˧˨
gỉ	ɣi˨˩˦
gi	ji˧˧
gìn	zin˧˨
giới	jɤj˦˥
giời	jɤj˧˨
giối	joj˦˥
giồi	joj˧˨
giội	joj˨˩˨
giòi	jɔj˧˨
giỏi	jɔj˨˩˦
giơ	jɤ˧˧
giờ	jɤ˧˨
giở	jɤ˨˩˦
giỗ	jo˨˩˦
gio	jɔ˧˧
gió	jɔ˦˥
gió	jɔ˦˥
giò	jɔ˧˨
giỏ	jɔ˨˩˦
giông	joŋm˧˧
giống	joŋm˦˥
giồng	joŋm˧˨
giong	jɔŋm˧˧
gióng	jɔŋm˦˥
giỏng	jɔŋm˨˩˦
giọng	jɔŋm˨˩˨
giôn	joŋm˧˧
gion	jɔŋm˧˧
giòn	jɔŋm˧˨
giọt	jɔkp˨˩˨
giũa	juə˨˩˦
giữa	jɯə˨˩˦
giục	jukp˨˩˨
giúi	juj˦˥
giùi	juj˧˨
giu	ju˧˧
giũ	ju˨˩˦
giữ	jɯ˨˩˦
giùm	jum˧˨
giun	juŋm˧˧
giương	jɯəŋ˧˧
giường	jɯəŋ˧˨
giúp	jup˦˥
goá	ɣwa˦˥
góa	ɣwa˦˥
gốc	ɣokp˦˥
góc	ɣɔkp˦˥
gờ	ɣɤ˧˨
gỡ	ɣɤ˨˩˦
gở	ɣɤ˨˩˦
gô	ɣo˧˧
gồ	ɣo˧˨
gỗ	ɣo˨˩˦
gò	ɣɔ˧˨
gõ	ɣɔ˨˩˦
gọ	ɣɔ˨˩˨
gởi	ɣɤj˨˩˦
gợi	ɣɤj˨˩˨
gối	ɣoj˦˥
gội	ɣoj˨˩˨
gói	ɣɔj˦˥
gỏi	ɣɔj˨˩˦
gọi	ɣɔj˨˩˨
gớm	ɣɤm˦˥
gờm	ɣɤm˧˨
gôm	ɣom˧˧
gom	ɣɔm˧˧
gông	ɣoŋm˧˧
gồng	ɣoŋm˧˨
gọng	ɣɔŋm˨˩˨
gòn-gia	ɣɔŋm˧˨-ja˧˧
gờn	ɣɤŋ˧˨
gợn	ɣɤŋ˨˩˨
gòn	ɣɔŋm˧˨
gọn	ɣɔŋm˨˩˨
goòng	ɣɔŋm˧˨
gộp	ɣop˨˩˨
góp	ɣɔp˦˥
gột	ɣokp˨˩˨
gót	ɣɔkp˦˥
gọt	ɣɔkp˨˩˨
gục	ɣukp˨˩˨
gừ	ɣɯ˧˨
gửi	ɣɯj˨˩˦
gừng	ɣɯŋ˧˨
gùn	ɣuŋm˧˨
guốc	ɣuək˦˥
gươm	ɣɯm˧˧
gườm	ɣɯm˧˨
guồng	ɣuəŋ˧˨
gương	ɣɯəŋ˧˧
gường	ɣɯəŋ˧˨
gượng	ɣɯəŋ˨˩˨
guột	ɣuək˨˩˨
gút	ɣukp˦˥
hắc	hăk˦˥
hạc	hak˨˩˨
hặc	hăk˨˩˨
hách	hat˦˥
hạch	hat˨˩˨
hà-đông	ha˧˨-doŋm˧˧
ha	ha˧˧
há	ha˦˥
hà	ha˧˨
hả	ha˨˩˦
hạ	ha˨˩˨
hai	haj˧˧
hái	haj˦˥
hài	haj˧˨
hãi	haj˨˩˦
hải	haj˨˩˦
hại	haj˨˩˨
ham	ham˧˧
hám	ham˦˥
hàm	ham˧˨
hăm	hăm˧˧
hằm	hăm˧˨
hãm	ham˨˩˦
hạm	ham˨˩˨
hặm	hăm˨˩˨
hâm	hɤ̆m˧˧
hấm	hɤ̆m˦˥
hầm	hɤ̆m˧˨
hẩm	hɤ̆m˨˩˦
hậm	hɤ̆m˨˩˨
hang	haŋ˧˧
hàng	haŋ˧˨
hăng	hăŋ˧˧
hắng	hăŋ˦˥
hằng	hăŋ˧˨
hãng	haŋ˨˩˦
hạng	haŋ˨˩˨
hẫng	hɤ̆ŋ˨˩˦
han	haŋ˧˧
hán	haŋ˦˥
hàn	haŋ˧˨
hắn	hăŋ˦˥
hằn	hăŋ˧˨
hẳn	hăŋ˨˩˦
hãn	haŋ˨˩˦
hạn	haŋ˨˩˨
hân	hɤ̆ŋ˧˧
hấn	hɤ̆ŋ˦˥
hận	hɤ̆ŋ˨˩˨
hanh	han˧˧
hánh	han˦˥
hành	han˧˨
hãnh	han˨˩˦
hạnh	han˨˩˨
hao	haw˧˧
háo	haw˦˥
hào	haw˧˨
hão	haw˨˩˦
hảo	haw˨˩˦
hạo	haw˨˩˨
hạp	hap˨˩˨
hấp	hɤ̆p˦˥
hắt	hăk˦˥
hát	hat˦˥
hạt	hat˨˩˨
hất	hɤ̆k˦˥
hau	hăw˧˧
háu	hăw˦˥
hầu	hɤ̆w˧˨
hẩu	hɤ̆w˨˩˦
hậu	hɤ̆w˨˩˨
hay	hăj˧˧
háy	hăj˦˥
hãy	hăj˨˩˦
hây	hɤ̆j˧˧
héc	hɛk˦˥
hếch	het˦˥
hệch	het˨˩˨
hề	he˧˨
hể	he˨˩˦
hệ	he˨˩˨
hé	hɛ˦˥
hè	hɛ˧˨
hèm	hɛm˧˨
hẻm	hɛm˨˩˦
hên	hen˧˧
hen	hɛŋ˧˧
hèn	hɛŋ˧˨
hẹn	hɛŋ˨˩˨
hênh	hen˧˧
hềnh	hen˧˨
hểnh	hen˨˩˦
heo	heo˧˧
héo	heo˦˥
hèo	heo˧˨
hẻo	heo˨˩˦
hẹp	hɛp˨˩˨
hết	het˦˥
hét	hɛt˦˥
hểu	hɛu˨˩˦
hịch	hit˨˩˨
hiếm	him˦˥
hiềm	him˧˨
hiểm	him˨˩˦
hiêng	hiəŋ˧˧
hiên	hiəŋ˧˧
hiến	hiəŋ˦˥
hiền	hiəŋ˧˨
hiển	hiəŋ˨˩˦
hiện	hiəŋ˨˩˨
hiếp	hip˦˥
hiệp	hip˨˩˨
hiếu	hiəw˦˥
hiểu	hiəw˨˩˦
hiệu	hiəw˨˩˨
hi	hi˧˧
hí	hi˦˥
hì	hi˧˨
hỉ	hi˨˩˦
him	him˧˧
hinh	hin˧˧
hình	hin˧˨
hỉnh	hin˨˩˦
híp	hip˦˥
hít	hit˦˥
hiu	hiw˧˧
hoạch	hwat˨˩˨
hoác	hwak˦˥
hoắc	hwăk˦˥
hoặc	hwăk˨˩˨
hoa	hwa˧˧
hoá	hwa˦˥
hoà	hwa˧˨
hoả	hwa˨˩˦
hoạ	hwa˨˩˨
hóa	hwa˦˥
hòa	hwa˧˨
hỏa	hwa˨˩˦
họa	hwa˨˩˨
hoài	hwaj˧˨
hoải	hwaj˨˩˦
hoại	hwaj˨˩˨
hoăm	hwăm˧˧
hoắm	hwăm˦˥
hoang	hwaŋ˧˧
hoàng	hwaŋ˧˨
hoăng	hwăŋ˧˧
hoảng	hwaŋ˨˩˦
hoành	hwan˧˨
hoạnh	hwan˨˩˨
hoan	hwaŋ˧˧
hoán	hwaŋ˦˥
hoàn	hwaŋ˧˨
hoãn	hwaŋ˨˩˦
hoạn	hwaŋ˨˩˨
hoặn	hwăŋ˨˩˨
hoạt	hwat˨˩˨
hoay	hwăj˧˧
hốc	hokp˦˥
hộc	hokp˨˩˨
hóc	hɔkp˦˥
học	hɔkp˨˩˨
hoe	hwe˧˧
hoè	hwe˧˨
hoen	hwen˧˧
hơ	hɤ˧˧
hớ	hɤ˦˥
hờ	hɤ˧˨
hở	hɤ˨˩˦
hô	ho˧˧
hố	ho˦˥
hồ	ho˧˨
hỗ	ho˨˩˦
hổ	ho˨˩˦
hộ	ho˨˩˨
ho	hɔ˧˧
hó	hɔ˦˥
hò	hɔ˧˨
họ	hɔ˨˩˨
hơi	hɤj˧˧
hời	hɤj˧˨
hỡi	hɤj˨˩˦
hởi	hɤj˨˩˦
hôi	hoj˧˧
hối	hoj˦˥
hồi	hoj˧˨
hổi	hoj˨˩˦
hội	hoj˨˩˨
hoi	hɔj˧˧
hói	hɔj˦˥
hỏi	hɔj˨˩˦
hợm	hɤm˨˩˨
hôm	hom˧˧
hổm	hom˨˩˦
hom	hɔm˧˧
hóm	hɔm˦˥
hòm	hɔm˧˨
hỏm	hɔm˨˩˦
hông	hoŋm˧˧
hống	hoŋm˦˥
hồng	hoŋm˧˨
hỗng	hoŋm˨˩˦
hổng	hoŋm˨˩˦
hong	hɔŋm˧˧
hóng	hɔŋm˦˥
hòng	hɔŋm˧˨
hỏng	hɔŋm˨˩˦
họng	hɔŋm˨˩˨
hơn	hɤŋ˧˧
hớn	hɤŋ˦˥
hờn	hɤŋ˧˨
hôn	hoŋm˧˧
hồn	hoŋm˧˨
hỗn	hoŋm˨˩˦
hổn	hoŋm˨˩˦
hộn	hoŋm˨˩˨
hon	hɔŋm˧˧
hòn	hɔŋm˧˨
hỏn	hɔŋm˨˩˦
hớp	hɤp˦˥
hợp	hɤp˨˩˨
hộp	hop˨˩˨
hóp	hɔp˦˥
họp	hɔp˨˩˨
hớt	hɤk˦˥
hốt	hokp˦˥
hột	hokp˨˩˨
hót	hɔkp˦˥
hứa	hɯə˦˥
huân	hwɤ̆ŋ˧˧
huấn	hwɤ̆ŋ˦˥
húc	hukp˦˥
hục	hukp˨˩˨
hực	hɯk˨˩˨
huếch	hwet˦˥
huê	hwe˧˧
huề	hwe˧˨
huệ	hwe˨˩˨
huênh	hwen˧˧
hu	hu˧˧
hú	hu˦˥
hù	hu˧˨
hũ	hu˨˩˦
hủ	hu˨˩˦
hư	hɯ˧˧
hừ	hɯ˧˨
hui	huj˧˧
hùi	huj˧˨
hum	hum˧˧
hùm	hum˧˨
hung	huŋm˧˧
húng	huŋm˦˥
hùng	huŋm˧˨
hủng	huŋm˨˩˦
hưng	hɯŋ˧˧
hứng	hɯŋ˦˥
hừng	hɯŋ˧˨
hững	hɯŋ˨˩˦
hửng	hɯŋ˨˩˦
hun	huŋm˧˧
hùn	huŋm˧˨
hủn	huŋm˨˩˦
huơ	huə˧˧
huống	huəŋ˦˥
hương	hɯəŋ˧˧
hương	hɯəŋ˧˧
hướng	hɯəŋ˦˥
hưởng	hɯəŋ˨˩˦
hươu	hɯəw˧˧
húp	hup˦˥
hụp	hup˨˩˨
hút	hukp˦˥
hụt	hukp˨˩˨
hưu	hɯw˧˧
hữu	hɯw˨˩˦
huých	hwit˦˥
huỵch	hwit˨˩˨
huyên	hwiəŋ˧˧
huyền	hwiəŋ˧˨
huyễn	hwiəŋ˨˩˦
huyện	hwiəŋ˨˩˨
huyết	hwiək˦˥
huyệt	hwiək˨˩˨
húy	huj˦˥
hủy	huj˨˩˦
huy	hwi˧˧
huý	hwi˦˥
huỷ	hwi˨˩˦
huynh	hwin˧˧
huỳnh	hwin˧˨
huýt	hwit˦˥
hy	hi˧˧
ỉa	iə˨˩˦
ích	it˦˥
ic	it˧˧
i	i˧˧
í	i˦˥
ì	i˧˨
ỉ	i˨˩˦
ị	i˨˩˨
im	im˧˧
ỉm	im˨˩˦
inh	in˧˧
ình	in˧˨
ĩnh	in˨˩˦
in	in˧˧
ìn	in˧˨
i-ôn	i˧˧-oŋm˧˧
ít	it˦˥
ịt	it˨˩˨
iu	iw˧˧
ỉu	iw˨˩˦
ka	ka˧˧
ka-li	ka˧˧-li˧˧
kếch	ket˦˥
kệch	ket˨˩˨
kê	ke˧˧
kế	ke˦˥
kề	ke˧˨
kể	ke˨˩˦
kệ	ke˨˩˨
ke	kɛ˧˧
ké	kɛ˦˥
kè	kɛ˧˨
kẽ	kɛ˨˩˦
kẻ	kɛ˨˩˦
kềm	kem˧˨
kem	kɛm˧˧
kém	kɛm˦˥
kèm	kɛm˧˨
kẽm	kɛm˨˩˦
kẻm	kɛm˨˩˦
keng	kɛŋ˧˧
kênh	ken˧˧
kềnh	ken˧˨
kễnh	ken˨˩˦
kên	ken˧˧
kền	ken˧˨
ken	kɛŋ˧˧
kén	kɛŋ˦˥
kèn	kɛŋ˧˨
kẹn	kɛŋ˨˩˨
keo	keo˧˧
kéo	keo˦˥
kèo	keo˧˨
kẽo	keo˨˩˦
kẻo	keo˨˩˦
kẹo	keo˨˩˨
kép	kɛp˦˥
kẹp	kɛp˨˩˨
kết	ket˦˥
két	kɛt˦˥
kẹt	kɛt˨˩˨
kêu	kɛu˧˧
khách	xat˦˥
khảch	xat˨˩˦
khác	xak˦˥
khắc	xăk˦˥
khạc	xak˨˩˨
khặc	xăk˨˩˨
khai	xaj˧˧
khái	xaj˦˥
khải	xaj˨˩˦
kham	xam˧˧
khám	xam˦˥
khăm	xăm˧˧
khắm	xăm˦˥
khảm	xam˨˩˦
khâm	xɤ̆m˧˧
khấm	xɤ̆m˦˥
khậm	xɤ̆m˨˩˨
khang	xaŋ˧˧
kháng	xaŋ˦˥
khăng	xăŋ˧˧
khắng	xăŋ˦˥
khằng	xăŋ˧˨
khẳng	xăŋ˨˩˦
khảng	xaŋ˨˩˦
khảng	xaŋ˨˩˦
khạng	xaŋ˨˩˨
khâng	xɤ̆ŋ˧˧
khầng	xɤ̆ŋ˧˨
khánh-hạ	xan˦˥-ha˨˩˨
khanh	xan˧˧
khánh	xan˦˥
khành	xan˧˨
khảnh	xan˨˩˦
khan	xaŋ˧˧
khán	xaŋ˦˥
khàn	xaŋ˧˨
khăn	xăŋ˧˧
khắn	xăŋ˦˥
khẳn	xăŋ˨˩˦
khản	xaŋ˨˩˦
khấn	xɤ̆ŋ˦˥
khẩn	xɤ̆ŋ˨˩˦
khao	xaw˧˧
khảo	xaw˨˩˦
khắp	xăp˦˥
khấp	xɤ̆p˦˥
khập	xɤ̆p˨˩˨
khắt	xăk˦˥
khát	xat˦˥
khất	xɤ̆k˦˥
khật	xɤ̆k˨˩˨
kháu	xăw˦˥
khâu	xɤ̆w˧˧
khấu	xɤ̆w˦˥
khẩu	xɤ̆w˨˩˦
kha	xa˧˧
khá	xa˦˥
khà	xa˧˨
khả	xa˨˩˦
khạ	xa˨˩˨
khay	xăj˧˧
khem	xɛm˧˧
khèng	xɛŋ˧˨
khềnh	xen˧˨
khễnh	xen˨˩˦
khểnh	xen˨˩˦
khệnh	xen˨˩˨
khen	xɛŋ˧˧
khèn	xɛŋ˧˨
kheo	xeo˧˧
kheo	xeo˧˧
khéo	xeo˦˥
khép	xɛp˦˥
khét	xɛt˦˥
khêu	xɛu˧˧
khều	xɛu˧˨
khê	xe˧˧
khế	xe˦˥
khề	xe˧˨
khệ	xe˨˩˨
khe	xɛ˧˧
khé	xɛ˦˥
khè	xɛ˧˨
khẽ	xɛ˨˩˦
khẻ	xɛ˨˩˦
khía	xiə˦˥
khích	xit˦˥
khiêm	xim˧˧
khiếm	xim˦˥
khiêng	xiəŋ˧˧
khiên	xiəŋ˧˧
khiển	xiəŋ˨˩˦
khiếp	xip˦˥
khiêu	xiəw˧˧
khiếu	xiəw˦˥
khinh	xin˧˧
khin	xin˧˧
khìn	xin˧˨
khít	xit˦˥
khịt	xit˨˩˨
khi	xi˧˧
khí	xi˦˥
khì	xi˧˨
khỉ	xi˨˩˦
khoác	xwak˦˥
khoai	xwaj˧˧
khoái	xwaj˦˥
khoăm	xwăm˧˧
khoằm	xwăm˧˨
khoang	xwaŋ˧˧
khoáng	xwaŋ˦˥
khoảng	xwaŋ˨˩˦
khoanh	xwan˧˧
khoành	xwan˧˨
khoảnh	xwan˨˩˦
khoan	xwaŋ˧˧
khoán	xwaŋ˦˥
khoản	xwaŋ˨˩˦
khoát	xwat˦˥
khoa	xwa˧˧
khoá	xwa˦˥
khoả	xwa˨˩˦
khóa	xwa˦˥
khỏa	xwa˨˩˦
khốc	xokp˦˥
khóc	xɔkp˦˥
khoen	xwen˧˧
khoeo	xwew˧˧
khoèo	xwew˧˨
khoét	xwet˦˥
khoe	xwe˧˧
khoé	xwe˦˥
khoẻ	xwe˨˩˦
khóe	xwe˦˥
khòe	xwe˧˨
khỏe	xwe˨˩˦
khơi	xɤj˧˧
khởi	xɤj˨˩˦
khôi	xoj˧˧
khối	xoj˦˥
khói	xɔj˦˥
khỏi	xɔj˨˩˦
khơ-me	xɤ˧˧-mɛ˧˧
khơ-mú	xɤ˧˧-mu˦˥
khom	xɔm˧˧
khòm	xɔm˧˨
khọm	xɔm˨˩˨
không	xoŋm˧˧
không	xoŋm˧˧
khống	xoŋm˦˥
khổng	xoŋm˨˩˦
khòng	xɔŋm˧˨
khôn	xoŋm˧˧
khốn	xoŋm˦˥
khổn	xoŋm˨˩˦
khớp	xɤp˦˥
khơ	xɤ˧˧
khờ	xɤ˧˨
khô	xo˧˧
khố	xo˦˥
khổ	xo˨˩˦
kho	xɔ˧˧
khó	xɔ˦˥
khò	xɔ˧˨
khuân	xwɤ̆ŋ˧˧
khuẩn	xwɤ̆ŋ˨˩˦
khuất	xwɤ̆k˦˥
khua	xuə˧˧
khuây	xwɤ̆j˧˧
khuấy	xwɤ̆j˦˥
khúc	xukp˦˥
khục	xukp˨˩˨
khuếch	xwet˦˥
khuê	xwe˧˧
khum	xum˧˧
khúm	xum˦˥
khung	xuŋm˧˧
khúng	xuŋm˦˥
khùng	xuŋm˧˨
khủng	xuŋm˨˩˦
khụng	xuŋm˨˩˨
khước	xɯək˦˥
khươm	xɯm˧˧
khuông	xuəŋ˧˧
khuôn	xuəŋ˧˧
khướt	xɯək˦˥
khướu	xɯəw˦˥
khuờ	xuə˧˨
khụt	xukp˨˩˨
khứu	xɯw˦˥
khu	xu˧˧
khú	xu˦˥
khù	xu˧˨
khủ	xu˨˩˦
khụ	xu˨˩˨
khư	xɯ˧˧
khứ	xɯ˦˥
khừ	xɯ˧˨
khử	xɯ˨˩˦
khự	xɯ˨˩˨
khuya	xwiə˧˧
khuyên	xwiəŋ˧˧
khuyến	xwiəŋ˦˥
khuyển	xwiəŋ˨˩˦
khuyết	xwiək˦˥
khuynh	xwin˧˧
khuỳnh	xwin˧˨
khuy	xwi˧˧
khyển	xiɛŋ˨˩˦
kia	kiə˧˧
kìa	kiə˧˨
kích	kit˦˥
kịch	kit˨˩˨
kiêm	kim˧˧
kiếm	kim˦˥
kiềm	kim˧˨
kiểm	kim˨˩˦
kiệm	kim˨˩˨
kiêng	kiəŋ˧˧
kiềng	kiəŋ˧˨
kiên	kiəŋ˧˧
kiến	kiəŋ˦˥
kiền	kiəŋ˧˨
kiện	kiəŋ˨˩˨
kiếp	kip˦˥
kiết	kiək˦˥
kiệt	kiək˨˩˨
kiệt	kiək˨˩˨
kiêu	kiəw˧˧
kiếu	kiəw˦˥
kiều	kiəw˧˨
kiểu	kiəw˨˩˦
kiệu	kiəw˨˩˨
ki	ki˧˧
kí	ki˦˥
kì	ki˧˨
kĩ	ki˨˩˦
kỉ	ki˨˩˦
kị	ki˨˩˨
ki-lô	ki˧˧-lo˧˧
ki-lô-oát	ki˧˧-lo˧˧-wat˦˥
kim	kim˧˧
kìm	kim˧˨
kinh	kin˧˧
kính	kin˦˥
kình	kin˧˨
kin	kin˧˧
kín	kin˦˥
kìn	kin˧˨
kíp	kip˦˥
kịp	kip˨˩˨
ki-tô	ki˧˧-to˧˧
kíu	kiw˦˥
kĩu	kiw˨˩˦
ky	ki˧˧
ký	ki˦˥
kỳ	ki˧˨
kỹ	ki˨˩˦
kỷ	ki˨˩˦
kỵ	ki˨˩˨
lách	lat˦˥
lạch	lat˨˩˨
lác	lak˦˥
lác	lak˦˥
lắc	lăk˦˥
lạc	lak˨˩˨
lặc	lăk˨˩˨
lấc	lɤ̆k˦˥
lai-đa	laj˧˧-da˧˧
lai	laj˧˧
lái	laj˦˥
lài	laj˧˨
lãi	laj˨˩˦
lải	laj˨˩˦
lại	laj˨˩˨
lai-ly	laj˧˧-li˧˧
la	la˧˧
lá	la˦˥
là	la˧˨
lã	la˨˩˦
lả	la˨˩˦
lạ	la˨˩˨
la-mã	la˧˧-ma˨˩˦
lam	lam˧˧
làm	lam˧˨
lăm	lăm˧˧
lắm	lăm˦˥
lắm	lăm˦˥
lằm	lăm˧˨
lãm	lam˨˩˦
lảm	lam˨˩˦
lạm	lam˨˩˨
lâm	lɤ̆m˧˧
lấm	lɤ̆m˦˥
lầm	lɤ̆m˧˨
lẫm	lɤ̆m˨˩˦
lẩm	lɤ̆m˨˩˦
lang	laŋ˧˧
láng	laŋ˦˥
làng	laŋ˧˨
lăng	lăŋ˧˧
lắng	lăŋ˦˥
lằng	lăŋ˧˨
lẵng	lăŋ˨˩˦
lẳng	lăŋ˨˩˦
lãng	laŋ˨˩˦
lảng	laŋ˨˩˦
lạng	laŋ˨˩˨
lặng	lăŋ˨˩˨
lâng	lɤ̆ŋ˧˧
lanh	lan˧˧
lánh	lan˦˥
lành	lan˧˨
lãnh	lan˨˩˦
lảnh	lan˨˩˦
lạnh	lan˨˩˨
lan	laŋ˧˧
lan	laŋ˧˧
lán	laŋ˦˥
làn	laŋ˧˨
lăn	lăŋ˧˧
lằn	lăŋ˧˨
lẳn	lăŋ˨˩˦
lãn	laŋ˨˩˦
lặn	lăŋ˨˩˨
lân	lɤ̆ŋ˧˧
lấn	lɤ̆ŋ˦˥
lần	lɤ̆ŋ˧˨
lẫn	lɤ̆ŋ˨˩˦
lẩn	lɤ̆ŋ˨˩˦
lận	lɤ̆ŋ˨˩˨
lao	law˧˧
láo	law˦˥
lào	law˧˨
lão	law˨˩˦
lảo	law˨˩˦
lạo	law˨˩˨
láp	lap˦˥
lắp	lăp˦˥
lạp	lap˨˩˨
lặp	lăp˨˩˨
lâp	lɤ̆p˧˧
lấp	lɤ̆p˦˥
lập	lɤ̆p˨˩˨
la-tê-rít	la˧˧-te˧˧-ʐit˦˥
la-tinh	la˧˧-tin˧˧
lắt	lăk˦˥
lặt	lăk˨˩˨
lát	lat˦˥
lạt	lat˨˩˨
lất	lɤ̆k˦˥
lật	lɤ̆k˨˩˨
lau	lăw˧˧
láu	lăw˦˥
làu	lăw˧˨
lảu	lăw˨˩˦
lạu	lăw˨˩˨
lâu	lɤ̆w˧˧
lấu	lɤ̆w˦˥
lầu	lɤ̆w˧˨
lẩu	lɤ̆w˨˩˦
lậu	lɤ̆w˨˩˨
lay	lăj˧˧
láy	lăj˦˥
lày	lăj˧˨
lảy	lăj˨˩˦
lạy	lăj˨˩˨
lây	lɤ̆j˧˧
lấy	lɤ̆j˦˥
lầy	lɤ̆j˧˨
lẫy	lɤ̆j˨˩˦
lẩy	lɤ̆j˨˩˦
lậy	lɤ̆j˨˩˨
lếch	let˦˥
lệch	let˨˩˨
lê	le˧˧
lề	le˧˨
lễ	le˨˩˦
lể	le˨˩˦
lệ	le˨˩˨
le	lɛ˧˧
lé	lɛ˦˥
lè	lɛ˧˨
lẽ	lɛ˨˩˦
lẻ	lɛ˨˩˦
lẹ	lɛ˨˩˨
lem	lɛm˧˧
lém	lɛm˦˥
lèm	lɛm˧˨
lẹm	lɛm˨˩˨
leng	lɛŋ˧˧
léng	lɛŋ˦˥
lẻng	lɛŋ˨˩˦
lênh	len˧˧
lềnh	len˧˨
lệnh	len˨˩˨
lên	len˧˧
len	lɛŋ˧˧
lén	lɛŋ˦˥
lèn	lɛŋ˧˨
lẻn	lɛŋ˨˩˦
leo	leo˧˧
léo	leo˦˥
lèo	leo˧˨
lẽo	leo˨˩˦
lẻo	leo˨˩˦
lẹo	leo˨˩˨
lép	lɛp˦˥
lẹp	lɛp˨˩˨
lết	let˦˥
lệt	let˨˩˨
lét	lɛt˦˥
lẹt	lɛt˨˩˨
lêu	lɛu˧˧
lếu	lɛu˦˥
lều	lɛu˧˨
lễu	lɛu˨˩˦
lểu	lɛu˨˩˦
lia	liə˧˧
lìa	liə˧˨
lích	lit˦˥
lịch	lit˨˩˨
liếc	liək˦˥
liêm	lim˧˧
liếm	lim˦˥
liềm	lim˧˨
liệm	lim˨˩˨
liêng	liəŋ˧˧
liểng	liəŋ˨˩˦
liên	liəŋ˧˧
liến	liəŋ˦˥
liền	liəŋ˧˨
liếp	lip˦˥
liệt	liək˨˩˨
liêu	liəw˧˧
liếu	liəw˦˥
liều	liəw˧˨
liễu	liəw˨˩˦
liệu	liəw˨˩˨
li	li˧˧
lí	li˦˥
lì	li˧˨
lị	li˨˩˨
lim	lim˧˧
lìm	lim˧˨
linh	lin˧˧
lính	lin˦˥
lình	lin˧˨
lĩnh	lin˨˩˦
lỉnh	lin˨˩˦
líp	lip˦˥
lít	lit˦˥
liu	liw˧˧
líu	liw˦˥
lịu	liw˨˩˨
loạch	lwat˨˩˨
loạc	lwak˨˩˨
loai	lwaj˧˧
loài	lwaj˧˨
loại	lwaj˨˩˨
loại	lwaj˨˩˨
loa	lwa˧˧
loá	lwa˦˥
loà	lwa˧˨
loã	lwa˨˩˦
loả	lwa˨˩˦
lòa	lwa˧˨
lõa	lwa˨˩˦
lỏa	lwa˨˩˦
loang	lwaŋ˧˧
loáng	lwaŋ˦˥
loàng	lwaŋ˧˨
loăng	lwăŋ˧˧
loằng	lwăŋ˧˨
loãng	lwaŋ˨˩˦
loảng	lwaŋ˨˩˦
loạng	lwaŋ˨˩˨
loanh	lwan˧˧
loan	lwaŋ˧˧
loăn	lwăŋ˧˧
loắn	lwăŋ˦˥
loằn	lwăŋ˧˨
loạn	lwaŋ˨˩˨
loáo	lwaw˦˥
loắt	lwăk˦˥
loát	lwat˦˥
loạt	lwat˨˩˨
loay	lwăj˧˧
loáy	lwăj˦˥
lốc	lokp˦˥
lộc	lokp˨˩˨
lóc	lɔkp˦˥
lọc	lɔkp˨˩˨
loe	lwe˧˧
loé	lwe˦˥
loè	lwe˧˨
lòe	lwe˧˨
loẻng	lwen˨˩˦
loen	lwen˧˧
loẻo	lwew˨˩˦
loét	lwet˦˥
loẹt	lwet˨˩˨
lô-gích	lo˧˧-ɣit˦˥
lơi	lɤj˧˧
lời	lɤj˧˨
lợi	lɤj˨˩˨
lôi	loj˧˧
lối	loj˦˥
lồi	loj˧˨
lỗi	loj˨˩˦
lội	loj˨˩˨
loi	lɔj˧˧
lòi	lɔj˧˨
lõi	lɔj˨˩˦
lọi	lɔj˨˩˨
lơ	lɤ˧˧
lớ	lɤ˦˥
lờ	lɤ˧˨
lỡ	lɤ˨˩˦
lở	lɤ˨˩˦
lợ	lɤ˨˩˨
lô	lo˧˧
lố	lo˦˥
lồ	lo˧˨
lỗ	lo˨˩˦
lổ	lo˨˩˦
lộ	lo˨˩˨
lo	lɔ˧˧
ló	lɔ˦˥
lò	lɔ˧˨
lõ	lɔ˨˩˦
lọ	lɔ˨˩˨
lờm	lɤm˧˨
lởm	lɤm˨˩˦
lợm	lɤm˨˩˨
lôm	lom˧˧
lốm	lom˦˥
lồm	lom˧˨
lỗm	lom˨˩˦
lổm	lom˨˩˦
lộm	lom˨˩˨
lom	lɔm˧˧
lóm	lɔm˦˥
lòm	lɔm˧˨
lõm	lɔm˨˩˦
lỏm	lɔm˨˩˦
lọm	lɔm˨˩˨
lông	loŋm˧˧
lồng	loŋm˧˨
lổng	loŋm˨˩˦
lộng	loŋm˨˩˨
long	lɔŋm˧˧
lóng	lɔŋm˦˥
lòng	lɔŋm˧˨
lõng	lɔŋm˨˩˦
lỏng	lɔŋm˨˩˦
lọng	lɔŋm˨˩˨
lơn	lɤŋ˧˧
lớn	lɤŋ˦˥
lờn	lɤŋ˧˨
lởn	lɤŋ˨˩˦
lợn	lɤŋ˨˩˨
lốn	loŋm˦˥
lồn	loŋm˧˨
lổn	loŋm˨˩˦
lộn	loŋm˨˩˨
lon	lɔŋm˧˧
lòn	lɔŋm˧˨
lỏn	lɔŋm˨˩˦
lọn	lɔŋm˨˩˨
loong	lɔŋm˧˧
lớp	lɤp˦˥
lợp	lɤp˨˩˨
lốp	lop˦˥
lộp	lop˨˩˨
lóp	lɔp˦˥
lọp	lɔp˨˩˨
lớt	lɤk˦˥
lợt	lɤk˨˩˨
lốt	lokp˦˥
lột	lokp˨˩˨
lót	lɔkp˦˥
lọt	lɔkp˨˩˨
lua	luə˧˧
lúa	luə˦˥
lủa	luə˨˩˦
lụa	luə˨˩˨
lưa	lɯə˧˧
lứa	lɯə˦˥
lừa	lɯə˧˨
lửa	lɯə˨˩˦
lựa	lɯə˨˩˨
luân	lwɤ̆ŋ˧˧
luấn	lwɤ̆ŋ˦˥
luẩn	lwɤ̆ŋ˨˩˦
luận	lwɤ̆ŋ˨˩˨
luật	lwɤ̆k˨˩˨
lúc	lukp˦˥
lục	lukp˨˩˨
lực	lɯk˨˩˨
lui	luj˧˧
lúi	luj˦˥
lùi	luj˧˨
lủi	luj˨˩˦
lụi	luj˨˩˨
lu	lu˧˧
lú	lu˦˥
lù	lu˧˨
lũ	lu˨˩˦
lủ	lu˨˩˦
lụ	lu˨˩˨
lư	lɯ˧˧
lừ	lɯ˧˨
lữ	lɯ˨˩˦
lử	lɯ˨˩˦
lự	lɯ˨˩˨
lum	lum˧˧
lúm	lum˦˥
lùm	lum˧˨
lũm	lum˨˩˦
lủm	lum˨˩˦
lụm	lum˨˩˨
lung	luŋm˧˧
lúng	luŋm˦˥
lùng	luŋm˧˨
lũng	luŋm˨˩˦
lủng	luŋm˨˩˦
lụng	luŋm˨˩˨
lưng	lɯŋ˧˧
lưng	lɯŋ˧˧
lừng	lɯŋ˧˨
lững	lɯŋ˨˩˦
lửng	lɯŋ˨˩˦
lựng	lɯŋ˨˩˨
lún	luŋm˦˥
lùn	luŋm˧˨
lũn	luŋm˨˩˦
lủn	luŋm˨˩˦
lụn	luŋm˨˩˨
lược	lɯək˨˩˨
lưới	lɯəj˦˥
lười	lɯəj˧˨
lưỡi	lɯəj˨˩˦
lưởi	lɯəj˨˩˦
luôm	lum˧˧
luộm	lum˨˩˨
lươm	lɯm˧˧
lườm	lɯm˧˨
lượm	lɯm˨˩˨
luông	luəŋ˧˧
luống	luəŋ˦˥
luồng	luəŋ˧˨
lương	lɯəŋ˧˧
lướng	lɯəŋ˦˥
lường	lɯəŋ˧˨
lưỡng	lɯəŋ˨˩˦
lượng	lɯəŋ˨˩˨
luôn	luəŋ˧˧
luồn	luəŋ˧˨
lươn	lɯəŋ˧˧
lượn	lɯəŋ˨˩˨
lướp	lɯp˦˥
luốt	luək˦˥
lướt	lɯək˦˥
lượt	lɯək˨˩˨
lướu	lɯəw˦˥
lúp	lup˦˥
lụp	lup˨˩˨
lút	lukp˦˥
lụt	lukp˨˩˨
lưu	lɯw˧˧
lựu	lɯw˨˩˨
luyên	lwiəŋ˧˧
luyến	lwiəŋ˦˥
luyện	lwiəŋ˨˩˨
lũy	luj˨˩˦
lụy	luj˨˩˨
luy	lwi˧˧
luỹ	lwi˨˩˦
luỵ	lwi˨˩˨
luýnh	lwin˦˥
ly	li˧˧
lý	li˦˥
lỵ	li˨˩˨
ma-cà-bông	ma˧˧-ka˧˨-boŋm˧˧
mách	mat˦˥
mạch	mat˨˩˨
mác	mak˦˥
mắc	măk˦˥
mạc	mak˨˩˨
mặc	măk˨˩˨
mạc-sê	mak˨˩˨-ʂe˧˧
mác-xít	mak˦˥-sit˦˥
mai	maj˧˧
mái	maj˦˥
mài	maj˧˨
mãi	maj˨˩˦
mãi	maj˨˩˦
mải	maj˨˩˦
mại	maj˨˩˨
ma	ma˧˧
má	ma˦˥
mà	ma˧˨
mã	ma˨˩˦
mả	ma˨˩˦
mả	ma˨˩˦
mạ	ma˨˩˨
măm	măm˧˧
mắm	măm˦˥
mẵm	măm˨˩˦
mâm	mɤ̆m˧˧
mầm	mɤ̆m˧˨
mẫm	mɤ̆m˨˩˦
mẩm	mɤ̆m˨˩˦
mang	maŋ˧˧
máng	maŋ˦˥
màng	maŋ˧˨
măng	măŋ˧˧
mắng	măŋ˦˥
mãng	maŋ˨˩˦
mảng	maŋ˨˩˦
mạng	maŋ˨˩˨
mâng	mɤ̆ŋ˧˧
manh	man˧˧
mánh	man˦˥
mành	man˧˨
mãnh	man˨˩˦
mảnh	man˨˩˦
mạnh	man˨˩˨
man	maŋ˧˧
mán	maŋ˦˥
màn	maŋ˧˨
măn	măŋ˧˧
mắn	măŋ˦˥
mằn	măŋ˧˨
mãn	maŋ˨˩˦
mạn	maŋ˨˩˨
mặn	măŋ˨˩˨
mân	mɤ̆ŋ˧˧
mấn	mɤ̆ŋ˦˥
mần	mɤ̆ŋ˧˨
mẫn	mɤ̆ŋ˨˩˦
mẩn	mɤ̆ŋ˨˩˦
mận	mɤ̆ŋ˨˩˨
mao	maw˧˧
mào	maw˧˨
mạo	maw˨˩˨
mấp	mɤ̆p˦˥
mập	mɤ̆p˨˩˨
mắt	măk˦˥
mặt	măk˨˩˨
mát	mat˦˥
mạt	mat˨˩˨
mất	mɤ̆k˦˥
mật	mɤ̆k˨˩˨
mau	măw˧˧
máu	măw˦˥
màu	măw˧˨
mâu	mɤ̆w˧˧
mấu	mɤ̆w˦˥
mầu	mɤ̆w˧˨
mẫu	mɤ̆w˨˩˦
mậu	mɤ̆w˨˩˨
may	măj˧˧
máy	măj˦˥
máy	măj˦˥
mày	măj˧˨
mảy	măj˨˩˦
mạy	măj˨˩˨
mây	mɤ̆j˧˧
mấy	mɤ̆j˦˥
mầy	mɤ̆j˧˨
mẩy	mɤ̆j˨˩˦
mếch	met˦˥
mê	me˧˧
mề	me˧˨
mễ	me˨˩˦
me	mɛ˧˧
mè	mɛ˧˨
mẽ	mɛ˨˩˦
mẻ	mɛ˨˩˦
mẹ	mɛ˨˩˨
mềm	mem˧˨
mênh	men˧˧
mệnh	men˨˩˨
mên	men˧˧
mến	men˦˥
mền	men˧˨
men	mɛŋ˧˧
meo	meo˧˧
méo	meo˦˥
mèo	meo˧˨
mẹo	meo˨˩˨
mép	mɛp˦˥
mệt	met˨˩˨
mét	mɛt˦˥
mếu	mɛu˦˥
mía	miə˦˥
mỉa	miə˨˩˦
mích	mit˦˥
miếng	miəŋ˦˥
miệng	miəŋ˨˩˨
miên	miəŋ˧˧
miền	miəŋ˧˨
miễn	miəŋ˨˩˦
miệt	miək˨˩˨
miêu	miəw˧˧
miếu	miəw˦˥
miều	miəw˧˨
mi	mi˧˧
mì	mi˧˨
mĩ	mi˨˩˦
mỉ	mi˨˩˦
mị	mi˨˩˨
mim	mim˧˧
mỉm	mim˨˩˦
minh	min˧˧
mình	min˧˨
mìn	min˧˨
mịn	min˨˩˨
mít	mit˦˥
mịt	mit˨˩˨
mỉu	miw˨˩˦
moay	mwăj˧˧
mô-bin	mo˧˧-bin˧˧
mốc	mokp˦˥
mộc	mokp˨˩˨
móc	mɔkp˦˥
mọc	mɔkp˨˩˨
mới	mɤj˦˥
mời	mɤj˧˨
môi	moj˧˧
mối	moj˦˥
mồi	moj˧˨
mỗi	moj˨˩˦
moi	mɔj˧˧
mòi	mɔj˧˨
mỏi	mɔj˨˩˦
mọi	mɔj˨˩˨
mô-men	mo˧˧-mɛŋ˧˧
mơ	mɤ˧˧
mớ	mɤ˦˥
mờ	mɤ˧˨
mỡ	mɤ˨˩˦
mở	mɤ˨˩˦
mớm	mɤm˦˥
mồm	mom˧˨
móm	mɔm˦˥
mòm	mɔm˧˨
mõm	mɔm˨˩˦
mỏm	mɔm˨˩˦
mô	mo˧˧
mố	mo˦˥
mồ	mo˧˨
mổ	mo˨˩˦
mộ	mo˨˩˨
mo	mɔ˧˧
mó	mɔ˦˥
mò	mɔ˧˨
mõ	mɔ˨˩˦
mỏ	mɔ˨˩˦
mông	moŋm˧˧
mống	moŋm˦˥
mồng	moŋm˧˨
mộng	moŋm˨˩˨
mong	mɔŋm˧˧
móng	mɔŋm˦˥
mòng	mɔŋm˧˨
mỏng	mɔŋm˨˩˦
mọng	mɔŋm˨˩˨
mơn	mɤŋ˧˧
mớn	mɤŋ˦˥
mởn	mɤŋ˨˩˦
môn	moŋm˧˧
mồn	moŋm˧˨
mon	mɔŋm˧˧
món	mɔŋm˦˥
mòn	mɔŋm˧˨
moóc	mɔkp˦˥
móp	mɔp˦˥
mốt	mokp˦˥
một	mokp˨˩˨
một	mokp˨˩˨
mót	mɔkp˦˥
mọt	mɔkp˨˩˨
mô-tô	mo˧˧-to˧˧
mua	muə˧˧
múa	muə˦˥
mùa	muə˧˨
mưa	mɯə˧˧
mưa	mɯə˧˧
mửa	mɯə˨˩˦
mục	mukp˨˩˨
mức	mɯk˦˥
mực	mɯk˨˩˨
mui	muj˧˧
múi	muj˦˥
mùi	muj˧˨
mũi	muj˨˩˦
mủi	muj˨˩˦
mum	mum˧˧
múm	mum˦˥
mũm	mum˨˩˦
mủm	mum˨˩˦
mú	mu˦˥
mù	mu˧˨
mũ	mu˨˩˦
mủ	mu˨˩˦
mụ	mu˨˩˨
mung	muŋm˧˧
mùng	muŋm˧˨
mủng	muŋm˨˩˦
mưng	mɯŋ˧˧
mừng	mɯŋ˧˨
mun	muŋm˧˧
mùn	muŋm˧˨
mụn	muŋm˨˩˨
mứn	mɯŋ˦˥
muối	muəj˦˥
muỗi	muəj˨˩˦
muội	muəj˨˩˨
mươi	mɯəj˧˧
mười	mɯəj˧˨
muồm	mum˧˨
muông	muəŋ˧˧
muống	muəŋ˦˥
mương	mɯəŋ˧˧
mường	mɯəŋ˧˨
muôn	muəŋ˧˧
muốn	muəŋ˦˥
muộn	muəŋ˨˩˨
mươn	mɯəŋ˧˧
mướn	mɯəŋ˦˥
mườn	mɯəŋ˧˨
mượn	mɯəŋ˨˩˨
mướp	mɯp˦˥
mướt	mɯək˦˥
mượt	mɯək˨˩˨
múp	mup˦˥
mút	mukp˦˥
mụt	mukp˨˩˨
mứt	mɯk˦˥
mưu	mɯw˧˧
mỹ	mi˨˩˦
nách	nat˦˥
nắc	năk˦˥
nạc	nak˨˩˨
nặc	năk˨˩˨
nấc	nɤ̆k˦˥
nai	naj˧˧
nái	naj˦˥
nài	naj˧˨
nại	naj˨˩˨
nam-đà	nam˧˧-da˧˨
nam-hạ	nam˧˧-ha˨˩˨
nam	nam˧˧
năm	năm˧˧
nắm	năm˦˥
nằm	năm˧˨
nạm	nam˨˩˨
nấm	nɤ̆m˦˥
nầm	nɤ̆m˧˨
nam-sang	nam˧˧-ʂaŋ˧˧
na	na˧˧
ná	na˦˥
nà	na˧˨
nạ	na˨˩˨
nang	naŋ˧˧
nàng	naŋ˧˨
năng	năŋ˧˧
nắng	năŋ˦˥
nằng	năŋ˧˨
nạng	naŋ˨˩˨
nặng	năŋ˨˩˨
nâng	nɤ̆ŋ˧˧
nẫng	nɤ̆ŋ˨˩˦
nanh	nan˧˧
nan	naŋ˧˧
năn	năŋ˧˧
nắn	năŋ˦˥
nằn	năŋ˧˨
nản	naŋ˨˩˦
nạn	naŋ˨˩˨
nặn	năŋ˨˩˨
nân	nɤ̆ŋ˧˧
nấn	nɤ̆ŋ˦˥
nần	nɤ̆ŋ˧˨
nao	naw˧˧
náo	naw˦˥
nào	naw˧˨
nào	naw˧˨
não	naw˨˩˦
nảo	naw˨˩˦
nạo	naw˨˩˨
náp	nap˦˥
nắp	năp˦˥
nạp	nap˨˩˨
nấp	nɤ̆p˦˥
nát	nat˦˥
nạt	nat˨˩˨
náu	năw˦˥
nâu	nɤ̆w˧˧
nấu	nɤ̆w˦˥
nẫu	nɤ̆w˨˩˦
nay	năj˧˧
này	năj˧˨
nãy	năj˨˩˦
nảy	năj˨˩˦
nây	nɤ̆j˧˧
nấy	nɤ̆j˦˥
nẩy	nɤ̆j˨˩˦
nêm	nem˧˧
nếm	nem˦˥
nệm	nem˨˩˨
nem	nɛm˧˧
ném	nɛm˦˥
nê	ne˧˧
nề	ne˧˨
nể	ne˨˩˦
nệ	ne˨˩˨
ne	nɛ˧˧
né	nɛ˦˥
nẻ	nɛ˨˩˦
nên	nen˧˧
nến	nen˦˥
nền	nen˧˨
nen	nɛŋ˧˧
nén	nɛŋ˦˥
neo	neo˧˧
néo	neo˦˥
nẻo	neo˨˩˦
nếp	nep˦˥
nẹp	nɛp˨˩˨
nết	net˦˥
nét	nɛt˦˥
nẹt	nɛt˨˩˨
nêu	nɛu˧˧
nếu	nɛu˦˥
ngạch	ŋat˨˩˨
ngác	ŋak˦˥
ngắc	ŋăk˦˥
ngạc	ŋak˨˩˨
ngấc	ŋɤ̆k˦˥
ngai	ŋaj˧˧
ngái	ŋaj˦˥
ngài	ŋaj˧˨
ngãi	ŋaj˨˩˦
ngải	ŋaj˨˩˦
ngại	ŋaj˨˩˨
ngam	ŋam˧˧
ngàm	ŋam˧˨
ngăm	ŋăm˧˧
ngắm	ŋăm˦˥
ngâm	ŋɤ̆m˧˧
ngấm	ŋɤ̆m˦˥
ngầm	ŋɤ̆m˧˨
ngẫm	ŋɤ̆m˨˩˦
ngẩm	ŋɤ̆m˨˩˦
ngậm	ŋɤ̆m˨˩˨
ngang	ŋaŋ˧˧
ngáng	ŋaŋ˦˥
ngẳng	ŋăŋ˨˩˦
ngãng	ŋaŋ˨˩˦
ngẩng	ŋɤ̆ŋ˨˩˦
ngành	ŋan˧˨
ngảnh	ŋan˨˩˦
ngan	ŋaŋ˧˧
ngán	ŋaŋ˦˥
ngàn	ŋaŋ˧˨
ngàn	ŋaŋ˧˨
ngăn	ŋăŋ˧˧
ngắn	ŋăŋ˦˥
ngằn	ŋăŋ˧˨
ngạn	ŋaŋ˨˩˨
ngân	ŋɤ̆ŋ˧˧
ngấn	ŋɤ̆ŋ˦˥
ngần	ŋɤ̆ŋ˧˨
ngẩn	ŋɤ̆ŋ˨˩˦
ngận	ŋɤ̆ŋ˨˩˨
nga	ŋa˧˧
ngà	ŋa˧˨
ngã	ŋa˨˩˦
ngả	ŋa˨˩˦
ngao	ŋaw˧˧
ngáo	ŋaw˦˥
ngào	ŋaw˧˨
ngạo	ŋaw˨˩˨
ngáp	ŋap˦˥
ngấp	ŋɤ̆p˦˥
ngập	ŋɤ̆p˨˩˨
ngắt	ŋăk˦˥
ngặt	ŋăk˨˩˨
ngát	ŋat˦˥
ngạt	ŋat˨˩˨
ngất	ŋɤ̆k˦˥
ngật	ŋɤ̆k˨˩˨
ngau	ŋăw˧˧
ngàu	ŋăw˧˨
ngâu	ŋɤ̆w˧˧
ngấu	ŋɤ̆w˦˥
ngầu	ŋɤ̆w˧˨
ngẫu	ŋɤ̆w˨˩˦
ngậu	ŋɤ̆w˨˩˨
ngay	ŋăj˧˧
ngáy	ŋăj˦˥
ngày	ŋăj˧˨
ngày	ŋăj˧˨
ngây	ŋɤ̆j˧˧
ngấy	ŋɤ̆j˦˥
ngầy	ŋɤ̆j˧˨
nghếch	ŋet˦˥
nghệch	ŋet˨˩˨
nghênh	ŋen˧˧
nghềnh	ŋen˧˨
nghễnh	ŋen˨˩˦
nghền	ŋen˧˨
nghển	ŋen˨˩˦
nghèn	ŋɛŋ˧˨
nghẽn	ŋɛŋ˨˩˦
nghẹn	ŋɛŋ˨˩˨
nghê	ŋe˧˧
nghề	ŋe˧˨
nghể	ŋe˨˩˦
nghệ	ŋe˨˩˨
nghe	ŋɛ˧˧
nghé	ŋɛ˦˥
nghè	ŋɛ˧˨
nghèo	ŋeo˧˨
nghệt	ŋet˨˩˨
nghẹt	ŋɛt˨˩˨
nghêu	ŋɛu˧˧
nghều	ŋɛu˧˨
nghễu	ŋɛu˨˩˦
nghĩa	ŋiə˨˩˦
nghịch	ŋit˨˩˨
nghiêm	ŋim˧˧
nghiễm	ŋim˨˩˦
nghiệm	ŋim˨˩˨
nghiêng	ŋiəŋ˧˧
nghiên	ŋiəŋ˧˧
nghiến	ŋiəŋ˦˥
nghiền	ŋiəŋ˧˨
nghiện	ŋiəŋ˨˩˨
nghiệp	ŋip˨˩˨
nghiệt	ŋiək˨˩˨
nghiêu	ŋiəw˧˧
nghim	ŋim˧˧
nghinh	ŋin˧˧
nghìn	ŋin˧˨
nghi	ŋi˧˧
nghí	ŋi˦˥
nghì	ŋi˧˨
nghĩ	ŋi˨˩˦
nghỉ	ŋi˨˩˦
nghị	ŋi˨˩˨
nghỉu	ŋiw˨˩˦
ngoạch	ŋwat˨˩˨
ngoắc	ŋwăk˦˥
ngoặc	ŋwăk˨˩˨
ngoai	ŋwaj˧˧
ngoái	ŋwaj˦˥
ngoài	ŋwaj˧˨
ngoại	ŋwaj˨˩˨
ngoam	ŋwam˧˧
ngoang	ŋwaŋ˧˧
ngoằng	ŋwăŋ˧˨
ngoảnh	ŋwan˨˩˦
ngoan	ŋwaŋ˧˧
ngoăn	ŋwăŋ˧˧
ngoằn	ŋwăŋ˧˨
ngoạn	ŋwaŋ˨˩˨
ngoa	ŋwa˧˧
ngoã	ŋwa˨˩˦
ngoạ	ŋwa˨˩˨
ngoao	ŋwaw˧˧
ngoáo	ŋwaw˦˥
ngoắt	ŋwăk˦˥
ngoặt	ŋwăk˨˩˨
ngoay	ŋwăj˧˧
ngốc	ŋokp˦˥
ngộc	ŋokp˨˩˨
ngóc	ŋɔkp˦˥
ngọc	ŋɔkp˨˩˨
ngoem	ŋwem˧˧
ngoen	ŋwen˧˧
ngoe	ŋwe˧˧
ngoeo	ŋwew˧˧
ngoéo	ŋwew˦˥
ngoèo	ŋwew˧˨
ngoẻo	ŋwew˨˩˦
ngóeo	ŋwew˦˥
ngơi	ŋɤj˧˧
ngời	ŋɤj˧˨
ngợi	ŋɤj˨˩˨
ngôi	ŋoj˧˧
ngồi	ŋoj˧˨
ngoi	ŋɔj˧˧
ngói	ŋɔj˦˥
ngòi	ŋɔj˧˨
ngơm	ŋɤm˧˧
ngờm	ŋɤm˧˨
ngợm	ŋɤm˨˩˨
ngồm	ŋom˧˨
ngổm	ŋom˨˩˦
ngòm	ŋɔm˧˨
ngỏm	ŋɔm˨˩˦
ngông	ŋoŋm˧˧
ngồng	ŋoŋm˧˨
ngỗng	ŋoŋm˨˩˦
ngổng	ŋoŋm˨˩˦
ngong	ŋɔŋm˧˧
ngóng	ŋɔŋm˦˥
ngòng	ŋɔŋm˧˨
ngỏng	ŋɔŋm˨˩˦
ngọng	ŋɔŋm˨˩˨
ngơn	ŋɤŋ˧˧
ngôn	ŋoŋm˧˧
ngốn	ŋoŋm˦˥
ngồn	ŋoŋm˧˨
ngổn	ŋoŋm˨˩˦
ngon	ŋɔŋm˧˧
ngón	ŋɔŋm˦˥
ngòn	ŋɔŋm˧˨
ngỏn	ŋɔŋm˨˩˦
ngọn	ŋɔŋm˨˩˨
ngơ	ŋɤ˧˧
ngớ	ŋɤ˦˥
ngờ	ŋɤ˧˨
ngỡ	ŋɤ˨˩˦
ngô	ŋo˧˧
ngồ	ŋo˧˨
ngỗ	ŋo˨˩˦
ngổ	ŋo˨˩˦
ngộ	ŋo˨˩˨
ngo	ŋɔ˧˧
ngó	ŋɔ˦˥
ngò	ŋɔ˧˨
ngõ	ŋɔ˨˩˦
ngỏ	ŋɔ˨˩˦
ngọ	ŋɔ˨˩˨
ngợp	ŋɤp˨˩˨
ngớt	ŋɤk˦˥
ngốt	ŋokp˦˥
ngột	ŋokp˨˩˨
ngót	ŋɔkp˦˥
ngọt	ŋɔkp˨˩˨
ngưa	ŋɯə˧˧
ngứa	ŋɯə˦˥
ngửa	ŋɯə˨˩˦
ngựa	ŋɯə˨˩˨
nguây	ŋwɤ̆j˧˧
nguầy	ŋwɤ̆j˧˨
nguẩy	ŋwɤ̆j˨˩˦
ngúc	ŋukp˦˥
ngục	ŋukp˨˩˨
ngực	ŋɯk˨˩˨
nguếch	ŋwet˦˥
nguệch	ŋwet˨˩˨
ngùi	ŋuj˧˨
ngửi	ŋɯj˨˩˦
ngúng	ŋuŋm˦˥
ngũng	ŋuŋm˨˩˦
ngủng	ŋuŋm˨˩˦
ngưng	ŋɯŋ˧˧
ngừng	ŋɯŋ˧˨
ngửng	ŋɯŋ˨˩˦
ngun	ŋuŋm˧˧
ngùn	ŋuŋm˧˨
ngũn	ŋuŋm˨˩˦
ngủn	ŋuŋm˨˩˦
ngu	ŋu˧˧
ngú	ŋu˦˥
ngù	ŋu˧˨
ngũ	ŋu˨˩˦
ngủ	ŋu˨˩˦
ngụ	ŋu˨˩˨
ngư	ŋɯ˧˧
ngữ	ŋɯ˨˩˦
ngự	ŋɯ˨˩˨
ngước	ŋɯək˦˥
ngược	ŋɯək˨˩˨
nguôi	ŋuəj˧˧
nguồi	ŋuəj˧˨
nguội	ŋuəj˨˩˨
ngươi	ŋɯəj˧˧
người	ŋɯəj˧˨
ngường	ŋɯəŋ˧˨
ngưỡng	ŋɯəŋ˨˩˦
ngượng	ŋɯəŋ˨˩˨
nguồn	ŋuəŋ˧˨
ngườ	ŋɯə˧˨
ngụp	ŋup˨˩˨
ngút	ŋukp˦˥
ngưu	ŋɯw˧˧
nguých	ŋwit˦˥
nguyên	ŋwiəŋ˧˧
nguyền	ŋwiəŋ˧˨
nguyện	ŋwiəŋ˨˩˨
nguyệt	ŋwiək˨˩˨
ngụy	ŋuj˨˩˨
nguy	ŋwi˧˧
nguỵ	ŋwi˨˩˨
nguýt	ŋwit˦˥
nhác	ɲak˦˥
nhắc	ɲăk˦˥
nhạc	ɲak˨˩˨
nhấc	ɲɤ̆k˦˥
nhai	ɲaj˧˧
nhai	ɲaj˧˧
nhái	ɲaj˦˥
nhài	ɲaj˧˨
nhãi	ɲaj˨˩˦
nham	ɲam˧˧
nhám	ɲam˦˥
nhàm	ɲam˧˨
nhăm	ɲăm˧˧
nhắm	ɲăm˦˥
nhằm	ɲăm˧˨
nhảm	ɲam˨˩˦
nhặm	ɲăm˨˩˨
nhâm	ɲɤ̆m˧˧
nhấm	ɲɤ̆m˦˥
nhầm	ɲɤ̆m˧˨
nhậm	ɲɤ̆m˨˩˨
nhang	ɲaŋ˧˧
nhàng	ɲaŋ˧˨
nhăng	ɲăŋ˧˧
nhắng	ɲăŋ˦˥
nhằng	ɲăŋ˧˨
nhẳng	ɲăŋ˨˩˦
nhãng	ɲaŋ˨˩˦
nhặng	ɲăŋ˨˩˨
nhâng	ɲɤ̆ŋ˧˧
nhanh	ɲan˧˧
nhan	ɲaŋ˧˧
nhàn	ɲaŋ˧˨
nhăn	ɲăŋ˧˧
nhắn	ɲăŋ˦˥
nhẵn	ɲăŋ˨˩˦
nhẳn	ɲăŋ˨˩˦
nhãn	ɲaŋ˨˩˦
nhạn	ɲaŋ˨˩˨
nhân	ɲɤ̆ŋ˧˧
nhấn	ɲɤ̆ŋ˦˥
nhần	ɲɤ̆ŋ˧˨
nhẫn	ɲɤ̆ŋ˨˩˦
nhẩn	ɲɤ̆ŋ˨˩˦
nhận	ɲɤ̆ŋ˨˩˨
nha	ɲa˧˧
nhá	ɲa˦˥
nhà	ɲa˧˨
nhã	ɲa˨˩˦
nhả	ɲa˨˩˦
nhao	ɲaw˧˧
nháo	ɲaw˦˥
nhào	ɲaw˧˨
nhão	ɲaw˨˩˦
nhạo	ɲaw˨˩˨
nhắp	ɲăp˦˥
nhấp	ɲɤ̆p˦˥
nhập	ɲɤ̆p˨˩˨
nhặt	ɲăk˨˩˨
nhát	ɲat˦˥
nhạt	ɲat˨˩˨
nhất	ɲɤ̆k˦˥
nhật	ɲɤ̆k˨˩˨
nhau	ɲăw˧˧
nhàu	ɲăw˧˨
nhảu	ɲăw˨˩˦
nhâu	ɲɤ̆w˧˧
nhầu	ɲɤ̆w˧˨
nhậu	ɲɤ̆w˨˩˨
nhay	ɲăj˧˧
nháy	ɲăj˦˥
nhày	ɲăj˧˨
nhảy	ɲăj˨˩˦
nhạy	ɲăj˨˩˨
nhây	ɲɤ̆j˧˧
nhầy	ɲɤ̆j˧˨
nhẩy	ɲɤ̆j˨˩˦
nhếch	ɲet˦˥
nhem	ɲɛm˧˧
nhèm	ɲɛm˧˨
nhẻm	ɲɛm˨˩˦
nhênh	ɲen˧˧
nhện	ɲen˨˩˨
nhen	ɲɛŋ˧˧
nhèn	ɲɛŋ˧˨
nhễ	ɲe˨˩˦
nhe	ɲɛ˧˧
nhè	ɲɛ˧˨
nhè	ɲɛ˧˨
nhẽ	ɲɛ˨˩˦
nhẻ	ɲɛ˨˩˦
nhẹ	ɲɛ˨˩˨
nheo	ɲeo˧˧
nhèo	ɲeo˧˨
nhẽo	ɲeo˨˩˦
nhếu	ɲɛu˦˥
nhều	ɲɛu˧˨
nhệu	ɲɛu˨˩˨
nhiếc	ɲiək˦˥
nhiễm	ɲim˨˩˦
nhiệm	ɲim˨˩˨
nhiên	ɲiəŋ˧˧
nhiếp	ɲip˦˥
nhiệt	ɲiək˨˩˨
nhiêu	ɲiəw˧˧
nhiều	ɲiəw˧˨
nhiễu	ɲiəw˨˩˦
nhím	ɲim˦˥
nhinh	ɲin˧˧
nhìn	ɲin˧˨
nhịn	ɲin˨˩˨
nhi	ɲi˧˧
nhí	ɲi˦˥
nhì	ɲi˧˨
nhĩ	ɲi˨˩˦
nhị	ɲi˨˩˨
nhíp	ɲip˦˥
nhịp	ɲip˨˩˨
nhiu	ɲiw˧˧
nhịu	ɲiw˨˩˨
nhoang	ɲwaŋ˧˧
nhoáng	ɲwaŋ˦˥
nhoay	ɲwăj˧˧
nhóc	ɲɔkp˦˥
nhọc	ɲɔkp˨˩˨
nhoen	ɲwen˧˧
nhoẻn	ɲwen˨˩˦
nhoe	ɲwe˧˧
nhoè	ɲwe˧˨
nhòe	ɲwe˧˨
nhoét	ɲwet˦˥
nhời	ɲɤj˧˨
nhồi	ɲoj˧˨
nhoi	ɲɔj˧˧
nhơm	ɲɤm˧˧
nhôm	ɲom˧˧
nhồm	ɲom˧˨
nhom	ɲɔm˧˧
nhóm	ɲɔm˦˥
nhòm	ɲɔm˧˨
nhỏm	ɲɔm˨˩˦
nhông	ɲoŋm˧˧
nhộng	ɲoŋm˨˩˨
nhong	ɲɔŋm˧˧
nhóng	ɲɔŋm˦˥
nhõng	ɲɔŋm˨˩˦
nhỏng	ɲɔŋm˨˩˦
nhơn	ɲɤŋ˧˧
nhớn	ɲɤŋ˦˥
nhờn	ɲɤŋ˧˨
nhỡn	ɲɤŋ˨˩˦
nhởn	ɲɤŋ˨˩˦
nhôn	ɲoŋm˧˧
nhốn	ɲoŋm˦˥
nhồn	ɲoŋm˧˨
nhộn	ɲoŋm˨˩˨
nhon	ɲɔŋm˧˧
nhón	ɲɔŋm˦˥
nhỏn	ɲɔŋm˨˩˦
nhọn	ɲɔŋm˨˩˨
nhơ	ɲɤ˧˧
nhớ	ɲɤ˦˥
nhờ	ɲɤ˧˨
nhỡ	ɲɤ˨˩˦
nhố	ɲo˦˥
nhổ	ɲo˨˩˦
nho	ɲɔ˧˧
nhỏ	ɲɔ˨˩˦
nhọ	ɲɔ˨˩˨
nhớp	ɲɤp˦˥
nhóp	ɲɔp˦˥
nhớt	ɲɤk˦˥
nhợt	ɲɤk˨˩˨
nhột	ɲokp˨˩˨
nhót	ɲɔkp˦˥
nhọt	ɲɔkp˨˩˨
nhuần	ɲwɤ̆ŋ˧˨
nhuận	ɲwɤ̆ŋ˨˩˨
nhựa	ɲɯə˨˩˨
nhúc	ɲukp˦˥
nhục	ɲukp˨˩˨
nhức	ɲɯk˦˥
nhuế	ɲwe˦˥
nhuệ	ɲwe˨˩˨
nhúm	ɲum˦˥
nhung	ɲuŋm˧˧
nhúng	ɲuŋm˦˥
nhùng	ɲuŋm˧˨
nhũng	ɲuŋm˨˩˦
nhủng	ɲuŋm˨˩˦
nhụng	ɲuŋm˨˩˨
nhưng	ɲɯŋ˧˧
những	ɲɯŋ˨˩˦
nhửng	ɲɯŋ˨˩˦
nhun	ɲuŋm˧˧
nhún	ɲuŋm˦˥
nhùn	ɲuŋm˧˨
nhũn	ɲuŋm˨˩˦
nhủn	ɲuŋm˨˩˦
nhu	ɲu˧˧
nhù	ɲu˧˨
nhũ	ɲu˨˩˦
nhủ	ɲu˨˩˦
như	ɲɯ˧˧
nhừ	ɲɯ˧˨
nhữ	ɲɯ˨˩˦
nhuốc	ɲuək˦˥
nhược	ɲɯək˨˩˨
nhuôm	ɲum˧˧
nhuốm	ɲum˦˥
nhuộm	ɲum˨˩˨
nhường	ɲɯəŋ˧˨
nhường	ɲɯəŋ˧˨
nhưỡng	ɲɯəŋ˨˩˦
nhượng	ɲɯəŋ˨˩˨
nhút	ɲukp˦˥
nhụt	ɲukp˨˩˨
nhựt	ɲɯk˨˩˨
nhuyễn	ɲwiəŋ˨˩˦
ních	nit˦˥
nịch	nit˨˩˨
niêm	nim˧˧
niềm	nim˧˨
niệm	nim˨˩˨
niềng	niəŋ˧˨
niên	niəŋ˧˧
niết	niək˦˥
niêu	niəw˧˧
niệu	niəw˨˩˨
ninh	nin˧˧
nình	nin˧˨
nịnh	nin˨˩˨
ni	ni˧˧
nì	ni˧˨
nỉ	ni˨˩˦
nin	nin˧˧
nín	nin˦˥
nịt	nit˨˩˨
niu	niw˧˧
níu	niw˦˥
noãn	nwaŋ˨˩˦
nốc	nokp˦˥
nóc	nɔkp˦˥
nọc	nɔkp˨˩˨
nơi	nɤj˧˧
nới	nɤj˦˥
nối	noj˦˥
nồi	noj˧˨
nỗi	noj˨˩˦
nổi	noj˨˩˦
nội	noj˨˩˨
noi	nɔj˧˧
nói	nɔj˦˥
nòi	nɔj˧˨
nơm	nɤm˧˧
nờm	nɤm˧˨
nôm	nom˧˧
nơ	nɤ˧˧
nỡ	nɤ˨˩˦
nở	nɤ˨˩˦
nợ	nɤ˨˩˨
nông	noŋm˧˧
nồng	noŋm˧˨
nong	nɔŋm˧˧
nóng	nɔŋm˦˥
nòng	nɔŋm˧˨
nôn	noŋm˧˧
nộn	noŋm˨˩˨
non	nɔŋm˧˧
nón	nɔŋm˦˥
nõn	nɔŋm˨˩˦
nô	no˧˧
nỗ	no˨˩˦
nổ	no˨˩˦
nộ	no˨˩˨
no	nɔ˧˧
no	nɔ˧˧
nó	nɔ˦˥
nõ	nɔ˨˩˦
nỏ	nɔ˨˩˦
nọ	nɔ˨˩˨
noong	nɔŋm˧˧
nớp	nɤp˦˥
nộp	nop˨˩˨
nốt	nokp˦˥
nót	nɔkp˦˥
nua	nuə˧˧
núa	nuə˦˥
nứa	nɯə˦˥
nữa	nɯə˨˩˦
nữa	nɯə˨˩˦
nửa	nɯə˨˩˦
núc	nukp˦˥
nục	nukp˨˩˨
nức	nɯk˦˥
nực	nɯk˨˩˨
núi	nuj˦˥
num	num˧˧
núm	num˦˥
nung	nuŋm˧˧
núng	nuŋm˦˥
nùng	nuŋm˧˨
nũng	nuŋm˨˩˦
nưng	nɯŋ˧˧
nựng	nɯŋ˨˩˨
nu	nu˧˧
nụ	nu˨˩˨
nữ	nɯ˨˩˦
nử	nɯ˨˩˦
nước	nɯək˦˥
nuôi	nuəj˧˧
nuối	nuəj˦˥
nườm	nɯm˧˨
nuông	nuəŋ˧˧
nương	nɯəŋ˧˧
nướng	nɯəŋ˦˥
nuốt	nuək˦˥
nuột	nuək˨˩˨
núp	nup˦˥
nút	nukp˦˥
nứt	nɯk˦˥
oác	wak˦˥
oai	waj˧˧
oái	waj˦˥
oải	waj˨˩˦
oàm	wam˧˨
oang	waŋ˧˧
oàng	waŋ˧˨
oăng	wăŋ˧˧
oanh	wan˧˧
oành	wan˧˨
oan	waŋ˧˧
oán	waŋ˦˥
oăn	wăŋ˧˧
oằn	wăŋ˧˨
oẳn	wăŋ˨˩˦
oản	waŋ˨˩˦
oắt	wăk˦˥
oặt	wăk˨˩˨
oát	wat˦˥
oa	wa˧˧
ốc	okp˦˥
ộc	okp˨˩˨
óc	ɔkp˦˥
ọc	ɔkp˨˩˨
oeng	wen˧˧
oe	we˧˧
oé	we˦˥
oẻ	we˨˩˦
ỏe	we˨˩˦
ơ	ɤ˧˧
ớ	ɤ˦˥
ờ	ɤ˧˨
ở	ɤ˨˩˦
ợ	ɤ˨˩˨
ơi	ɤj˧˧
ời	ɤj˧˨
ôi	oj˧˧
ối	oj˦˥
ồi	oj˧˨
ổi	oj˨˩˦
oi	ɔj˧˧
ói	ɔj˦˥
òi	ɔj˧˨
ỏi	ɔj˨˩˦
ỡm	ɤm˨˩˦
ôm	om˧˧
ốm	om˦˥
ồm	om˧˨
ổm	om˨˩˦
om	ɔm˧˧
òm	ɔm˧˨
ỏm	ɔm˨˩˦
ơn	ɤŋ˧˧
ớn	ɤŋ˦˥
ờn	ɤŋ˧˨
ông	oŋm˧˧
ống	oŋm˦˥
ồng	oŋm˧˨
ong	ɔŋm˧˧
óng	ɔŋm˦˥
òng	ɔŋm˧˨
õng	ɔŋm˨˩˦
ỏng	ɔŋm˨˩˦
ôn	oŋm˧˧
ồn	oŋm˧˨
ổn	oŋm˨˩˦
ộn	oŋm˨˩˨
ỏn	ɔŋm˨˩˦
ô	o˧˧
ố	o˦˥
ồ	o˧˨
ổ	o˨˩˦
ộ	o˨˩˨
oong	ɔŋm˧˧
o	ɔ˧˧
ó	ɔ˦˥
ò	ɔ˧˨
ọ	ɔ˨˩˨
ốp	op˦˥
ộp	op˨˩˨
óp	ɔp˦˥
ọp	ɔp˨˩˨
ớt	ɤk˦˥
ốt	okp˦˥
ô-tô	o˧˧-to˧˧
ót	ɔkp˦˥
ọt	ɔkp˨˩˨
o-xi	ɔ˧˧-si˧˧
o-xít	ɔ˧˧-sit˦˥
o-xy	ɔ˧˧-si˧˧
pác	pak˦˥
pa	pa˧˧
pà	pa˧˨
pát	pat˦˥
pâu	pɤ̆w˧˧
pe-man-ga-nát	pɛ˧˧-maŋ˧˧-ɣa˧˧-nat˦˥
pen	pɛŋ˧˧
pê	pe˧˧
phác	fak˦˥
phắc	făk˦˥
phách	fat˦˥
phạch	fat˨˩˨
pha	fa˧˧
phá	fa˦˥
phà	fa˧˨
phả	fa˨˩˦
phai	faj˧˧
phái	faj˦˥
phải	faj˨˩˦
phàm	fam˧˨
phăm	făm˧˧
phạm	fam˨˩˨
phầm	fɤ̆m˧˨
phẩm	fɤ̆m˨˩˦
phán	faŋ˦˥
phàn	faŋ˧˨
phăn	făŋ˧˧
phản	faŋ˨˩˦
phạn	faŋ˨˩˨
phân	fɤ̆ŋ˧˧
phấn	fɤ̆ŋ˦˥
phần	fɤ̆ŋ˧˨
phẫn	fɤ̆ŋ˨˩˦
phận	fɤ̆ŋ˨˩˨
phang	faŋ˧˧
phăng	făŋ˧˧
phẳng	făŋ˨˩˦
phảng	faŋ˨˩˦
phanh	fan˧˧
phành	fan˧˨
phao	faw˧˧
pháo	faw˦˥
pháp	fap˦˥
pháp	fap˦˥
phấp	fɤ̆p˦˥
phập	fɤ̆p˨˩˨
phắt	făk˦˥
phát	fat˦˥
phạt	fat˨˩˨
phất	fɤ̆k˦˥
phật	fɤ̆k˨˩˨
phau	făw˧˧
phẫu	fɤ̆w˨˩˦
phay	făj˧˧
phây	fɤ̆j˧˧
phẩy	fɤ̆j˨˩˦
phéc	fɛk˦˥
phê	fe˧˧
phế	fe˦˥
phề	fe˧˨
phệ	fe˨˩˨
phe	fɛ˧˧
phè	fɛ˧˨
phên	fen˧˧
phèn	fɛŋ˧˨
phèng	fɛŋ˧˨
phềnh	fen˧˨
phệnh	fen˨˩˨
phép	fɛp˦˥
phét	fɛt˦˥
phẹt	fɛt˨˩˨
phều	fɛu˧˨
phìa	fiə˧˨
phiếm	fim˦˥
phiên	fiəŋ˧˧
phiến	fiəŋ˦˥
phiền	fiəŋ˧˨
phiệt	fiək˨˩˨
phiêu	fiəw˧˧
phiếu	fiəw˦˥
phi	fi˧˧
phí	fi˦˥
phì	fi˧˨
phỉ	fi˨˩˦
phim	fim˧˧
phím	fim˦˥
phin	fin˧˧
phìn	fin˧˨
phinh	fin˧˧
phình	fin˧˨
phĩnh	fin˨˩˦
phỉnh	fin˨˩˦
phịu	fiw˨˩˨
phốc	fokp˦˥
phơ	fɤ˧˧
phờ	fɤ˧˨
phở	fɤ˨˩˦
phô	fo˧˧
phố	fo˦˥
phổ	fo˨˩˦
pho	fɔ˧˧
phó	fɔ˦˥
phò	fɔ˧˨
phơi	fɤj˧˧
phới	fɤj˦˥
phôi	foj˧˧
phối	foj˦˥
phổi	foj˨˩˦
phòi	fɔj˧˨
phôm	fom˧˧
phồm	fom˧˨
phơn	fɤŋ˧˧
phớn	fɤŋ˦˥
phởn	fɤŋ˨˩˦
phồn	foŋm˧˨
phông	foŋm˧˧
phồng	foŋm˧˨
phỗng	foŋm˨˩˦
phổng	foŋm˨˩˦
phộng	foŋm˨˩˨
phong	fɔŋm˧˧
phóng	fɔŋm˦˥
phòng	fɔŋm˧˨
phỏng	fɔŋm˨˩˦
phọng	fɔŋm˨˩˨
phoóc	fɔkp˦˥
phốp	fop˦˥
phớt	fɤk˦˥
phốt	fokp˦˥
phọt	fɔkp˨˩˨
phứa	fɯə˦˥
phúc	fukp˦˥
phục	fukp˨˩˨
phức	fɯk˦˥
phu	fu˧˧
phú	fu˦˥
phù	fu˧˨
phũ	fu˨˩˦
phủ	fu˨˩˦
phủ	fu˨˩˦
phụ	fu˨˩˨
phui	fuj˧˧
phủi	fuj˨˩˦
phun	fuŋm˧˧
phún	fuŋm˦˥
phùn	fuŋm˧˨
phừn	fɯŋ˧˨
phung	fuŋm˧˧
phúng	fuŋm˦˥
phùng	fuŋm˧˨
phụng	fuŋm˨˩˨
phưng	fɯŋ˧˧
phừng	fɯŋ˧˨
phước	fɯək˦˥
phướn	fɯəŋ˦˥
phương	fɯəŋ˧˧
phường	fɯəŋ˧˨
phượng	fɯəŋ˨˩˨
phút	fukp˦˥
pin	pin˧˧
pi	pi˧˧
pít	pit˦˥
pô-li-me	po˧˧-li˧˧-mɛ˧˧
pom	pɔm˧˧
pơ	pɤ˧˧
pô	po˧˧
puốc	puək˦˥
pu	pu˧˧
quách	wat˦˥
quác	wak˦˥
quắc	wăk˦˥
quạc	wak˨˩˨
quai	waj˧˧
quái	waj˦˥
quài	waj˧˨
quải	waj˨˩˦
quăm	wăm˧˧
quằm	wăm˧˨
quặm	wăm˨˩˨
quang	waŋ˧˧
quáng	waŋ˦˥
quàng	waŋ˧˨
quăng	wăŋ˧˧
quẳng	wăŋ˨˩˦
quãng	waŋ˨˩˦
quảng	waŋ˨˩˦
quầng	wɤ̆ŋ˧˨
quẩng	wɤ̆ŋ˨˩˦
quanh	wan˧˧
quánh	wan˦˥
quành	wan˧˨
quạnh	wan˨˩˨
quan	waŋ˧˧
quán	waŋ˦˥
quăn	wăŋ˧˧
quằn	wăŋ˧˨
quản	waŋ˨˩˦
quặn	wăŋ˨˩˨
quân	wɤ̆ŋ˧˧
quấn	wɤ̆ŋ˦˥
quần	wɤ̆ŋ˧˨
quẫn	wɤ̆ŋ˨˩˦
quẩn	wɤ̆ŋ˨˩˦
quận	wɤ̆ŋ˨˩˨
quắp	wăp˦˥
quặp	wăp˨˩˨
quắt	wăk˦˥
quặt	wăk˨˩˨
quát	wat˦˥
quạt	wat˨˩˨
quất	wɤ̆k˦˥
quật	wɤ̆k˨˩˨
quau	wăw˧˧
quàu	wăw˧˨
quạu	wăw˨˩˨
qua	wa˧˧
quá	wa˦˥
quá	wa˦˥
quà	wa˧˨
quả	wa˨˩˦
quạ	wa˨˩˨
quay	wăj˧˧
quày	wăj˧˨
quảy	wăj˨˩˦
quây	wɤ̆j˧˧
quấy	wɤ̆j˦˥
quầy	wɤ̆j˧˨
quậy	wɤ̆j˨˩˨
quếch	wet˦˥
quệch	wet˨˩˨
queng	wɛŋ˧˧
quếnh	wen˦˥
quềnh	wen˧˨
quệnh	wen˨˩˨
quên	wen˧˧
quến	wen˦˥
quen	wɛŋ˧˧
quèn	wɛŋ˧˨
queo	weo˧˧
quèo	weo˧˨
quẹo	weo˨˩˨
quết	wet˦˥
quét	wɛt˦˥
quẹt	wɛt˨˩˨
quếu	wɛu˦˥
quều	wɛu˧˨
quê	we˧˧
quế	we˦˥
quề	we˧˨
que	wɛ˧˧
què	wɛ˧˨
quẻ	wɛ˨˩˦
quình	win˧˨
quít	wit˦˥
qui	wi˧˧
quí	wi˦˥
quì	wi˧˨
quĩ	wi˨˩˦
quỉ	wi˨˩˦
quị	wi˨˩˨
quốc	wokp˦˥
quới	wɤj˦˥
quờn	wɤŋ˧˨
quơ	wɤ˧˧
quờ	wɤ˧˨
quở	wɤ˨˩˦
quyên	wiɛŋ˧˧
quyến	wiɛŋ˦˥
quyền	wiɛŋ˧˨
quyển	wiɛŋ˨˩˦
quyết	wiɛt˦˥
quýnh	win˦˥
quỳnh	win˧˨
quýt	wit˦˥
quy	wi˧˧
quý	wi˦˥
quỳ	wi˧˨
quỹ	wi˨˩˦
quỷ	wi˨˩˦
quỵ	wi˨˩˨
rách	ʐat˦˥
rạch	ʐat˨˩˨
rác	ʐak˦˥
rắc	ʐăk˦˥
rạc	ʐak˨˩˨
ra-đi-ô	ʐa˧˧-di˧˧-o˧˧
rái	ʐaj˦˥
rãi	ʐaj˨˩˦
rải	ʐaj˨˩˦
ram	ʐam˧˧
rám	ʐam˦˥
răm	ʐăm˧˧
rắm	ʐăm˦˥
rằm	ʐăm˧˨
rặm	ʐăm˨˩˨
râm	ʐɤ̆m˧˧
rấm	ʐɤ̆m˦˥
rầm	ʐɤ̆m˧˨
rậm	ʐɤ̆m˨˩˨
rang	ʐaŋ˧˧
ráng	ʐaŋ˦˥
ràng	ʐaŋ˧˨
răng	ʐăŋ˧˧
rằng	ʐăŋ˧˨
rạng	ʐaŋ˨˩˨
ranh	ʐan˧˧
rành	ʐan˧˨
rãnh	ʐan˨˩˦
rảnh	ʐan˨˩˦
ran	ʐaŋ˧˧
rán	ʐaŋ˦˥
ràn	ʐaŋ˧˨
răn	ʐăŋ˧˧
rắn	ʐăŋ˦˥
rằn	ʐăŋ˧˨
rạn	ʐaŋ˨˩˨
rân	ʐɤ̆ŋ˧˧
rấn	ʐɤ̆ŋ˦˥
rần	ʐɤ̆ŋ˧˨
rận	ʐɤ̆ŋ˨˩˨
rao	ʐaw˧˧
ráo	ʐaw˦˥
rào	ʐaw˧˨
rảo	ʐaw˨˩˦
rạo	ʐaw˨˩˨
ráp	ʐap˦˥
rắp	ʐăp˦˥
rạp	ʐap˨˩˨
rấp	ʐɤ̆p˦˥
rập	ʐɤ̆p˨˩˨
rặt	ʐăk˨˩˨
rát	ʐat˦˥
rất	ʐɤ̆k˦˥
rau	ʐăw˧˧
ráu	ʐăw˦˥
râu	ʐɤ̆w˧˧
rầu	ʐɤ̆w˧˨
ray	ʐăj˧˧
ráy	ʐăj˦˥
rày	ʐăj˧˨
rầy	ʐɤ̆j˧˨
rẫy	ʐɤ̆j˨˩˦
ra	ʐa˧˧
ra	ʐa˧˧
rá	ʐa˦˥
rà	ʐa˧˨
rã	ʐa˨˩˦
rả	ʐa˨˩˦
rạ	ʐa˨˩˨
rếch	ʐet˦˥
reng	ʐɛŋ˧˧
rềnh	ʐen˧˨
rểnh	ʐen˨˩˦
rên	ʐen˧˧
rền	ʐen˧˨
ren	ʐɛŋ˧˧
rén	ʐɛŋ˦˥
rèn	ʐɛŋ˧˨
reo	ʐeo˧˧
réo	ʐeo˦˥
rèo	ʐeo˧˨
rẻo	ʐeo˨˩˦
rẹo	ʐeo˨˩˨
rệp	ʐep˨˩˨
rết	ʐet˦˥
rét	ʐɛt˦˥
rêu	ʐɛu˧˧
rệu	ʐɛu˨˩˨
rế	ʐe˦˥
rề	ʐe˧˨
rễ	ʐe˨˩˦
rể	ʐe˨˩˦
re	ʐɛ˧˧
ré	ʐɛ˦˥
rè	ʐɛ˧˨
rẽ	ʐɛ˨˩˦
rẻ	ʐɛ˨˩˦
rịa-vũng	ʐiə˨˩˨-juŋm˨˩˦
rìa	ʐiə˧˨
rỉa	ʐiə˨˩˦
rích	ʐit˦˥
rịch	ʐit˨˩˨
riêng	ʐiəŋ˧˧
riềng	ʐiəŋ˧˨
riết	ʐiək˦˥
riêu	ʐiəw˧˧
rinh	ʐin˧˧
rình	ʐin˧˨
rin	ʐin˧˧
rít	ʐit˦˥
riu	ʐiw˧˧
ríu	ʐiw˦˥
rìu	ʐiw˧˨
ri	ʐi˧˧
rí	ʐi˦˥
rì	ʐi˧˨
rĩ	ʐi˨˩˦
rỉ	ʐi˨˩˦
rị	ʐi˨˩˨
rốc	ʐokp˦˥
rộc	ʐokp˨˩˨
róc	ʐɔkp˦˥
rọc	ʐɔkp˨˩˨
rơi	ʐɤj˧˧
rời	ʐɤj˧˨
rối	ʐoj˦˥
rồi	ʐoj˧˨
rỗi	ʐoj˨˩˦
roi	ʐɔj˧˧
rơm	ʐɤm˧˧
rờm	ʐɤm˧˨
rởm	ʐɤm˨˩˦
rôm	ʐom˧˧
rồm	ʐom˧˨
ròm	ʐɔm˧˨
rông	ʐoŋm˧˧
rống	ʐoŋm˦˥
rồng	ʐoŋm˧˨
rỗng	ʐoŋm˨˩˦
rộng	ʐoŋm˨˩˨
rong	ʐɔŋm˧˧
ròng	ʐɔŋm˧˨
rơn	ʐɤŋ˧˧
rờn	ʐɤŋ˧˨
rởn	ʐɤŋ˨˩˦
rợn	ʐɤŋ˨˩˨
rôn	ʐoŋm˧˧
rốn	ʐoŋm˦˥
rồn	ʐoŋm˧˨
rổn	ʐoŋm˨˩˦
rộn	ʐoŋm˨˩˨
rón	ʐɔŋm˦˥
ròn	ʐɔŋm˧˨
rợp	ʐɤp˨˩˨
rớt	ʐɤk˦˥
rốt	ʐokp˦˥
rột	ʐokp˨˩˨
rót	ʐɔkp˦˥
rọt	ʐɔkp˨˩˨
rơ	ʐɤ˧˧
rờ	ʐɤ˧˨
rỡ	ʐɤ˨˩˦
rợ	ʐɤ˨˩˨
rô	ʐo˧˧
rồ	ʐo˧˨
rỗ	ʐo˨˩˦
rổ	ʐo˨˩˦
rộ	ʐo˨˩˨
ro	ʐɔ˧˧
ró	ʐɔ˦˥
rò	ʐɔ˧˨
rõ	ʐɔ˨˩˦
rỏ	ʐɔ˨˩˦
rọ	ʐɔ˨˩˨
rùa	ʐuə˧˨
rủa	ʐuə˨˩˦
rưa	ʐɯə˧˧
rữa	ʐɯə˨˩˦
rửa	ʐɯə˨˩˦
rựa	ʐɯə˨˩˨
rúc	ʐukp˦˥
rục	ʐukp˨˩˨
rực	ʐɯk˨˩˨
rúi	ʐuj˦˥
rủi	ʐuj˨˩˦
rúm	ʐum˦˥
rùm	ʐum˧˨
rung	ʐuŋm˧˧
rúng	ʐuŋm˦˥
rùng	ʐuŋm˧˨
rủng	ʐuŋm˨˩˦
rụng	ʐuŋm˨˩˨
rưng	ʐɯŋ˧˧
rừng	ʐɯŋ˧˨
rửng	ʐɯŋ˨˩˦
run	ʐuŋm˧˧
rún	ʐuŋm˦˥
rủn	ʐuŋm˨˩˦
ruốc	ʐuək˦˥
rước	ʐɯək˦˥
ruồi	ʐuəj˧˨
ruổi	ʐuəj˨˩˦
rươi	ʐɯəj˧˧
rười	ʐɯəj˧˨
rươm	ʐɯm˧˧
rườm	ʐɯm˧˨
ruồng	ʐuəŋ˧˨
ruỗng	ʐuəŋ˨˩˦
ruộng	ʐuəŋ˨˩˨
rương	ʐɯəŋ˧˧
rường	ʐɯəŋ˧˨
ruôn	ʐuəŋ˧˧
rướn	ʐɯəŋ˦˥
rườn	ʐɯəŋ˧˨
rượn	ʐɯəŋ˨˩˨
ruột	ʐuək˨˩˨
rượu	ʐɯəw˨˩˨
rụp	ʐup˨˩˨
rút	ʐukp˦˥
rụt	ʐukp˨˩˨
rứt	ʐɯk˦˥
ru	ʐu˧˧
rú	ʐu˦˥
rù	ʐu˧˨
rũ	ʐu˨˩˦
rủ	ʐu˨˩˦
rụ	ʐu˨˩˨
sách	ʂat˦˥
sạch	ʂat˨˩˨
sắc	ʂăk˦˥
sặc	ʂăk˨˩˨
sai	ʂaj˧˧
sái	ʂaj˦˥
sài	ʂaj˧˨
sãi	ʂaj˨˩˦
sải	ʂaj˨˩˦
sam	ʂam˧˧
sám	ʂam˦˥
sàm	ʂam˧˨
săm	ʂăm˧˧
sắm	ʂăm˦˥
sạm	ʂam˨˩˨
sặm	ʂăm˨˩˨
sâm	ʂɤ̆m˧˧
sấm	ʂɤ̆m˦˥
sầm	ʂɤ̆m˧˨
sẩm	ʂɤ̆m˨˩˦
sậm	ʂɤ̆m˨˩˨
sang	ʂaŋ˧˧
sáng	ʂaŋ˦˥
sàng	ʂaŋ˧˨
săng	ʂăŋ˧˧
sằng	ʂăŋ˧˨
sảng	ʂaŋ˨˩˦
sanh	ʂan˧˧
sánh	ʂan˦˥
sành	ʂan˧˨
sảnh	ʂan˨˩˦
san	ʂaŋ˧˧
sán	ʂaŋ˦˥
sàn	ʂaŋ˧˨
săn	ʂăŋ˧˧
sắn	ʂăŋ˦˥
sẵn	ʂăŋ˨˩˦
sản	ʂaŋ˨˩˦
sạn	ʂaŋ˨˩˨
sân	ʂɤ̆ŋ˧˧
sấn	ʂɤ̆ŋ˦˥
sần	ʂɤ̆ŋ˧˨
sao	ʂaw˧˧
sáo	ʂaw˦˥
sào	ʂaw˧˨
sảo	ʂaw˨˩˦
sạo	ʂaw˨˩˨
sáp	ʂap˦˥
sắp	ʂăp˦˥
sẵp	ʂăp˨˩˦
sạp	ʂap˨˩˨
sấp	ʂɤ̆p˦˥
sập	ʂɤ̆p˨˩˨
sa	ʂa˧˧
sá	ʂa˦˥
sà	ʂa˧˨
sã	ʂa˨˩˦
sả	ʂa˨˩˦
sắt	ʂăk˦˥
sặt	ʂăk˨˩˨
sát	ʂat˦˥
sạt	ʂat˨˩˨
sau	ʂăw˧˧
sáu	ʂăw˦˥
sâu	ʂɤ̆w˧˧
sầu	ʂɤ̆w˧˨
say	ʂăj˧˧
sảy	ʂăj˨˩˦
sây	ʂɤ̆j˧˧
sấy	ʂɤ̆j˦˥
sầy	ʂɤ̆j˧˨
sẩy	ʂɤ̆j˨˩˦
sém	ʂɛm˦˥
sênh	ʂen˧˧
sềnh	ʂen˧˨
sểnh	ʂen˨˩˦
sên	ʂen˧˧
sến	ʂen˦˥
sền	ʂen˧˨
sen	ʂɛŋ˧˧
sẻn	ʂɛŋ˨˩˦
seo	ʂeo˧˧
sẹo	ʂeo˨˩˨
sếp	ʂep˦˥
sê	ʂe˧˧
sề	ʂe˧˨
sệ	ʂe˨˩˨
se	ʂɛ˧˧
sè	ʂɛ˧˨
sẽ	ʂɛ˨˩˦
sẻ	ʂɛ˨˩˦
sét	ʂɛt˦˥
sêu	ʂɛu˧˧
sếu	ʂɛu˦˥
sỉa	ʂiə˨˩˦
siểm	ʂim˨˩˦
siêng	ʂiəŋ˧˧
siết	ʂiək˦˥
siêu	ʂiəw˧˧
sim	ʂim˧˧
sinh	ʂin˧˧
sính	ʂin˦˥
sình	ʂin˧˨
sin	ʂin˧˧
sín	ʂin˦˥
sìn	ʂin˧˨
si	ʂi˧˧
sì	ʂi˧˨
sĩ	ʂi˨˩˦
sỉ	ʂi˨˩˦
sít	ʂit˦˥
sịt	ʂit˨˩˨
soái	ʂwaj˦˥
soàm	ʂwam˧˨
soán	ʂwaŋ˦˥
soàn	ʂwaŋ˧˨
soạn	ʂwaŋ˨˩˨
soát	ʂwat˦˥
sộc	ʂokp˨˩˨
sóc	ʂɔkp˦˥
sợi	ʂɤj˨˩˨
sôi	ʂoj˧˧
sồi	ʂoj˧˨
soi	ʂɔj˧˧
sói	ʂɔj˦˥
sõi	ʂɔj˨˩˦
sỏi	ʂɔj˨˩˦
sơm	ʂɤm˧˧
sớm	ʂɤm˦˥
sờm	ʂɤm˧˨
sóm	ʂɔm˦˥
sòm	ʂɔm˧˨
sọm	ʂɔm˨˩˨
sông	ʂoŋm˧˧
sống	ʂoŋm˦˥
sồng	ʂoŋm˧˨
sổng	ʂoŋm˨˩˦
song	ʂɔŋm˧˧
sóng	ʂɔŋm˦˥
sòng	ʂɔŋm˧˨
sõng	ʂɔŋm˨˩˦
sơn	ʂɤŋ˧˧
sớn	ʂɤŋ˦˥
sờn	ʂɤŋ˧˨
sởn	ʂɤŋ˨˩˦
sồn	ʂoŋm˧˨
son	ʂɔŋm˧˧
sòn	ʂɔŋm˧˨
sốp	ʂop˦˥
sơ	ʂɤ˧˧
sớ	ʂɤ˦˥
sờ	ʂɤ˧˨
sở	ʂɤ˨˩˦
sợ	ʂɤ˨˩˨
sô	ʂo˧˧
số	ʂo˦˥
sồ	ʂo˧˨
sỗ	ʂo˨˩˦
sổ	ʂo˨˩˦
so	ʂɔ˧˧
sò	ʂɔ˧˨
sọ	ʂɔ˨˩˨
sốt	ʂokp˦˥
sột	ʂokp˨˩˨
sót	ʂɔkp˦˥
sọt	ʂɔkp˨˩˨
sô-vanh	ʂo˧˧-jan˧˧
sủa	ʂuə˨˩˦
sứa	ʂɯə˦˥
sữa	ʂɯə˨˩˦
sửa	ʂɯə˨˩˦
suất	ʂwɤ̆k˦˥
suất	ʂwɤ̆k˦˥
súc	ʂukp˦˥
sục	ʂukp˨˩˨
sức	ʂɯk˦˥
sực	ʂɯk˨˩˨
sui	ʂuj˧˧
sùi	ʂuj˧˨
sủi	ʂuj˨˩˦
sum	ʂum˧˧
sùm	ʂum˧˨
sụm	ʂum˨˩˨
sung	ʂuŋm˧˧
súng	ʂuŋm˦˥
sùng	ʂuŋm˧˨
sủng	ʂuŋm˨˩˦
sưng	ʂɯŋ˧˧
sừng	ʂɯŋ˧˨
sững	ʂɯŋ˨˩˦
sửng	ʂɯŋ˨˩˦
sựng	ʂɯŋ˨˩˨
sun-phát	ʂuŋm˧˧-fat˦˥
sun	ʂuŋm˧˧
sún	ʂuŋm˦˥
sụn	ʂuŋm˨˩˨
sừn	ʂɯŋ˧˨
suối	ʂuəj˦˥
sưởi	ʂɯəj˨˩˦
suông	ʂuəŋ˧˧
suồng	ʂuəŋ˧˨
sương	ʂɯəŋ˧˧
sướng	ʂɯəŋ˦˥
sường	ʂɯəŋ˧˨
sượng	ʂɯəŋ˨˩˨
suôn	ʂuəŋ˧˧
sườn	ʂɯəŋ˧˨
suốt	ʂuək˦˥
sướt	ʂɯək˦˥
súp	ʂup˦˥
sụp	ʂup˨˩˨
su	ʂu˧˧
sú	ʂu˦˥
sù	ʂu˧˨
sù	ʂu˧˨
sủ	ʂu˨˩˦
sụ	ʂu˨˩˨
sư	ʂɯ˧˧
sứ	ʂɯ˦˥
sử	ʂɯ˨˩˦
sự	ʂɯ˨˩˨
sút	ʂukp˦˥
sụt	ʂukp˨˩˨
sứt	ʂɯk˦˥
sưu	ʂɯw˧˧
súy	ʂuj˦˥
suy	ʂwi˧˧
suý	ʂwi˦˥
suýt	ʂwit˦˥
suỵt	ʂwit˨˩˨
sỹ	ʂi˨˩˦
tách	tat˦˥
tác	tak˦˥
tắc	tăk˦˥
tạc	tak˨˩˨
tặc	tăk˨˩˨
tấc	tɤ̆k˦˥
tai	taj˧˧
tai	taj˧˧
tái	taj˦˥
tài	taj˧˨
tải	taj˨˩˦
tại	taj˨˩˨
tam	tam˧˧
tám	tam˦˥
tàm	tam˧˨
tăm	tăm˧˧
tắm	tăm˦˥
tằm	tăm˧˨
tạm	tam˨˩˨
tâm	tɤ̆m˧˧
tấm	tɤ̆m˦˥
tầm	tɤ̆m˧˨
tẩm	tɤ̆m˨˩˦
tậm	tɤ̆m˨˩˨
tang	taŋ˧˧
táng	taŋ˦˥
tàng	taŋ˧˨
tăng	tăŋ˧˧
tằng	tăŋ˧˨
tảng	taŋ˨˩˦
tạng	taŋ˨˩˨
tặng	tăŋ˨˩˨
tâng	tɤ̆ŋ˧˧
tầng	tɤ̆ŋ˧˨
tanh	tan˧˧
tánh	tan˦˥
tành	tan˧˨
tạnh	tan˨˩˨
tan	taŋ˧˧
tán	taŋ˦˥
tàn	taŋ˧˨
tằn	tăŋ˧˨
tẳn	tăŋ˨˩˦
tản	taŋ˨˩˦
tân	tɤ̆ŋ˧˧
tấn	tɤ̆ŋ˦˥
tần	tɤ̆ŋ˧˨
tẩn	tɤ̆ŋ˨˩˦
tận	tɤ̆ŋ˨˩˨
tao	taw˧˧
táo	taw˦˥
tào	taw˧˨
tảo	taw˨˩˦
tạo	taw˨˩˨
táp	tap˦˥
tắp	tăp˦˥
tạp	tap˨˩˨
tấp	tɤ̆p˦˥
tập	tɤ̆p˨˩˨
ta	ta˧˧
tá	ta˦˥
tà	ta˧˨
tà	ta˧˨
tã	ta˨˩˦
tả	ta˨˩˦
tạ	ta˨˩˨
tắt	tăk˦˥
tát	tat˦˥
tạt	tat˨˩˨
tất	tɤ̆k˦˥
tật	tɤ̆k˨˩˨
tàu	tăw˧˨
tâu	tɤ̆w˧˧
tấu	tɤ̆w˦˥
tầu	tɤ̆w˧˨
tẩu	tɤ̆w˨˩˦
tậu	tɤ̆w˨˩˨
tay	tăj˧˧
táy	tăj˦˥
tày	tăj˧˨
tây	tɤ̆j˧˧
tầy	tɤ̆j˧˨
tẩy	tɤ̆j˨˩˦
tếch	tet˦˥
têm	tem˧˧
tem	tɛm˧˧
tèm	tɛm˧˨
teng	tɛŋ˧˧
tèng	tɛŋ˧˨
tênh	ten˧˧
tềnh	ten˧˨
tên	ten˧˧
ten	tɛŋ˧˧
tén	tɛŋ˦˥
tèn	tɛŋ˧˨
tẽn	tɛŋ˨˩˦
teo	teo˧˧
tèo	teo˧˨
tẻo	teo˨˩˦
tép	tɛp˦˥
tẹp	tɛp˨˩˨
tê	te˧˧
tế	te˦˥
tề	te˧˨
tễ	te˨˩˦
tể	te˨˩˦
tệ	te˨˩˨
te	tɛ˧˧
té	tɛ˦˥
tè	tɛ˧˨
tẻ	tɛ˨˩˦
tết	tet˦˥
tẹt	tɛt˨˩˨
tếu	tɛu˦˥
thách	tʰat˦˥
thạch	tʰat˨˩˨
thác	tʰak˦˥
thắc	tʰăk˦˥
thạc	tʰak˨˩˨
thai	tʰaj˧˧
thái	tʰaj˦˥
thài	tʰaj˧˨
thải	tʰaj˨˩˦
tham	tʰam˧˧
thám	tʰam˦˥
thàm	tʰam˧˨
thăm	tʰăm˧˧
thắm	tʰăm˦˥
thẳm	tʰăm˨˩˦
thảm	tʰam˨˩˦
thâm	tʰɤ̆m˧˧
thấm	tʰɤ̆m˦˥
thầm	tʰɤ̆m˧˨
thẩm	tʰɤ̆m˨˩˦
thậm	tʰɤ̆m˨˩˨
thang	tʰaŋ˧˧
tháng	tʰaŋ˦˥
thăng	tʰăŋ˧˧
thắng	tʰăŋ˦˥
thằng	tʰăŋ˧˨
thẳng	tʰăŋ˨˩˦
thảng	tʰaŋ˨˩˦
thặng	tʰăŋ˨˩˨
thanh	tʰan˧˧
thánh	tʰan˦˥
thành	tʰan˧˨
thảnh	tʰan˨˩˦
thạnh	tʰan˨˩˨
than	tʰaŋ˧˧
thán	tʰaŋ˦˥
thăn	tʰăŋ˧˧
thằn	tʰăŋ˧˨
thản	tʰaŋ˨˩˦
thân	tʰɤ̆ŋ˧˧
thần	tʰɤ̆ŋ˧˨
thẫn	tʰɤ̆ŋ˨˩˦
thẩn	tʰɤ̆ŋ˨˩˦
thận	tʰɤ̆ŋ˨˩˨
thao	tʰaw˧˧
tháo	tʰaw˦˥
thào	tʰaw˧˨
thảo	tʰaw˨˩˦
thạo	tʰaw˨˩˨
tháp	tʰap˦˥
thắp	tʰăp˦˥
thấp	tʰɤ̆p˦˥
thập	tʰɤ̆p˨˩˨
tha	tʰa˧˧
thà	tʰa˧˨
thả	tʰa˨˩˦
thắt	tʰăk˦˥
thát	tʰat˦˥
thất	tʰɤ̆k˦˥
thật	tʰɤ̆k˨˩˨
thau	tʰăw˧˧
tháu	tʰăw˦˥
thâu	tʰɤ̆w˧˧
thấu	tʰɤ̆w˦˥
thầu	tʰɤ̆w˧˨
thẩu	tʰɤ̆w˨˩˦
thay	tʰăj˧˧
tháy	tʰăj˦˥
thày	tʰăj˧˨
thảy	tʰăj˨˩˦
thây	tʰɤ̆j˧˧
thấy	tʰɤ̆j˦˥
thầy	tʰɤ̆j˧˨
thêm	tʰem˧˧
thềm	tʰem˧˨
thèm	tʰɛm˧˨
thênh	tʰen˧˧
then	tʰɛŋ˧˧
thèn	tʰɛŋ˧˨
thẹn	tʰɛŋ˨˩˨
theo	tʰeo˧˧
thèo	tʰeo˧˨
thếp	tʰep˦˥
thép	tʰɛp˦˥
thẹp	tʰɛp˨˩˨
thê	tʰe˧˧
thế	tʰe˦˥
thề	tʰe˧˨
thể	tʰe˨˩˦
thệ	tʰe˨˩˨
the	tʰɛ˧˧
thè	tʰɛ˧˨
thẽ	tʰɛ˨˩˦
thẻ	tʰɛ˨˩˦
thết	tʰet˦˥
thét	tʰɛt˦˥
thêu	tʰɛu˧˧
thều	tʰɛu˧˨
thia	tʰiə˧˧
thìa	tʰiə˧˨
thích	tʰit˦˥
thịch	tʰit˨˩˨
thiếc	tʰiək˦˥
thiêm	tʰim˧˧
thiềm	tʰim˧˨
thiểm	tʰim˨˩˦
thiêng	tʰiəŋ˧˧
thiên	tʰiəŋ˧˧
thiền	tʰiəŋ˧˨
thiển	tʰiəŋ˨˩˦
thiện	tʰiəŋ˨˩˨
thiếp	tʰip˦˥
thiệp	tʰip˨˩˨
thiết	tʰiək˦˥
thiệt	tʰiək˨˩˨
thiêu	tʰiəw˧˧
thiếu	tʰiəw˦˥
thiều	tʰiəw˧˨
thiểu	tʰiəw˨˩˦
thiệu	tʰiəw˨˩˨
thinh	tʰin˧˧
thính	tʰin˦˥
thình	tʰin˧˨
thỉnh	tʰin˨˩˦
thịnh	tʰin˨˩˨
thin	tʰin˧˧
thi	tʰi˧˧
thí	tʰi˦˥
thì	tʰi˧˨
thỉ	tʰi˨˩˦
thị	tʰi˨˩˨
thít	tʰit˦˥
thịt	tʰit˨˩˨
thiu	tʰiw˧˧
thoai	tʰwaj˧˧
thoái	tʰwaj˦˥
thoải	tʰwaj˨˩˦
thoại	tʰwaj˨˩˨
thoang	tʰwaŋ˧˧
thoáng	tʰwaŋ˦˥
thoảng	tʰwaŋ˨˩˦
thoán	tʰwaŋ˦˥
thoăn	tʰwăŋ˧˧
thoa	tʰwa˧˧
thoá	tʰwa˦˥
thoả	tʰwa˨˩˦
thóa	tʰwa˦˥
thỏa	tʰwa˨˩˦
thoắt	tʰwăk˦˥
thoát	tʰwat˦˥
thoạt	tʰwat˨˩˨
thốc	tʰokp˦˥
thóc	tʰɔkp˦˥
thọc	tʰɔkp˨˩˨
thới	tʰɤj˦˥
thời	tʰɤj˧˨
thôi	tʰoj˧˧
thối	tʰoj˦˥
thổi	tʰoj˨˩˦
thoi	tʰɔj˧˧
thói	tʰɔj˦˥
thòi	tʰɔj˧˨
thơm	tʰɤm˧˧
thồm	tʰom˧˨
thom	tʰɔm˧˧
thòm	tʰɔm˧˨
thông	tʰoŋm˧˧
thống	tʰoŋm˦˥
thong	tʰɔŋm˧˧
thòng	tʰɔŋm˧˨
thõng	tʰɔŋm˨˩˦
thơn	tʰɤŋ˧˧
thờn	tʰɤŋ˧˨
thôn	tʰoŋm˧˧
thốn	tʰoŋm˦˥
thồn	tʰoŋm˧˨
thỗn	tʰoŋm˨˩˦
thổn	tʰoŋm˨˩˦
thon	tʰɔŋm˧˧
thoòng	tʰɔŋm˧˨
thộp	tʰop˨˩˨
thơ	tʰɤ˧˧
thớ	tʰɤ˦˥
thờ	tʰɤ˧˨
thở	tʰɤ˨˩˦
thợ	tʰɤ˨˩˨
thô	tʰo˧˧
thố	tʰo˦˥
thồ	tʰo˧˨
thổ	tʰo˨˩˦
thò	tʰɔ˧˨
thỏ	tʰɔ˨˩˦
thọ	tʰɔ˨˩˨
thớt	tʰɤk˦˥
thốt	tʰokp˦˥
thuần	tʰwɤ̆ŋ˧˨
thuận	tʰwɤ̆ŋ˨˩˨
thua	tʰuə˧˧
thùa	tʰuə˧˨
thủa	tʰuə˨˩˦
thưa	tʰɯə˧˧
thừa	tʰɯə˧˨
thuật	tʰwɤ̆k˨˩˨
thúc	tʰukp˦˥
thục	tʰukp˨˩˨
thức	tʰɯk˦˥
thực	tʰɯk˨˩˨
thuê	tʰwe˧˧
thuế	tʰwe˦˥
thuể	tʰwe˨˩˦
thui	tʰuj˧˧
thùi	tʰuj˧˨
thủi	tʰuj˨˩˦
thum	tʰum˧˧
thùm	tʰum˧˨
thung	tʰuŋm˧˧
thúng	tʰuŋm˦˥
thùng	tʰuŋm˧˨
thũng	tʰuŋm˨˩˦
thủng	tʰuŋm˨˩˦
thụng	tʰuŋm˨˩˨
thưng	tʰɯŋ˧˧
thừng	tʰɯŋ˧˨
thun	tʰuŋm˧˧
thùn	tʰuŋm˧˨
thuốc	tʰuək˦˥
thuộc	tʰuək˨˩˨
thước	tʰɯək˦˥
thược	tʰɯək˨˩˨
thuồi	tʰuəj˧˨
thười	tʰɯəj˧˨
thuông	tʰuəŋ˧˧
thuồng	tʰuəŋ˧˨
thương	tʰɯəŋ˧˧
thường	tʰɯəŋ˧˨
thưởng	tʰɯəŋ˨˩˦
thượng	tʰɯəŋ˨˩˨
thuôn	tʰuəŋ˧˧
thuồn	tʰuəŋ˧˨
thườn	tʰɯəŋ˧˨
thưỡn	tʰɯəŋ˨˩˦
thuở	tʰuə˨˩˦
thướt	tʰɯək˦˥
thụp	tʰup˨˩˨
thu	tʰu˧˧
thú	tʰu˦˥
thù	tʰu˧˨
thủ	tʰu˨˩˦
thụ	tʰu˨˩˨
thư	tʰɯ˧˧
thứ	tʰɯ˦˥
thử	tʰɯ˨˩˦
thự	tʰɯ˨˩˨
thút	tʰukp˦˥
thụt	tʰukp˨˩˨
thuyên	tʰwiəŋ˧˧
thuyền	tʰwiəŋ˧˨
thuyết	tʰwiək˦˥
thùy	tʰuj˧˨
thủy	tʰuj˨˩˦
thụy	tʰuj˨˩˨
thuý	tʰwi˦˥
thuỳ	tʰwi˧˨
thuỷ	tʰwi˨˩˦
thuỵ	tʰwi˨˩˨
tia	tiə˧˧
tía	tiə˦˥
tỉa	tiə˨˩˦
tích	tit˦˥
tịch	tit˨˩˨
tiếc	tiək˦˥
tiệc	tiək˨˩˨
tiêm	tim˧˧
tiếm	tim˦˥
tiềm	tim˧˨
tiệm	tim˨˩˨
tiêng	tiəŋ˧˧
tiếng	tiəŋ˦˥
tiên	tiəŋ˧˧
tiến	tiəŋ˦˥
tiền	tiəŋ˧˨
tiễn	tiəŋ˨˩˦
tiện	tiəŋ˨˩˨
tiếp	tip˦˥
tiệp	tip˨˩˨
tiết	tiək˦˥
tiệt	tiək˨˩˨
tiêu	tiəw˧˧
tiếu	tiəw˦˥
tiều	tiəw˧˨
tiễu	tiəw˨˩˦
tiểu	tiəw˨˩˦
tim	tim˧˧
tím	tim˦˥
tìm	tim˧˨
tỉm	tim˨˩˦
tinh	tin˧˧
tính	tin˦˥
tính	tin˦˥
tình	tin˧˨
tĩnh	tin˨˩˦
tỉnh	tin˨˩˦
tịnh	tin˨˩˨
tin	tin˧˧
tín	tin˦˥
típ	tip˦˥
ti	ti˧˧
tí	ti˦˥
tì	ti˧˨
tỉ	ti˨˩˦
tị	ti˨˩˨
tít	tit˦˥
tịt	tit˨˩˨
tiu	tiw˧˧
tíu	tiw˦˥
tỉu	tiw˨˩˦
toác	twak˦˥
toạc	twak˨˩˨
toại	twaj˨˩˨
toang	twaŋ˧˧
toan	twaŋ˧˧
toán	twaŋ˦˥
toàn	twaŋ˧˨
toát	twat˦˥
toa	twa˧˧
toá	twa˦˥
toà	twa˧˨
toả	twa˨˩˦
toạ	twa˨˩˨
tòa	twa˧˨
tỏa	twa˨˩˦
tọa	twa˨˩˨
tộc-ngôn	tokp˨˩˨-ŋoŋm˧˧
tốc	tokp˦˥
tộc	tokp˨˩˨
tộc	tokp˨˩˨
tóc	tɔkp˦˥
tọc	tɔkp˨˩˨
toen	twen˧˧
toèn	twen˧˨
toét	twet˦˥
toe	twe˧˧
toé	twe˦˥
tóe	twe˦˥
tơi	tɤj˧˧
tới	tɤj˦˥
tôi	toj˧˧
tối	toj˦˥
tồi	toj˧˨
tội	toj˨˩˨
toi	tɔj˧˧
tỏi	tɔj˨˩˦
tởm	tɤm˨˩˦
tôm	tom˧˧
tôm	tom˧˧
tồm	tom˧˨
tom	tɔm˧˧
tóm	tɔm˦˥
tòm	tɔm˧˨
tỏm	tɔm˨˩˦
tông	toŋm˧˧
tống	toŋm˦˥
tồng	toŋm˧˨
tổng	toŋm˨˩˦
tong	tɔŋm˧˧
tòng	tɔŋm˧˨
tỏng	tɔŋm˨˩˦
tớn	tɤŋ˦˥
tợn	tɤŋ˨˩˨
tôn	toŋm˧˧
tốn	toŋm˦˥
tồn	toŋm˧˨
tổn	toŋm˨˩˦
ton	tɔŋm˧˧
tòn	tɔŋm˧˨
toong	tɔŋm˧˧
toòng	tɔŋm˧˨
tô-pô	to˧˧-po˧˧
tốp	top˦˥
top	tɔp˧˧
tóp	tɔp˦˥
tô-tem	to˧˧-tɛm˧˧
tơ	tɤ˧˧
tớ	tɤ˦˥
tờ	tɤ˧˨
tở	tɤ˨˩˦
tô	to˧˧
tố	to˦˥
tồ	to˧˨
tổ	to˨˩˦
to	tɔ˧˧
tò	tɔ˧˨
tỏ	tɔ˨˩˦
tốt	tokp˦˥
tột	tokp˨˩˨
tót	tɔkp˦˥
tọt	tɔkp˨˩˨
trách	ʈat˦˥
trạch	ʈat˨˩˨
trác	ʈak˦˥
trắc	ʈăk˦˥
trai	ʈaj˧˧
trái	ʈaj˦˥
trài	ʈaj˧˨
trải	ʈaj˨˩˦
trại	ʈaj˨˩˨
trám	ʈam˦˥
tràm	ʈam˧˨
trăm	ʈăm˧˧
trắm	ʈăm˦˥
trằm	ʈăm˧˨
trảm	ʈam˨˩˦
trạm	ʈam˨˩˨
trâm	ʈɤ̆m˧˧
trầm	ʈɤ̆m˧˨
trẫm	ʈɤ̆m˨˩˦
trậm	ʈɤ̆m˨˩˨
trang	ʈaŋ˧˧
tráng	ʈaŋ˦˥
tràng	ʈaŋ˧˨
trăng	ʈăŋ˧˧
trắng	ʈăŋ˦˥
trằng	ʈăŋ˧˨
trảng	ʈaŋ˨˩˦
trạng	ʈaŋ˨˩˨
trâng	ʈɤ̆ŋ˧˧
tranh	ʈan˧˧
tránh	ʈan˦˥
trán	ʈaŋ˦˥
tràn	ʈaŋ˧˨
trăn	ʈăŋ˧˧
trằn	ʈăŋ˧˨
trân	ʈɤ̆ŋ˧˧
trấn	ʈɤ̆ŋ˦˥
trần	ʈɤ̆ŋ˧˨
trận	ʈɤ̆ŋ˨˩˨
trao	ʈaw˧˧
tráo	ʈaw˦˥
trào	ʈaw˧˨
trảo	ʈaw˨˩˦
trập	ʈɤ̆p˨˩˨
trát	ʈat˦˥
trất	ʈɤ̆k˦˥
trật	ʈɤ̆k˨˩˨
tra	ʈa˧˧
trá	ʈa˦˥
trà	ʈa˧˨
trả	ʈa˨˩˦
trau	ʈăw˧˧
trâu	ʈɤ̆w˧˧
trấu	ʈɤ̆w˦˥
trầu	ʈɤ̆w˧˨
trẩu	ʈɤ̆w˨˩˦
trày	ʈăj˧˨
trây	ʈɤ̆j˧˧
trầy	ʈɤ̆j˧˨
trẩy	ʈɤ̆j˨˩˦
tréc	ʈɛk˦˥
trém	ʈɛm˦˥
trên	ʈen˧˧
trèn	ʈɛŋ˧˨
trẽn	ʈɛŋ˨˩˦
treo	ʈeo˧˧
tréo	ʈeo˦˥
trèo	ʈeo˧˨
trẽo	ʈeo˨˩˦
trẹo	ʈeo˨˩˨
trết	ʈet˦˥
trệt	ʈet˨˩˨
trét	ʈɛt˦˥
trẹt	ʈɛt˨˩˨
trê	ʈe˧˧
trề	ʈe˧˨
trễ	ʈe˨˩˦
trệ	ʈe˨˩˨
tre	ʈɛ˧˧
trẻ	ʈɛ˨˩˦
trêu	ʈɛu˧˧
trếu	ʈɛu˦˥
trệu	ʈɛu˨˩˨
trích	ʈit˦˥
trịch	ʈit˨˩˨
triền	ʈiəŋ˧˨
triển	ʈiəŋ˨˩˦
triết	ʈiək˦˥
triệt	ʈiək˨˩˨
triêu	ʈiəw˧˧
triều	ʈiəw˧˨
triệu	ʈiəw˨˩˨
trinh	ʈin˧˧
trình	ʈin˧˨
trịnh	ʈin˨˩˨
tri	ʈi˧˧
trí	ʈi˦˥
trì	ʈi˧˨
trĩ	ʈi˨˩˦
trị	ʈi˨˩˨
trìu	ʈiw˧˨
trĩu	ʈiw˨˩˦
trốc	ʈokp˦˥
trộc	ʈokp˨˩˨
tróc	ʈɔkp˦˥
trọc	ʈɔkp˨˩˨
trời	ʈɤj˧˨
trôi	ʈoj˧˧
trối	ʈoj˦˥
trỗi	ʈoj˨˩˦
trổi	ʈoj˨˩˦
trội	ʈoj˨˩˨
trói	ʈɔj˦˥
tròi	ʈɔj˧˨
trọi	ʈɔj˨˩˨
trộm	ʈom˨˩˨
tróm	ʈɔm˦˥
tròm	ʈɔm˧˨
trông	ʈoŋm˧˧
trống	ʈoŋm˦˥
trồng	ʈoŋm˧˨
trong	ʈɔŋm˧˧
tróng	ʈɔŋm˦˥
tròng	ʈɔŋm˧˨
trọng	ʈɔŋm˨˩˨
trơn	ʈɤŋ˧˧
trớn	ʈɤŋ˦˥
trờn	ʈɤŋ˧˨
trợn	ʈɤŋ˨˩˨
trôn	ʈoŋm˧˧
trốn	ʈoŋm˦˥
trộn	ʈoŋm˨˩˨
tròn	ʈɔŋm˧˨
trọn	ʈɔŋm˨˩˨
trớt	ʈɤk˦˥
trợt	ʈɤk˨˩˨
trót	ʈɔkp˦˥
trơ	ʈɤ˧˧
trớ	ʈɤ˦˥
trờ	ʈɤ˧˨
trở	ʈɤ˨˩˦
trợ	ʈɤ˨˩˨
trô	ʈo˧˧
trỗ	ʈo˨˩˦
trổ	ʈo˨˩˦
tro	ʈɔ˧˧
trò	ʈɔ˧˨
trỏ	ʈɔ˨˩˦
trọ	ʈɔ˨˩˨
truân	ʈwɤ̆ŋ˧˧
truất	ʈwɤ̆k˦˥
trưa	ʈɯə˧˧
trúc	ʈukp˦˥
trục	ʈukp˨˩˨
trực	ʈɯk˨˩˨
trui	ʈuj˧˧
trùi	ʈuj˧˨
trụi	ʈuj˨˩˨
trùm	ʈum˧˨
trung	ʈuŋm˧˧
trúng	ʈuŋm˦˥
trùng	ʈuŋm˧˨
trủng	ʈuŋm˨˩˦
trưng	ʈɯŋ˧˧
trứng	ʈɯŋ˦˥
trừng	ʈɯŋ˧˨
trước	ʈɯək˦˥
truông	ʈuəŋ˧˧
truồng	ʈuəŋ˧˨
trương	ʈɯəŋ˧˧
trướng	ʈɯəŋ˦˥
trường	ʈɯəŋ˧˨
trưởng	ʈɯəŋ˨˩˦
trượng	ʈɯəŋ˨˩˨
trượt	ʈɯək˨˩˨
trút	ʈukp˦˥
tru	ʈu˧˧
trú	ʈu˦˥
trù	ʈu˧˨
trụ	ʈu˨˩˨
trứ	ʈɯ˦˥
trừ	ʈɯ˧˨
trữ	ʈɯ˨˩˦
trừu	ʈɯw˧˨
truyền	ʈwiəŋ˧˨
truyện	ʈwiəŋ˨˩˨
trụy	ʈuj˨˩˨
truy	ʈwi˧˧
truỵ	ʈwi˨˩˨
tuân	twɤ̆ŋ˧˧
tuấn	twɤ̆ŋ˦˥
tuần	twɤ̆ŋ˧˨
tuẫn	twɤ̆ŋ˨˩˦
tua	tuə˧˧
tủa	tuə˨˩˦
từa	tɯə˧˨
tựa	tɯə˨˩˨
túc	tukp˦˥
tục	tukp˨˩˨
tức	tɯk˦˥
tuếch	twet˦˥
tuệch	twet˨˩˨
tuềnh	twen˧˨
tuế	twe˦˥
tuệ	twe˨˩˨
túi	tuj˦˥
tủi	tuj˨˩˦
tụi	tuj˨˩˨
tum	tum˧˧
túm	tum˦˥
tùm	tum˧˨
tủm	tum˨˩˦
tụm	tum˨˩˨
tung	tuŋm˧˧
túng	tuŋm˦˥
tùng	tuŋm˧˨
tủng	tuŋm˨˩˦
tụng	tuŋm˨˩˨
tưng	tɯŋ˧˧
từng	tɯŋ˧˨
tun	tuŋm˧˧
tủn	tuŋm˨˩˦
tước	tɯək˦˥
tuổi	tuəj˨˩˦
tươi	tɯəj˧˧
tưới	tɯəj˦˥
tươm	tɯm˧˧
tườm	tɯm˧˨
tuồng	tuəŋ˧˨
tương	tɯəŋ˧˧
tướng	tɯəŋ˦˥
tường	tɯəŋ˧˨
tưởng	tɯəŋ˨˩˦
tượng	tɯəŋ˨˩˨
tuôn	tuəŋ˧˧
tuồn	tuəŋ˧˨
tuốt	tuək˦˥
tuột	tuək˨˩˨
tướt	tɯək˦˥
tườu	tɯəw˧˨
túp	tup˦˥
tụt	tukp˨˩˨
tu	tu˧˧
tú	tu˦˥
tù	tu˧˨
tủ	tu˨˩˦
tụ	tu˨˩˨
tư	tɯ˧˧
tứ	tɯ˦˥
từ	tɯ˧˨
tử	tɯ˨˩˦
tự	tɯ˨˩˨
tửu	tɯw˨˩˦
tựu	tɯw˨˩˨
tuyên	twiəŋ˧˧
tuyến	twiəŋ˦˥
tuyền	twiəŋ˧˨
tuyển	twiəŋ˨˩˦
tuyết	twiək˦˥
tuyệt	twiək˨˩˨
tuýt	twit˦˥
túy	tuj˦˥
tùy	tuj˧˨
tủy	tuj˨˩˦
tụy	tuj˨˩˨
tuy	twi˧˧
tuý	twi˦˥
tuỳ	twi˧˨
tuỷ	twi˨˩˦
ty	ti˧˧
tỳ	ti˧˨
tỷ	ti˨˩˦
tỵ	ti˨˩˨
uẩn	wɤ̆ŋ˨˩˦
uất	wɤ̆k˦˥
úa	uə˦˥
ùa	uə˧˨
ụa	uə˨˩˨
ưa	ɯə˧˧
ứa	ɯə˦˥
úc	ukp˦˥
ục	ukp˨˩˨
ức	ɯk˦˥
uế	we˦˥
uể	we˨˩˦
ui	uj˧˧
úi	uj˦˥
ủi	uj˨˩˦
um	um˧˧
úm	um˦˥
ùm	um˧˨
ung	uŋm˧˧
úng	uŋm˦˥
ùng	uŋm˧˨
ủng	uŋm˨˩˦
ưng	ɯŋ˧˧
ứng	ɯŋ˦˥
ừng	ɯŋ˧˨
ửng	ɯŋ˨˩˦
un	uŋm˧˧
ùn	uŋm˧˨
ủn	uŋm˨˩˦
ước	ɯək˦˥
ươi	ɯəj˧˧
uôm	um˧˧
ươm	ɯm˧˧
ướm	ɯm˦˥
uông	uəŋ˧˧
uống	uəŋ˦˥
uổng	uəŋ˨˩˦
ương	ɯəŋ˧˧
uốn	uəŋ˦˥
ươn	ɯəŋ˧˧
ưỡn	ɯəŋ˨˩˦
ướp	ɯp˦˥
ướt	ɯək˦˥
úp	up˦˥
út	ukp˦˥
ụt	ukp˨˩˨
u	u˧˧
ú	u˦˥
ù	u˧˨
ủ	u˨˩˦
ụ	u˨˩˨
ưu	ɯw˧˧
ư	ɯ˧˧
ứ	ɯ˦˥
ừ	ɯ˧˨
uyên	wiəŋ˧˧
uyển	wiəŋ˨˩˦
uỳnh	win˧˨
ủy	uj˨˩˦
uy	wi˧˧
uý	wi˦˥
uỷ	wi˨˩˦
vách	jat˦˥
vạch	jat˨˩˨
vác	jak˦˥
vạc	jak˨˩˨
vặc	jăk˨˩˨
vai	jaj˧˧
vái	jaj˦˥
vài	jaj˧˨
vãi	jaj˨˩˦
vải	jaj˨˩˦
va	ja˧˧
vá	ja˦˥
và	ja˧˨
vã	ja˨˩˦
vả	ja˨˩˦
vạ	ja˨˩˨
vàm	jam˧˨
vằm	jăm˧˨
vạm	jam˨˩˨
vậm	jɤ̆m˨˩˨
vang	jaŋ˧˧
váng	jaŋ˦˥
vàng	jaŋ˧˨
văng	jăŋ˧˧
vắng	jăŋ˦˥
vằng	jăŋ˧˨
vãng	jaŋ˨˩˦
vâng	jɤ̆ŋ˧˧
vầng	jɤ̆ŋ˧˨
vanh	jan˧˧
vành	jan˧˨
van	jaŋ˧˧
ván	jaŋ˦˥
vàn	jaŋ˧˨
văn	jăŋ˧˧
vắn	jăŋ˦˥
vằn	jăŋ˧˨
vãn	jaŋ˨˩˦
vạn	jaŋ˨˩˨
vặn	jăŋ˨˩˨
vân	jɤ̆ŋ˧˧
vấn	jɤ̆ŋ˦˥
vần	jɤ̆ŋ˧˨
vẫn	jɤ̆ŋ˨˩˦
vẩn	jɤ̆ŋ˨˩˦
vận	jɤ̆ŋ˨˩˨
vào	jaw˧˨
vấp	jɤ̆p˦˥
vập	jɤ̆p˨˩˨
vắt	jăk˦˥
vặt	jăk˨˩˨
vạt	jat˨˩˨
vất	jɤ̆k˦˥
vật	jɤ̆k˨˩˨
vay	jăj˧˧
váy	jăj˦˥
vày	jăj˧˨
vảy	jăj˨˩˦
vạy	jăj˨˩˨
vây	jɤ̆j˧˧
vấy	jɤ̆j˦˥
vầy	jɤ̆j˧˨
vẫy	jɤ̆j˨˩˦
vậy	jɤ̆j˨˩˨
véc	jɛk˦˥
vẹc	jɛk˨˩˨
vê	je˧˧
về	je˧˨
vệ	je˨˩˨
ve	jɛ˧˧
vé	jɛ˦˥
vè	jɛ˧˨
vẽ	jɛ˨˩˦
vẻ	jɛ˨˩˦
vênh	jen˧˧
vểnh	jen˨˩˦
vên	jen˧˧
vền	jen˧˨
ven	jɛŋ˧˧
vén	jɛŋ˦˥
vẻn	jɛŋ˨˩˦
vẹn	jɛŋ˨˩˨
veo	jeo˧˧
véo	jeo˦˥
vèo	jeo˧˨
vẹo	jeo˨˩˨
vết	jet˦˥
vét	jɛt˦˥
vẹt	jɛt˨˩˨
vêu	jɛu˧˧
vía	jiə˦˥
vỉa	jiə˨˩˦
vi-đê-ô	ji˧˧-de˧˧-o˧˧
việc	jiək˨˩˨
viêm	jim˧˧
viêng	jiəŋ˧˧
viếng	jiəŋ˦˥
viên	jiəŋ˧˧
viên	jiəŋ˧˧
viễn	jiəŋ˨˩˦
viển	jiəŋ˨˩˦
viện	jiəŋ˨˩˨
viết	jiək˦˥
việt	jiək˨˩˨
việt-nam	jiək˨˩˨-nam˧˧
vi	ji˧˧
ví	ji˦˥
vì	ji˧˨
vĩ	ji˨˩˦
vỉ	ji˨˩˦
vị	ji˨˩˨
vinh	jin˧˧
vĩnh	jin˨˩˦
vin	jin˧˧
vi-rút	ji˧˧-ʐukp˦˥
vịt	jit˨˩˨
vóc	jɔkp˦˥
vọc	jɔkp˨˩˨
vơi	jɤj˧˧
với	jɤj˦˥
vời	jɤj˧˨
vôi	joj˧˧
vồi	joj˧˨
vội	joj˨˩˨
voi	jɔj˧˧
vòi	jɔj˧˨
vơ	jɤ˧˧
vớ	jɤ˦˥
vờ	jɤ˧˨
vỡ	jɤ˨˩˦
vở	jɤ˨˩˦
vợ	jɤ˨˩˨
vô	jo˧˧
vồ	jo˧˨
vỗ	jo˨˩˦
vo	jɔ˧˧
vó	jɔ˦˥
vò	jɔ˧˨
võ	jɔ˨˩˦
vỏ	jɔ˨˩˦
vọ	jɔ˨˩˨
vòm	jɔm˧˨
vông	joŋm˧˧
vong	jɔŋm˧˧
vòng	jɔŋm˧˨
võng	jɔŋm˨˩˦
vọng	jɔŋm˨˩˨
vôn	joŋm˧˧
vốn	joŋm˦˥
vồn	joŋm˧˨
von	jɔŋm˧˧
vòn	jɔŋm˧˨
vỏn	jɔŋm˨˩˦
voọc	jɔkp˨˩˨
vọp	jɔp˨˩˨
vớt	jɤk˦˥
vót	jɔkp˦˥
vọt	jɔkp˨˩˨
vua	juə˧˧
vùa	juə˧˨
vừa	jɯə˧˨
vữa	jɯə˨˩˦
vựa	jɯə˨˩˨
vúc	jukp˦˥
vực	jɯk˨˩˨
vui	juj˧˧
vùi	juj˧˨
vu	ju˧˧
vú	ju˦˥
vù	ju˧˨
vũ	ju˨˩˦
vụ	ju˨˩˨
vung	juŋm˧˧
vùng	juŋm˧˨
vũng	juŋm˨˩˦
vụng	juŋm˨˩˨
vừng	jɯŋ˧˨
vững	jɯŋ˨˩˦
vựng	jɯŋ˨˩˨
vun	juŋm˧˧
vùn	juŋm˧˨
vụn	juŋm˨˩˨
vuông	juəŋ˧˧
vương	jɯəŋ˧˧
vướng	jɯəŋ˦˥
vượng	jɯəŋ˨˩˨
vươn	jɯəŋ˧˧
vườn	jɯəŋ˧˨
vượn	jɯəŋ˨˩˨
vuốt	juək˦˥
vuột	juək˨˩˨
vượt	jɯək˨˩˨
vút	jukp˦˥
vụt	jukp˨˩˨
vứt	jɯk˦˥
vưu	jɯw˧˧
vy	ji˧˧
xách	sat˦˥
xạch	sat˨˩˨
xác	sak˦˥
xắc	săk˦˥
xạc	sak˨˩˨
xấc	sɤ̆k˦˥
xái	saj˦˥
xài	saj˧˨
xam	sam˧˧
xám	sam˦˥
xàm	sam˧˨
xăm	săm˧˧
xắm	săm˦˥
xâm	sɤ̆m˧˧
xầm	sɤ̆m˧˨
xẩm	sɤ̆m˨˩˦
xậm	sɤ̆m˨˩˨
xàng	saŋ˧˨
xăng	săŋ˧˧
xằng	săŋ˧˨
xẵng	săŋ˨˩˦
xanh	san˧˧
xành	san˧˨
xán	saŋ˦˥
xăn	săŋ˧˧
xắn	săŋ˦˥
xẩn	sɤ̆ŋ˨˩˦
xao	saw˧˧
xáo	saw˦˥
xào	saw˧˨
xảo	saw˨˩˦
xáp	sap˦˥
xấp	sɤ̆p˦˥
xập	sɤ̆p˨˩˨
xa	sa˧˧
xá	sa˦˥
xà	sa˧˨
xã	sa˨˩˦
xả	sa˨˩˦
xạ	sa˨˩˨
xát	sat˦˥
xạu	săw˨˩˨
xâu	sɤ̆w˧˧
xấu	sɤ̆w˦˥
xầu	sɤ̆w˧˨
xay	săj˧˧
xảy	săj˨˩˦
xây	sɤ̆j˧˧
xẩy	sɤ̆j˨˩˦
xếch	set˦˥
xệch	set˨˩˨
xềm	sem˧˨
xem	sɛm˧˧
xẻng	sɛŋ˨˩˦
xênh	sen˧˧
xềnh	sen˧˨
xen	sɛŋ˧˧
xén	sɛŋ˦˥
xèn	sɛŋ˧˨
xẻn	sɛŋ˨˩˦
xeo	seo˧˧
xéo	seo˦˥
xèo	seo˧˨
xẹo	seo˨˩˨
xếp	sep˦˥
xép	sɛp˦˥
xẹp	sɛp˨˩˨
xê	se˧˧
xế	se˦˥
xề	se˧˨
xe	sɛ˧˧
xé	sɛ˦˥
xè	sɛ˧˨
xẻ	sɛ˨˩˦
xét	sɛt˦˥
xều	sɛu˧˨
xệu	sɛu˨˩˨
xỉa	siə˨˩˦
xích	sit˦˥
xiêm	sim˧˧
xiểm	sim˨˩˦
xiềng	siəŋ˧˨
xiểng	siəŋ˨˩˦
xiên	siəŋ˧˧
xiển	siəŋ˨˩˦
xiết	siək˦˥
xiêu	siəw˧˧
xiếu	siəw˦˥
xinh	sin˧˧
xính	sin˦˥
xình	sin˧˨
xin	sin˧˧
xín	sin˦˥
xi	si˧˧
xí	si˦˥
xì	si˧˨
xỉ	si˨˩˦
xị	si˨˩˨
xít	sit˦˥
xíu	siw˦˥
xìu	siw˧˨
xỉu	siw˨˩˦
xịu	siw˨˩˨
xoạc	swak˨˩˨
xoai	swaj˧˧
xoài	swaj˧˨
xoang	swaŋ˧˧
xoàng	swaŋ˧˨
xoành	swan˧˨
xoan	swaŋ˧˧
xoàn	swaŋ˧˨
xoăn	swăŋ˧˧
xoắn	swăŋ˦˥
xoẳn	swăŋ˨˩˦
xoa	swa˧˧
xoá	swa˦˥
xoay	swăj˧˧
xoáy	swăj˦˥
xốc	sokp˦˥
xộc	sokp˨˩˨
xóc	sɔkp˦˥
xọc	sɔkp˨˩˨
xoen	swen˧˧
xoèn	swen˧˨
xơi	sɤj˧˧
xới	sɤj˦˥
xởi	sɤj˨˩˦
xôi	soj˧˧
xối	soj˦˥
xổi	soj˨˩˦
xoi	sɔj˧˧
xói	sɔj˦˥
xờm	sɤm˧˨
xôm	som˧˧
xồm	som˧˨
xom	sɔm˧˧
xóm	sɔm˦˥
xòm	sɔm˧˨
xông	soŋm˧˧
xống	soŋm˦˥
xồng	soŋm˧˨
xổng	soŋm˨˩˦
xong	sɔŋm˧˧
xòng	sɔŋm˧˨
xõng	sɔŋm˨˩˦
xỏng	sɔŋm˨˩˦
xơn	sɤŋ˧˧
xớn	sɤŋ˦˥
xôn	soŋm˧˧
xốn	soŋm˦˥
xồn	soŋm˧˨
xổn	soŋm˨˩˦
xộn	soŋm˨˩˨
xon	sɔŋm˧˧
xoong	sɔŋm˧˧
xợp	sɤp˨˩˨
xốp	sop˦˥
xóp	sɔp˦˥
xơ	sɤ˧˧
xớ	sɤ˦˥
xờ	sɤ˧˨
xô	so˧˧
xổ	so˨˩˦
xo	sɔ˧˧
xó	sɔ˦˥
xỏ	sɔ˨˩˦
xọ	sɔ˨˩˨
xớt	sɤk˦˥
xốt	sokp˦˥
xót	sɔkp˦˥
xô-viết	so˧˧-jiək˦˥
xuân	swɤ̆ŋ˧˧
xuẩn	swɤ̆ŋ˨˩˦
xua	suə˧˧
xưa	sɯə˧˧
xửa	sɯə˨˩˦
xuất	swɤ̆k˦˥
xúc	sukp˦˥
xục	sukp˨˩˨
xức	sɯk˦˥
xuệch	swet˨˩˨
xuềnh	swen˧˨
xuê	swe˧˧
xuề	swe˧˨
xui	suj˧˧
xúi	suj˦˥
xụi	suj˨˩˨
xum	sum˧˧
xúm	sum˦˥
xùm	sum˧˨
xung	suŋm˧˧
xúng	suŋm˦˥
xùng	suŋm˧˨
xủng	suŋm˨˩˦
xưng	sɯŋ˧˧
xứng	sɯŋ˦˥
xửng	sɯŋ˨˩˦
xun	suŋm˧˧
xước	sɯək˦˥
xuôi	suəj˧˧
xười	sɯəj˧˨
xuống	suəŋ˦˥
xuồng	suəŋ˧˨
xương	sɯəŋ˧˧
xướng	sɯəŋ˦˥
xường	sɯəŋ˧˨
xưởng	sɯəŋ˨˩˦
xúp	sup˦˥
xu	su˧˧
xú	su˦˥
xù	su˧˨
xủ	su˨˩˦
xụ	su˨˩˨
xứ	sɯ˦˥
xử	sɯ˨˩˦
xuyên	swiəŋ˧˧
xuy	swi˧˧
xuý	swi˦˥
xuýt	swit˦˥
yêm	iɛm˧˧
yếm	iɛm˦˥
yểm	iɛm˨˩˦
yêng	iɛŋ˧˧
yểng	iɛŋ˨˩˦
yên	iɛŋ˧˧
yến	iɛŋ˦˥
yết	iɛt˦˥
yêu	iəw˧˧
yếu	iəw˦˥
yểu	iəw˨˩˦
y	i˧˧
ý	i˦˥
ỷ	i˨˩˦
ạ	ɑ˨˩˨
nắng	n˧aŋ˧˥˧
ấm	ɔm˧
chỗ	tɨ˧
na	naː˧
mục	mˈuk˨˩˨
xem	sɛm˧
cắt	ka˧
cho	tɔː˧˧
sự	suː˧
em	ɛm˧
tình	tiŋkɤ˨˩
là	la˨˩
tôi	toj˧
ma	maː˧
còn	kɔn˧˨˩
mắt	maːt˧
mà	maˈa˨˩
đỡ	dɒ˧
từ	tɨ˧
xe	sɛ˧
ma	ma˧
ta	taka˧
cổ	kɔː˧
chấp	ba˧
xa	saa˧
con	kɔn˧
bỗng	lũŋ˧
em	ɛm˧
sự	əm˧
ta	ta˧
em	ɛm˧
nhà	ɲaː˨˩
bị	bɛj˨˩˨
hoặc	hɔːk˧
rồ	sɛ˧
bỗng	bɔk˧
thật	tɔp˧
bà	baː˨˩
là	la˨˩
vợ	vˈœ˧
bị	bi˨˩˨
nhỏ	nɔ˨˧
tất	tˈɔt˧
em	ɛm˧
dù	ɛɛ˨˩
cứ	gɨ˧
em	ɛm˧
em	ɛm˧
mắt	mˈq˧
mà	maː˨˩
đôi	doj˧
mắt	maˈt˧
tư	tɯ˧
tôi	toj˧
tạm	tak˨˩˨
em	ɛm˧
nó	nɔːt˧˥
bị	bi˨˩˨
mà	ma˨˩
ta	tako˧
mất	m˧
mà	ma˨˩
ta	ta˧
và	va˨˩
được	dˈɯ˧
bạn	bɛn˨˩˨
đi	di˧
qua	kwaŋa˧
viêt	vˈɪt˧
mà	maj˨˩
cô	ko˧
rốt	tut˧
sự	ʃu˧
tôi	toj˧
là	la˨˩
được	dˌɯkˈ˧
hà	haːd˨˩
co	kɛn˧˧
cấu	kuɔ˧
em	ɛm˧
mặt	əɹ˧
hà	hani˨˩
ma	ma˧
em	ɛm˧
còn	kɔng˨˩
dịch	ʃs˨˩˨
bà	baː˨˩
mà	maː˨˩
bà	baː˨˩
bà	baː˨˩
rất	rˈt˧
suốt	sot˧
em	ɛm˦˧
em	ɛm˧
là	laː˨˩
cối	ɛː˧
lỡ	lɨː˧
cũ	ku˧˥˧
từ	tˈy˧
được	døk˧
mà	maː˨˩
mồ	mɔ˧
được	dˌʊk˧
em	ɛm˧
nên	nenˈi˧
mà	ma˨˩
cầm	ɛm˧
giật	zˈat˧
em	ɛm˧
bố	bu˧
cố	kuː˧
ý	iko˧
em	ɛm˧
xa	saː˧
bạn	bˈb˨˩˨
tắt	dɛ˧
em	ɛm˧
mà	maː˨˩
chị	ɛm˨˩˨
em	ɛm˧
từ	tˈu˧
từ	tˈu˧
mà	maː˦˨˩
có	kɔː˧˥
nó	nɔːi˧˥
em	ɛm˧
bạn	ɑɛn˨˩˨
tàn	tanta˨˩
nhắm	ɲam˧t˧˧
có	kɔː˧˥
chứ	ʃy˧
còn	kɔn˨˩
con	kɔn˧
đi	diː˧
có	kɔː˧˥
xa	saː˧
em	ɛm˧
mà	maː˨˩
mất	ˈɔt˧
xôn	son˧
có	kɔŋ˧˥
na	na˧
vang	vaŋ˧
em	ɛm˧
cỏ	oː˨˧
cứ	kɯ˧
vợ	ɛn˧
cử	kuɔ˧
bà	ba˨˩
từ	tɤ˧
mà	ma˨˩
hà	haː˨˩
có	kɔ˧˥
mà	ma˨˩
ni	niː˧
khi	xiː˧
được	duːk˧
mắc	mɑːk˧
vì	viː˨˩
là	laː˨˩
suốt	suku˧
sợ	sɨ˧
có	kɔː˧˥
bố	ɛm˧
lao	law˧
đi	dili˧
giật	zɨp˧
em	ɛmɲe˧
in	in˧
vũ	ɛv˧˥˧
nó	nɔːm˧˥
ý	i˧˥
con	kɔn˧
tất	tˈɪt˧
mà	ma˨˩
hề	hebi˧
bị	biː˨˩˨
thật	tˌɑt˧
đỗ	ʊn˧
na	naː˧
mà	maː˨˩
đỡ	ˈda˧
được	ɑːk˧
hoặc	hɑːk˧
cô	koː˧
sự	ʂɨ˧
và	vaː˨˩
nó	nɔːn˧˥
bận	bɛng˧
đức	dˈɪk˧
được	dɨlk˧
mắt	mˈt˧
no,	nɔː˧
hũ	huː˧˥˧
xa,	sa˧
giấc	zɨːk˧
tất	tɔ˧
được	dɔːk˧
-	ki˧
lũ	luː˧˥˧
em	ɛm˧
suốt	ʃuːt˧
cũ	kuˌ˧˥˧
ban	ban˧
ma	maˈa˧
dạt	ja˨˩˨
tao	taː˧˥˧
mà	maˈa˨˩
lạt	la-˨˩˨
em	ɛm˧
và	va˨˩
và	va˨˩
hà	ha˨˩
gió	zɔkɛ˧˥
tôi	toj˧
khó	xɔːr˧˥
bố	bu˧
em	ɛm˧
em	ɛm˧
sự	˥˩˧
cầm	kɑm˧
bố	buː˧
em	ɛm˧
rất	vɪt˧
và	vaː˨˩
tất	tɔk˧
cứ	ɛk˧
bà	ba˨˩
đêm	demn˧
hà	ha˨˩
ni	ni˧
mà	ma˨˩
là	la˨˩
tôi	toji˧
mắt	mˈat˧
chị	xi˨˩˨
mặt	ma˧
đi	diː˧
ký	kiː˧˥
mà	ma˨˩
sự	ʃɛ˧
sức	huk˧
dịch	dɤ˨˩˨
alo	pala˧
rằm	ʒam˧
nó	nɔ˧˥
nói	nɔj˧˥
xin	sin˧
em	ɛm˧
cứ	kyn˧
có	kɔm˧˥
mất	mɛtː˧
còn	kɔn˨˩
là	laː˨˩
tôi	toj˧
đỡ	dˈœ˧
nói	nɔj˧˥
em	ɛm˧
vẫn	v˨˩˦˧
có	kɔsɔ˧˥
bà	ba˥˩˨˩
được	dɔw˧
là	laː˨˩
bạn	baːn˨˩˨
tò	tɔː˨˩
cầm	kɛm˧
con	kɔn˧
bà	baː˨˩
xa	saka˧
và	va˨˩
linh	lɪŋ˧˧
nếu	nɛu˧
mà	maː˨˩
cách	kɛkˈ˧˥
sợ	ʃɔ˧
em	ɛm˧
em	ɛmɲe˧
được	dˈy˧
xe	sɛ˧
là	la˨˩
mắt	mɑ˧
mà	ma˨˩
bà	baː˥˨˩
em	ɛm˧
sự	ɛt˧
bố	boː˧
em	ɛm˧
ẩn	ɛn˧
lắc	sɛ˧
có	kɔː˧˥
vụ	ɔm˨˩˨
bố	buː˧
ma	maˈa˧
viên	viːn˧˧
hàng	hæŋ˧˨˩
bùn	bˈʊn˨˩
chấp	na˧
dậy	dɑ˧
đi	di˧
bố	buː˧
mắt	mˈk˧
chị	tɔ˨˩˨
em	ɛm˧
tên	tən˧˥˧
nó	nɔː˧˥
bạn	bɑːn˨˩˨
muốn	mun˧
mất	mˈt˧
mất	mˈt˧
mà	man˨˩
có	kɔː˧˥
tao	taw˧
sợ	˥˩˧
nhắc	ɲak˧
na	naː˧
mắt	mak˧
vị	vˈi˨˩˨
cô	ko˧
là	la-˨˩
em	ɛm˧
qua	kwa˧
bà	baː˨˩
bó	bɔː˧˥
vì	vi˨˩
có	kɔː˧˥
da	za˧
là	la˨˩
hồ	hɔː˧
nếu	nɛːˈ˦˧
em	ɛm˧
tuy	twi˧
ấp	ɛb˧
già	za˨˩
mắt	mˈt˧
bà	ba˨˩
lạ	la˨˩˨
giá	zaː˧˥
mà	ma˨˩
mà	ma˨˩
còn	kɔng˨˩
bà	ba˨˩
bị	bi˨˩˨
bằng	mɛ˧
là	la˨˩
em	ɛm˧
em	ɛm˧
bạn	la˨˩˨
em	ɛm˧
là	la˨˩
em	ɛm˧
lo	lɔː˧
chắc	tɑk˧
có	kɔl˧˥
vì	viː˨˩
sự	ʃu˧
tốt	dɛ˧
con	kɔn˧
báo	baw˧˥
em	ɛm˧
bà	ba˨˩
giật	kɛt˧
bị	biː˨˩˨
tất	tɤt˧
dụ	ni˨˩˨
em	ɛm˧
là	laː˨˩
bỏ	bɔː˨˧
dứt	zit˧
mà	maka˨˩
em	ɛm˧
mặc	mˈak˧
có	kɔː˧˥
ấm	ɛm˧
còn	kɔn˨˩
nhắc	ɲˈak˧
vị	viː˨˩˨
vì	vi˨˩
vì	vi˨˩
đỡ	sɛ˧
cố	ku˧
cứ	kɯn˧
thứ	va˧
bà	baː˨˩
từ	do˧
mà	maː˨˩
bố	buː˧
qua	kwa˧
nó	nɔːl˧˥
em	ɛm˧
khác	xak˧˥
ốm	ʔm˧
em	ɛm˧
xin	sin˧
mất	mak˧
bằng	bãn˧
em	ɛm˧
tầm	ma˧
bị	zɪ˨˩˨
em	ɛm˧
nam	namˈ˧
ni	niː˧
có	kɔː˧˥
nụ	nəʊ˨˩˨
dậy	jai˧
đi	diː˧
được	dˈɑk˧
bạn	bãn˨˩˨
xa	sama˧
là	laː˨˩
bé	bɛn˧˥
bị	lɛ˨˩˨
là	laː˨˩
xem	sɛm˧
có	kɔːn˧˥
ba	ba˧
là	la˨˩
mà	mani˨˩
được	dukː˧
được	wɔk˧
bên	ben˧
bà	ba˨˩
tất	tɨ˧
em	ɛm˧
giúp	zupː˧˥
em	ɛm˧
bà	baː˧˨˩
vì	viː˨˩
