က	ka̰
ကကုသန်	ka̰kṵθàɴ
ကကုသန်ဘုရား	ka̰kṵθàɴpʰəjá
ကက်စီနို	kɛʔsìnò
ကက်ဆက်	kɛʔsʰɛʔ
ကက်တလောက်	kɛʔtəlaʊʔ
ကက်ပတိန်	kɛʔpətèɪɴ
ကက်ဗိနက်	kɛʔbḭnɛʔ
ကက်သလစ်	kɛʔθəlɪʔ
ကကြီး	ka̰dʑí
ကချင်	kətɕʰɪ̀ɴ
ကချလာ	kətɕʰəlà
ကချေသည်	ka̰dʑèðè
ကင်	kɪ̀ɴ
ကင်ဆာ	kɪ̀ɴsʰà
ကင်ဆာရောဂါ	kɪ̀ɴsʰàjɔ́gà
ကင်ညာ	kɪ̀ɴɲà
ကင်ပွန်း	kɪ̀ɴbʊ́ɴ
ကင်ပွန်းချဉ်	kɪ̀ɴbʊ́ɴdʑɪ̀ɴ
ကင်ဘာရာ	kɪ̀ɴbàɹà
ကင်မရာ	kɪ̀ɴməɹà
ကင်မရွန်း	kɪ̀ɴma̰ɹʊ́ɴ
ကင်း	kɪ́ɴ
ကင်းခြေများ	kɪ́ɴtɕìmjá
ကင်းစီး	kɪ́ɴsí
ကင်းထောက်လေယာဉ်	kɪ́ɴdaʊʔlèjɪ̀ɴ
ကင်းပုံ	kɪ́ɴbòʊɴ
ကင်းမြီးကောက်	kɪ́ɴmjígaʊʔ
ကင်းမွန်	kɪ́ɴmʊ̀ɴ
ကစား	gəzá
ကစားကွင်း	gəzágwɪ́ɴ
ကစားစရာ	gəzázəjà
ကစားသမား	gəsáðəmá
ကစီ	gəzì
ကစီဓာတ်	gəzìdaʔ
ကစ္ဆပနဒီ	kɪʔsʰa̰pənədì
ကဆုန်	kəsʰòʊɴ
ကဆုန်လပြည့်နေ့	kəsʰòʊɴla̰pjḭnḛ
ကညာ	kəɲà
ကညွတ်	kəɲʊʔ
ကညွတ်ရိုး	kəɲʊʔjó
ကဏန်း	gənáɴ
ကဏ္ဍ	kànda̰
ကတညုတ	kətɪ̀ɴɲṵta̰
ကတည်းက	gədɛ́ga̰
ကတိ	gədḭ
ကတုတ်	gədoʊʔ
ကတုတ်ကျင်း	gədoʊʔtɕɪ́ɴ
ကတော့	gədɔ̰
ကတော်	gədɔ̀
ကတ္တား	kaʔtá
ကတ္တီပါ	gədìbà
ကတ်	kaʔ
ကတ်ကြေး	kaʔtɕí
ကတ်ကြေးကိုက်	kaʔtɕíkaɪʔ
ကတ်ပြား	kaʔpjá
ကတ်သလိတ်	kaʔθəleɪʔ
ကတွတ်	gədʊʔ
ကတွတ်ယို	kədʊʔjò
ကထာန	məhàkətʰàna̰
ကထိက	kətʰḭka̰
ကထိန်	kətʰèɪɴ
ကဒတ်	gədaʔ
ကဒ်	kàd
ကနခို	kənəkʰò
ကနစိုး	kənəzó
ကနား	kəná
ကနုကမာ	kənṵkəmà
ကနုတ်	kənoʊʔ
ကနေဒါ	ka̰nèdà
ကန့်	ka̰ɴ
ကန့်လန့်	ka̰ɴla̰ɴ
ကန့်လန့်ကာ	kələgà
ကန္တာရ	kàɴtàja̰
ကန်	kàɴ
ကန်စွန်း	gəzʊ́ɴ
ကန်စွန်းဥ	gəzʊ́ɴʔṵ
ကန်တော့	gədɔ̰
ကန်ထရိုက်	kàɴtʰəɹaɪʔ
ကပိလဝတ်	kəpḭla̰wʊʔ
ကပ္ပလီ	kaʔpəlì
ကပ္ပလီပင်လယ်	kaʔpəlìpɪ̀ɴlɛ̀
ကပ်	kaʔ
ကပ်ကြီးသုံးပါး	kaʔdʑíθóʊɴbá
ကပ်နာ	kaʔnà
ကပ်ပယ်	kaʔpɛ̀
ကပ်ပါး	kaʔpá
ကပ်ရောဂါ	kaʔjɔ́gà
ကပွဲရုံ	ka̰bwɛ́jòʊɴ
ကဖီး	kəpʰí
ကဗျာ	gəbjà
ကဘတ်	gəbaʔ
ကဘီလူး	ka̰bəlú
ကဘူးလ်	ka̰bú
ကမန်	ka̰màɴ
ကမာ	kəmà
ကမာရွတ်	kəmàjʊʔ
ကမ္ဗလာ	gəbəlà
ကမ္ဗောဇ	kàɴbɔ́za̰
ကမ္ဘာ	gəbà
ကမ္ဘာဂြိုဟ်	gəbàdʑò
ကမ္ဘာစစ်	gəbàsɪʔ
ကမ္ဘာဖလား	gəbàpʰəlá
ကမ္ဘာလုံး	gəbàlóʊɴ
ကမ္ဘာလုံးခြမ်း	gəbàlóʊɴdʑàɴ
ကမ္ဘာ့ဖလား	gəba̰pʰəlá
ကမ္ဘောဒီးယား	kàɴbɔ́díjá
ကမ္မဝါ	kàɴma̰wà
ကမ္မဝါစာ	kàɴma̰wàsà
ကမ်စော်	kàɴzɔ̀
ကမ်း	káɴ
ကမ်းခြေ	káɴdʑè
ကယား	kəjá
ကယ်	kɛ̀
ကယ်တင်ရှင်	kɛ̀tɪ̀ɴʃɪ̀ɴ
ကယ်လဆီယမ်	kɛ̀ləsʰìjàɴ
ကရကဋ်	kəɹa̰kàt
ကရက်	ka̰ɹɛʔ
ကရင်	kəjɪ̀ɴ
ကရင်နီ	kəjɪ̀ɴnì
ကရစ်ကက်	kəɹɪʔkɛʔ
ကရဝိက်	kəɹa̰weɪʔ
ကရဝေးရွက်	kəɹəwéjwɛʔ
ကရိန်း	kəɹéɪɴ
ကရုဏာ	gəjṵnà
ကလပ်	kəlaʔ
ကလမောင်း	kələmáʊɴ
ကလာပ်စည်း	kəlaʔsí
ကလိုရင်း	kəlòɹɪ́ɴ
ကလီစာ	kəlìzà
ကလောင်	kəlàʊɴ
ကလေး	kʰəlé
ကလေးဖျက်	kəlépʰjɛʔ
ကလျာ	kələjà
ကလျာဏမိတ္တ	kələjàna̰meɪʔta̰
ကလျာဏီ	kələjànì
ကဝိ	kəwḭ
ကဝေ	kəwè
ကသည်း	kəθí
ကာ	kà
ကာကွယ်	kàgwɛ̀
ကာကွယ်ဆေး	kàgwɛ̀zé
ကာကွယ်ရေး	kàgwɛ̀jé
ကာဂစ်စတန်	kəgɪʔsətàɴ
ကာဂျစ္စတန်	kədʑɪʔsətàɴ
ကာဇက်စတန်	kàzɛʔsətàɴ
ကာတာ	kàtà
ကာတွန်း	kàtʊ́ɴ
ကာဗွန်	kàbʊ̀ɴ
ကာမ	kàma̰
ကာမသုတ်	kàma̰θoʊʔ
ကာယ	kəja̰
ကာယကံ	kàjəgàɴ
ကာယပညာ	kàja̰pjɪ̀ɴɲà
ကာရန်	kəjàɴ
ကာရာအိုကေ	kàɹàʔòkè
ကာလ	kàla̰
ကာလဝမ်း	kàləwʊ́ɴ
ကာလသား	kàləðá
ကာလသားရောဂါ	kàla̰θájɔ́gà
ကာလာမသုတ်	kàlàma̰θoʊʔ
ကာလီဖိုးနီးယား	kàlìpʰóníjá
ကား	ká
ကားဂိတ်	kágeɪʔ
ကားမှတ်တိုင်	kám̥aʔtàɪɴ
ကားရုံ	kájòʊɴ
ကိစ္စ	keɪʔsa̰
ကိတ်	keɪʔ
ကိတ်ဗာဒီ	keɪʔbədì
ကိတ်မုန့်	keɪʔmo̰ʊɴ
ကိန္နရာ	kèɪɴnəjà
ကိန္နရီ	kèɪɴnəjì
ကိန်း	kéɪɴ
ကိန်းရှင်	kéɪɴʃɪ̀ɴ
ကိမိလဗေဒ	kḭmḭla̰bèda̰
ကိရိယာ	kəɹḭjà
ကိလေသာ	kḭlèθà
ကို	kò
ကို	gò
ကို	ɴ
ကို	ʔ
ကိုကာကိုလာ	kòkàkòlà
ကိုကို	kòkò
ကိုက်	kaɪʔ
ကိုက်လန်	kaɪʔlàɴ
ကိုင်	kàɪɴ
ကိုင်ရို	kàɪɴjò
ကိုဆိုဗို	kòsʰòbò
ကိုပင်ဟေဂင်	kòpɪ̀ɴhègɪ̀ɴ
ကိုဘော့	kòbɔ̰
ကိုမိုရို	kòmòɹò
ကိုယ့်ဥမှဥထင်	ko̰jʔṵm̥a̰ʔṵtʰɪ̀ɴ
ကိုယ်	kò
ကိုယ်စားလှယ်	kòjzəl̥ɛ̀
ကိုယ်စားလှယ်အဖွဲ့	kòjzəl̥ɛ̀ʔəpʰwɛ̰
ကိုယ်လုပ်တော်	kòloʊʔtɔ̀
ကိုယ်ဝန်	kòjwʊ̀ɴ
ကိုယ်ဝန်ဆောင်	kòjwʊ̀ɴsʰàʊɴ
ကိုယ်ဝန်ပျက်	kòwʊ̀ɴpjɛʔ
ကိုယ်ဝန်ဖျက်	kòwʊ̀ɴpʰjɛʔ
ကိုယ်ဝန်ရှိ	kòjwʊ̀ɴʃḭ
ကိုရင်	kòjɪ̀ɴ
ကိုရမ်ကျမ်း	kòɹàɴtɕáɴ
ကိုရိုနာဗိုင်းရပ်စ်	kòɹònàbáɪɴɹaʔs
ကိုရီးယား	kòɹíjá
ကိုလိုနီ	kòlònì
ကိုလိုနီဝါဒ	kòlònìwàda̰
ကိုလံဘို	kòlàɴbò
ကိုလံဘီယာ	kòlàɴbìjà
ကိုး	kó
ကိုးကန့်	kóga̰ɴ
ကိုးလ	kóla̰
ကီလိုဂရမ်	kìlògəɹàɴ
ကီလိုမီတာ	kìlòmìtà
ကီးမား	kímá
ကီးမားပလာတာ	kímápəlàtà
ကီးယက်	kíjɛʔ
ကုဋေ	gədè
ကုတ်	koʊʔ
ကုတ်ဟီးနာ	koʊʔhínà
ကုန်	kòʊɴ
ကုန်ကား	kòʊɴgá
ကုန်ကုန်	kòʊɴgòʊɴ
ကုန်စည်	kòʊɴzì
ကုန်တင်ကား	kòʊɴdɪ̀ɴgá
ကုန်ထုတ်သမဝါယမ	kòʊɴtʰoʊʔθəma̰wàjəma̰
ကုန်ပစ္စည်း	kòʊɴpɪʔsí
ကုန်ပဒေသာဆိုင်	kòʊɴbədèθàsʰàɪɴ
ကုန်ပို့လွှာ	kòʊɴpo̰l̥wà
ကုန်သည်	kòʊɴðè
ကုန်သည်ကြီး	kòʊɴðèdʑí
ကုန်သွယ်ရေး	kòʊɴθwɛ̀jé
ကုန်သွယ်ရေးသမဂ္ဂ	kòʊɴθwɛ̀jéða̰mɛʔga̰
ကုန်း	kóʊɴ
ကုန်းနှီး	kóʊɴn̥í
ကုန်းဘောင်	kóʊɴbàʊɴ
ကုန်းဘောင်ကြီး	kóʊɴbàʊɴdʑí
ကုဗ	kṵba̰
ကုဗ္ဘီး	koʊʔbí
ကုဗ္ဘီးတိုင်	koʊʔbídàɪɴ
ကုမုဒ	kṵmoʊʔda̰
ကုမ္ပဏီ	kòʊɴpənì
ကုလသမဂ္ဂ	kṵla̰θa̰mɛʔga̰
ကုလား	kəlá
ကုလားတန်	kələtàɴ
ကုလားထိုင်	kələtʰàɪɴ
ကုလားနို့	kələno̰
ကုလားပဲ	kələpɛ́
ကုလားဖြူ	kələpʰjù
ကုလားအုတ်	kələʔoʊʔ
ကုလားအော်	kələʔɔ̀
ကုသိုလ်	kṵθò
ကုသိုလ်ကံ	kṵðògàɴ
ကုသိုလ်ရှင်	kṵθòʃɪ̀ɴ
ကုံ	kòʊɴ
ကုံကုမံ	gòʊɴgəmàɴ
ကူ	kù
ကူညီ	kùɲì
ကူဖီ	kùpʰì
ကူရှင်	kùʃɪ̀ɴ
ကူလီ	kùlì
ကူဝိတ်	kùweɪʔ
ကူး	kú
ကူးစက်ရောဂါ	kúzɛʔjɔ́gà
ကူးတို့	gədo̰
ကူးတို့ဆိပ်	gədo̰zeɪʔ
ကူးပြောင်း	kúpjáʊɴ
ကူးပြောင်းဆဲကာလ	kúpjáʊɴsʰɛ́kàla̰
ကူးလောင်း	kúláʊɴ
ကေ	kè
ကေတုမဒီ	kètṵmədì
ကေသ	kèθa̰
ကေသာ	kèθà
ကော	kɔ́
ကော	gɔ́
ကောက်	kaʊʔ
ကောက်ညှင်း	kaʊʔɲ̊ɪ́ɴ
ကောက်ညှင်းပေါင်း	kaʊʔɲ̊ɪ́ɴbáʊɴ
ကောက်ညှင်းမှုန့်	kaʊʔɲ̊ɪ́ɴm̥o̰ʊɴ
ကောက်ရိုး	kaʊʔjó
ကောင်	kàʊɴ
ကောင်ငယ်	kàʊɴŋɛ̀
ကောင်စစ်ဝန်	kàʊɴsɪʔwʊ̀ɴ
ကောင်စစ်ဝန်ရုံး	kàʊɴsɪʔwʊ̀ɴjóʊɴ
ကောင်စီ	kàʊɴsì
ကောင်တာ	kàʊɴtà
ကောင်မ	kàʊɴma̰
ကောင်မငယ်	kàʊɴma̰ŋɛ̀
ကောင်မလေး	kàʊɴma̰lé
ကောင်း	káʊɴ
ကောင်းကင်	káʊɴgɪ̀ɴ
ကောင်းကင်ကြိုး	káʊɴgɪ̀ɴdʑó
ကောင်းကင်တမန်	káʊɴgɪ̀ɴtəmàɴ
ကောင်းကင်ဘုံ	káʊɴgɪ̀ɴbòʊɴ
ကောင်းကောင်း	káʊɴgáʊɴ
ကောင်းမှု	káʊɴm̥ṵ
ကောင်းရာသုဂတိ	káʊɴjàθṵgədḭ
ကောဋိ	kɔ́tḭ
ကောဋိပကောဋိ	kɔ́dḭpa̰kɔ́dḭ
ကောဏဂုံ	kɔ́nəgòʊɴ
ကောဏဂုံဘုရား	kɔ́nəgòʊɴpʰəjá
ကောဏ္ဍည	kɔ̀ndəɲa̰
ကောဏ္ဍညဘုရား	kɔ̀ndəɲa̰pʰəjá
ကောလာဟလ	kɔ́làha̰la̰
ကောလိပ်	kɔ́leɪʔ
ကောလိသိန်	kɔ́lḭθèɪɴ
ကောသလ	kɔ́θəla̰
ကော့စတာရီကာ	kɔ̰sətàɹìkà
ကော်	kɔ̀
ကော်ဇော	kɔ̀zɔ́
ကော်တွန်	kɔ̀tʊ̀ɴ
ကော်ပီ	kɔ̀pì
ကော်ပီစာအုပ်	kɔ̀pìsàʔoʊʔ
ကော်ပီသီချင်း	kɔ̀pìθətɕʰɪ́ɴ
ကော်ပြန့်	kɔ̀pja̰ɴ
ကော်ပြန့်ကြော်	kɔ̀pja̰ɴdʑɔ̀
ကော်ပြန့်စိမ်း	kɔ̀pja̰ɴzéɪɴ
ကော်ဖီ	kɔ̀pʰì
ကော်မတီ	kɔ̀mətì
ကော်ရည်ခေါက်ဆွဲ	kɔ̀jìkʰaʊʔsʰwɛ́
ကော်လာ	kɔ̀là
ကဲကုလ	kɛ́kṵla̰
ကဲ့	kɛ̰
ကံ	kàɴ
ကံကုန်	kàɴkòʊɴ
ကံကြမ္မာ	kàɴtɕəmà
ကံတော်ကုန်	kàɴtɔ̀kòʊɴ
ကံသုံးပါး	kàɴθóʊɴbá
ကံ့ကူတံ	ka̰ɴgùdàɴ
ကံ့ကော်	ga̰ɴgɔ̀
ကျ	tɕa̰
ကျက်	tɕɛʔ
ကျက်သရေ	tɕɛʔθəjè
ကျင်	tɕɪ̀ɴ
ကျင်ကြီး	tɕɪ̀ɴdʑí
ကျင်ချောင်း	tɕɪ̀ɴtɕʰáʊɴ
ကျင်စွယ်	tɕɪ̀ɴzwɛ̀
ကျင်း	tɕɪ́ɴ
ကျဉ်း	tɕɪ́ɴ
ကျဉ်းကျပ်	tɕɪ́ɴtɕaʔ
ကျည်	tɕì
ကျည်ကပ်	tɕìgaʔ
ကျည်ဖူး	tɕìbú
ကျနော်	tɕənɔ̀
ကျန်	tɕàɴ
ကျန်း	tɕáɴ
ကျန်းမာ	tɕáɴmà
ကျန်းမာရေး	tɕáɴmàjé
ကျန်းမာရေးပညာ	tɕáɴmàjépa̰ɲà
ကျပ်	tɕaʔ
ကျပ်သား	tɕaʔθá
ကျမ	tɕəma̰
ကျယ်	tɕɛ̀
ကျယ်ဝန်း	tɕɛ̀wʊ́ɴ
ကျာပွတ်	tɕàbʊʔ
ကျား	tɕá
ကျားကျားလျားလျား	tɕádʑájájá
ကျားကျုတ်	tɕádʑoʊʔ
ကျားထိုးခြင်း	tɕátʰódʑɪ́ɴ
ကျားမ	tɕáma̰
ကျားမျက်လုံး	tɕámjɛʔlóʊɴ
ကျားလက်သည်း	tɕálɛʔθɛ́
ကျားလျှာ	tɕáʃà
ကျားသစ်	tɕəθɪʔ
ကျိန္တလီ	tɕèɪɴta̰lì
ကျိန်း	tɕéɪɴ
ကျိပ်	tɕeɪʔ
ကျို	tɕò
ကျိုက္ခမီ	tɕaɪʔkʰəmì
ကျိုက်ထို	tɕaɪʔtʰò
ကျိုက်ထီးရိုး	tɕaɪʔtʰíjó
ကျိုက်မရော	tɕaɪʔməɹɔ́
ကျိုင်းတုံ	tɕáɪɴtòʊɴ
ကျိုး	tɕó
ကျီ	tɕì
ကျီး	tɕí
ကျီးကန်း	tɕígáɴ
ကျီးတာရာ	tɕítàjà
ကျီးနိုးချိန်	tɕínódʑèɪɴ
ကျီးအ	tɕíʔa̰
ကျုပ်	tɕoʊʔ
ကျုပ်တို့	tɕoʊʔto̰
ကျူးကျော်	tɕútɕɔ̀
ကျူးဘား	tɕúbá
ကျေနပ်	tɕènaʔ
ကျော	tɕɔ́
ကျောက်	tɕaʊʔ
ကျောက်ကပ်	tɕaʊʔkaʔ
ကျောက်ကျော	tɕaʊʔtɕɔ́
ကျောက်ကြီး	tɕaʊʔtɕí
ကျောက်ခေတ်	tɕaʊʔkʰɪʔ
ကျောက်ဂွမ်း	tɕaʊʔgʊ́ɴ
ကျောက်စာတိုင်	tɕaʊʔsàdàɪɴ
ကျောက်စိမ်း	tɕaʊʔséɪɴ
ကျောက်တူလုံး	tɕaʊʔtùlóʊɴ
ကျောက်နီ	tɕaʊʔnì
ကျောက်ပွင့်သုပ်	tɕaʊʔpwɪ̰ɴθoʊʔ
ကျောက်ဖရုံ	tɕaʊʔpʰəjòʊɴ
ကျောက်ဖြူ	tɕaʊʔpʰjù
ကျောက်မီး	tɕaʊʔmí
ကျောက်မီးသွေး	tɕaʊʔmíðwé
ကျောက်သင်ပုန်း	tɕaʊʔθɪ̀ɴbóʊɴ
ကျောင်း	tɕáʊɴ
ကျောင်းနေဖက်	tɕáʊɴnèbɛʔ
ကျောင်းသား	tɕáʊɴðá
ကျောင်းသုံးစာအုပ်	tɕáʊɴðóʊɴsàʔoʊʔ
ကျောင်းသူ	tɕáʊɴðù
ကျောပိုးအိတ်	tɕɔ́bóʔeɪʔ
ကျောရိုး	tɕɔ́jó
ကျော်	tɕɔ̀
ကျော်စွာ	tɕɔ̀zwà
ကျေး	tɕé
ကျေးဇူး	tɕézú
ကျေးဇူးတင်	tɕézútɪ̀ɴ
ကျေးဇူးတင်ပါတယ်	tɕézútɪ̀ɴbàdɛ̀
ကျေးဇူးပြု၍	tɕézúpjṵjwḛ
ကျေးဇူးရှင်	tɕézúʃɪ̀ɴ
ကျေးတော်မျိုး	tɕédɔ̀mjó
ကျဲ	tɕɛ́
ကျွတ်	tɕʊʔ
ကျွန်	tɕʊ̀ɴ
ကျွန်တော့်	tɕʊ̀ɴdɔ̰
ကျွန်တော်	tɕʊ̀ɴdɔ̀
ကျွန်တော်တို့	tɕʊ̀ɴdɔ̀do̰
ကျွန်တော်မျိုး	tɕʊ̀ɴdɔ̀mjó
ကျွန်မ	tɕʊ̀ɴma̰
ကျွန်မတို့	tɕʊ̀ɴma̰do̰
ကျွန်ုပ်	tɕənoʊʔ
ကျွန်း	tɕʊ́ɴ
ကျွန်းကလေး	tɕʊ́ɴgəlé
ကျွန်းကိုင်းမှီကိုင်းကျွန်းမှီ	tɕʊ́ɴkáɪɴm̥ìkáɪɴtɕʊ́ɴm̥ì
ကျွန်းစု	tɕʊ́ɴzṵ
ကျွန်းဆွယ်	tɕʊ́ɴzwɛ̀
ကျွမ်း	tɕwáɴ
ကျွမ်းကျင်သူ	tɕwáɴtɕɪ̀ɴðù
ကျွဲ	tɕwɛ́
ကျွဲကော	tɕwɛ́gɔ́
ကျွဲပြည့်စင်	tɕwɛ́pjḭzɪ̀ɴ
ကြက်	tɕɛʔ
ကြက်ခြေ	tɕɛʔtɕʰè
ကြက်ခြေထောက်	tɕɛʔtɕʰèdaʊʔ
ကြက်ခြေနီ	tɕɛʔtɕʰènì
ကြက်ခြေနီအသင်း	tɕɛʔtɕʰènìʔəθɪ́ɴ
ကြက်ဆင်	tɕɛʔsʰɪ̀ɴ
ကြက်ဆီထမင်း	tɕɛʔsʰìtʰəmɪ́ɴ
ကြက်ဆူ	tɕɛʔsʰù
ကြက်တူရွေး	tɕɛʔtùjwé
ကြက်တော	tɕɛʔtɔ́
ကြက်ဖ	tɕɛʔpʰa̰
ကြက်မ	tɕɛʔma̰
ကြက်မောက်	tɕɛʔmaʊʔ
ကြက်မောက်သီး	tɕɛʔmaʊʔθí
ကြက်သား	tɕɛʔθá
ကြက်သီးထ	tɕɛʔθéɪɴtʰa̰
ကြက်သီးမွေးညင်းထ	tɕɛʔθéɪɴmwéɲɪ́ɴtʰa̰
ကြက်သွန်	tɕɛʔθʊ̀ɴ
ကြက်သွန်နီ	tɕɛʔθʊ̀ɴnì
ကြက်သွန်ဖြူ	tɕɛʔθʊ̀ɴbjù
ကြက်သွန်မြိတ်	tɕɛʔθʊ̀ɴmjeɪʔ
ကြက်ဟင်းခါးသီး	tɕɛʔhɪ́ɴgáðí
ကြက်အူချောင်း	tɕɛʔʔùdʑáʊɴ
ကြက်ဦးတွန်	tɕɛʔʔútʊ̀ɴ
ကြခတ်ဝါး	tɕəkʰaʔwá
ကြငှန်း	tɕəŋ̊áɴ
ကြငှန်းတိုင်	tɕəŋ̊áɴdàɪɴ
ကြဉ်	tɕɪ̀ɴ
ကြည့်	tɕḭ
ကြည့်မြင်တိုင်	tɕḭmjɪ̀ɴdàɪɴ
ကြည့်ရှု	tɕḭʃṵ
ကြည့်ရှုသူ	tɕḭʃṵðù
ကြည်	tɕì
ကြည်	tɕɪ̀ɴ
ကြည်းတပ်	tɕídaʔ
ကြပ်	tɕaʔ
ကြမ္မာ	tɕəmà
ကြမ်း	tɕáɴ
ကြယ်	tɕɛ̀
ကြယ်ငါး	tɕɛ̀ŋá
ကြယ်စု	tɕɛ̀zṵ
ကြယ်တံခွန်	tɕɛ̀dəgʊ̀ɴ
ကြယ်နဂါး	tɕɛ̀nəgá
ကြယ်သီး	tɕɛ̀θí
ကြာ	tɕà
ကြာကြာ	tɕàdʑà
ကြာချည်	tɕàtɕʰì
ကြာစေ့	tɕàzḛ
ကြာဆံ	tɕàzàɴ
ကြာဆံသုပ်	tɕàzàɴθoʊʔ
ကြာညို့	tɕàɲo̰
ကြာသပတေး	tɕàθəpədə
ကြာသပတေးဂြိုဟ်	tɕàðəbədédʑò
ကြား	tɕá
ကြိမ်	tɕèɪɴ
ကြိယာ	kəɹḭjà
ကြိယာဝိသေသန	kəɹḭjàwḭθèθəna̰
ကြိုက်	tɕaɪʔ
ကြိုဆို	tɕòzò
ကြိုဆိုပါ၏	tɕòzòbàʔɛ̰
ကြို့	tɕo̰
ကြိုး	tɕó
ကြိုးကြာ	dʑódʑà
ကြိုးစင်	tɕózɪ̀ɴ
ကြိုးစား	tɕózá
ကြီး	tɕí
ကြီးကြီး	tɕídʑí
ကြီးမား	tɕímá
ကြေညာ	tɕèɲà
ကြေညာချက်	tɕèɲàdʑɛʔ
ကြောက်	tɕaʊʔ
ကြောင့်	dʑa̰ʊɴ
ကြောင်	tɕàʊɴ
ကြောင်ကလေး	tɕàʊɴgəlé
ကြောင်ထီး	tɕàʊɴdí
ကြောင်မ	tɕàʊɴma̰
ကြောင်လိမ်လှေကား	tɕàʊɴlèɪɴl̥ègá
ကြောင်လျှာ	tɕàʊɴʃà
ကြောင်အိမ်	tɕàʊɴʔèɪɴ
ကြောင်း	tɕáʊɴ
ကြော်	tɕɔ̀
ကြော်ငြာ	tɕɔ̀ɲà
ကြော်ငြာစာ	tɕɔ̀ɲàzà
ကြေး	dʑí
ကြေး	tɕé
ကြေးကြီး	tɕétɕí
ကြေးချွတ်ဆေး	dʑétɕʰʊʔsʰé
ကြေးငွေ	tɕéŋwè
ကြေးစည်	tɕézì
ကြေးနန်း	tɕénáɴ
ကြေးနီ	tɕénì
ကြေးမုံ	tɕémòʊɴ
ကြေးဝါ	tɕéwà
ကြေးအိုး	tɕéʔó
ကြံ	tɕàɴ
ကြံ့	tɕa̰ɴ
ကြံ့လျော်	tɕa̰ɴʃɔ̀
ကြွ	tɕwa̰
ကြွက်	tɕwɛʔ
ကြွက်နို့	tɕwɛʔno̰
ကြွက်သား	tɕwɛʔθá
ကြွင်း	tɕwɪ́ɴ
ကြွပ်	tɕʊʔ
ကြွယ်	tɕwɛ̀
ကြွား	tɕwá
ကြွေ	tɕwè
ကြွေး	tɕwé
ကွ	kwa̰
ကွက်	kwɛʔ
ကွင်း	kwɪ́ɴ
ကွင်းထိုးဖိနပ်	gwɪ́ɴdópʰənaʔ
ကွတ်	kʊʔ
ကွန်	kʊ̀ɴ
ကွန်ကရစ်	kʊ̀ɴgəɹɪʔ
ကွန်ဂရက်	kʊ̀ɴgəɹɛʔ
ကွန်ဂို	kʊ̀ɴgò
ကွန်ဒုံး	kʊ̀ɴdóʊɴ
ကွန်ပါ	kʊ̀ɴpà
ကွန်ပျူတာ	kʊ̀ɴpjùtà
ကွန်ပျူတာသိပ္ပံပညာ	kʊ̀ɴpjùtàðeɪʔpàɴpjɪ̀ɴɲà
ကွန်ဖရင့်	kʊ̀ɴpʰəɹɪ̰ɴ
ကွန်ဖြူးရှပ်	kʊ̀ɴpʰjúʃaʔ
ကွန်မြူနစ်	kʊ̀ɴmjùnɪʔ
ကွန်ရက်	kʊ̀ɴjɛʔ
ကွမ်ရင်	kwàɴjɪ̀ɴ
ကွမ်ရင်မယ်တော်	kwàɴjɪ̀ɴmɛ̀dɔ̀
ကွမ်းတောင်	kʊ́ɴdàʊɴ
ကွမ်းမွှေး	kʊ́ɴm̥wé
ကွမ်းယာ	kʊ́ɴjà
ကွမ်းရွက်ပင်	kʊ́ɴjwɛʔpɪ̀ɴ
ကွယ်လွန်	kwɛ̀lʊ̀ɴ
ကွာစေ့	kwàsḭ
ကွာရှင်း	kwàʃɪ́ɴ
ကွာလာလမ်ပူ	kwàlàlàɴpù
ကွီး	kwí
ကွေတာလန်း	kwètàláɴ
ကွေတီယို	kwètìjò
ကွေပင်ကား	kwèpɪ̀ɴká
ကွေလာပေး	kwèlàpé
ကွေလာပေးစ	kwèlàpésa̰
ကွေ့တီယို	kwḛtìjò
ကွေး	kwé
ကွဲ	kwɛ́
ကဿပ	kaʔθəpa̰
ကဿပဘုရား	kaʔθəpa̰pʰəjá
ခ	kʰa̰
ခက်	kʰɛʔ
ခက်ရင်း	kʰəjɪ́ɴ
ခကွေး	kʰa̰gwé
ခင်	kʰɪ̀ɴ
ခင်ပွန်း	kʰɪ̀ɴbʊ́ɴ
ခင်ဗျာ	kʰəmjà
ခင်ဗျာ့	kʰɪ̀ɴbja̰
ခင်ဗျား	kʰɪ̀ɴbjá
ခင်ဗျားတို့	kʰɪ̀ɴbjádo̰
ခင်မင်မှု	kʰɪ̀ɴmɪ̀ɴm̥ṵ
ခဏ	kʰəna̰
ခဏခဏ	kʰəna̰kʰəna̰
ခတ္တမန္ဒု	kʰaʔtəmàɴdṵ
ခတ္တိယ	kʰaʔtḭja̰
ခနုံထုပ်	kʰənòʊɴdoʊʔ
ခနုံအီ	kʰənòʊɴʔì
ခန္တီ	kʰàɴtì
ခန္ဓာ	kʰàɴdà
ခန္ဓာငါးပါး	kʰàɴdàŋábá
ခန္ဓာဗေဒ	kʰàɴdàbèda̰
ခန်တမာ	kʰàɴtəmà
ခန်း	kʰáɴ
ခပ်သိမ်း	kʰaʔθéɪɴ
ခမည်းတော်	kʰəmídɔ̀
ခမာ	kʰəmà
ခမာနီ	kʰəmànì
ခမောက်	kʰəmaʊʔ
ခယ်မ	kʰɛ̀ma̰
ခရင်း	kʰəjɪ́ɴ
ခရစ္စမတ်	kʰəɹɪʔsəmaʔ
ခရစ်	kʰəɹɪʔ
ခရစ်တော်	kʰəɹɪʔtɔ̀
ခရစ်ယာန်	kʰəɹɪʔjàn
ခရမ်း	kʰəjáɴ
ခရမ်းချဉ်	kʰəjáɴdʑɪ̀ɴ
ခရမ်းသီး	kʰəjáɴθí
ခရာ	kʰəjà
ခရာမွှေး	kʰəjàm̥wé
ခရိုင်	kʰəjàɪɴ
ခရိုင်းမီးယား	kʰəɹáɪɴmíjá
ခရိုနီ	kʰəɹònì
ခရိုမီယမ်	kʰəɹòmìjàɴ
ခရိုအေးရှား	kʰəɹòʔéʃá
ခရိုး	kʰəjó
ခရီး	kʰəjí
ခရီးသည်	kʰəjíðè
ခရု	kʰəjṵ
ခရုဆီ	kʰəjṵzì
ခရုပက်ကျိ	kʰəjṵpɛʔtɕḭ
ခရေ	kʰəjè
ခရေပွင့်	kʰəjèbwɪ̰ɴ
ခလယ်	kʰəlɛ̀
ခလာသီ	kʰəlàθì
ခလုတ်	kʰəloʊʔ
ခလုတ်ခုံ	kʰəloʊʔkʰòʊɴ
ခဝါ	kʰəwà
ခဝါချ	kʰəwàtɕʰa̰
ခဝဲ	kʰəwɛ́
ခါ	kʰà
ခါကြက်ဥ	kʰàtɕɛʔʔṵ
ခါတွမ်း	kʰàtʊ́ɴ
ခါး	kʰá
ခါးပတ်	gəbaʔ
ခို	kʰò
ခိုင်း	kʰáɪɴ
ခိုဒါ	kʰòdà
ခိုလှုံခွင့်	kʰòl̥òʊɴgwɪ̰ɴ
ခိုး	kʰó
ခိုးစား	kʰósá
ခု	kʰṵ
ခုခံအားကျရောဂါ	kʰṵgàɴʔátɕa̰jɔ́gà
ခုနစ်	kʰʊ̀ɴn̥ɪʔ
ခုနစ်လ	kʰʊ̀ɴn̥əla̰
ခုန်	kʰòʊɴ
ခုံတန်းလျား	kʰòʊɴtáɴjá
ခုံရှည်	kʰòʊɴʃè
ခုံး	kʰóʊɴ
ခူး	kʰú
ခေတ္တ	kʰɪʔta̰
ခေတ်	kʰɪʔ
ခေမာရဋ္ဌ	kʰèmàjətʰa̰
ခေါက်	kʰaʊʔ
ခေါက်ဆွဲ	kʰaʊʔsʰwɛ́
ခေါက်ဆွဲဆိုင်	kʰaʊʔsʰwɛ́zàɪɴ
ခေါက်ဆွဲသုပ်	kʰaʊʔsʰwɛ́θoʊʔ
ခေါက်မုန့်	kʰaʊʔmo̰ʊɴ
ခေါင်း	kʰáʊɴ
ခေါင်း	gáʊɴ
ခေါင်းဆောင်	gáʊɴsʰàʊɴ
ခေါင်းဆောင်	gáʊɴzàʊɴ
ခေါင်းပေါင်း	gáʊɴbáʊɴ
ခေါင်းလောင်း	kʰáʊɴláʊɴ
ခေါင်းလျှော်ရည်	gáʊɴʃɔ̀jè
ခေါင်းအုံး	gáʊɴʔóʊɴ
ခေါပုတ်	kʰɔ́boʊʔ
ခေါပျဉ်	kʰɔ́bjɪ̀ɴ
ခေါ်	kʰɔ̀
ခေး	kʰé
ခဲ	kʰɛ́
ခဲတံ	kʰɛ́dàɴ
ခဲဖျက်	kʰɛ́bjɛʔ
ခဲယဉ်း	kʰɛ́jɪ́ɴ
ခဲယမ်းမီးကျောက်	kʰɛ́jáɴmídʑaʊʔ
ခဲအို	kʰɛ́ʔò
ခဲ့	kʰɛ̰
ခဲ့	gɛ̰
ခံ	kʰàɴ
ခံစား	kʰàɴzá
ခံတပ်	kʰàɴdaʔ
ခံတောင်း	kʰàɴdáʊɴ
ခံမြို့	kʰàɴmjo̰
ခံယူချက်	kʰàɴjùdʑɛʔ
ချ	tɕʰa̰
ချက်	tɕʰɛʔ
ချက်ကိုဆလိုဗားကီးယား	tɕʰɛʔkòsʰəlòbákíjá
ချက်ကြိုး	tɕʰɛʔtɕó
ချက်ချင်း	tɕʰɛʔtɕʰɪ́ɴ
ချက်မြှုပ်	tɕʰɛʔm̥joʊʔ
ချက်သမ္မတနိုင်ငံ	tɕʰɛʔθəməda̰nàɪɴŋàɴ
ချင်	tɕʰɪ̀ɴ
ချင်း	dʑɪ́ɴ
ချင်း	tɕʰɪ́ɴ
ချင်းတွင်း	tɕʰɪ́ɴdwɪ́ɴ
ချင်းမိုင်	tɕʰɪ́ɴmàɪɴ
ချင်းသုပ်	dʑɪ́ɴðoʊʔ
ချစ်	tɕʰɪʔ
ချစ်ခင်	tɕʰɪʔkʰɪ̀ɴ
ချစ်တီး	tɕʰɪʔtí
ချစ်သူ	tɕʰɪʔθù
ချဉ်	tɕʰɪ̀ɴ
ချဉ်ပေါင်	tɕʰɪ̀ɴbàʊɴ
ချဉ်ဖတ်	tɕʰɪ̀ɴbaʔ
ချဉ်ဖတ်တည်	tɕʰɪ̀ɴbaʔtɛ̀
ချည်	tɕʰì
ချည်မန်းကွင်း	tɕʰìmáɴgwɪ́ɴ
ချည်လုံး	tɕʰìlóʊɴ
ချဒ်	tɕʰàd
ချပါတီ	tɕʰəpàtì
ချပ်	dʑaʔ
ချမ်း	tɕʰáɴ
ချမ်းသာ	tɕʰáɴðà
ချယ်ရီ	tɕʰɛ̀ɹì
ချာတိတ်	tɕʰàteɪʔ
ချားလ်	tɕʰál
ချိတ်	dʑeɪʔ
ချိန်တာရာ	tɕʰèɪɴtàjà
ချိပ်	tɕʰeɪʔ
ချို	dʑò
ချို	tɕʰò
ချိုချဉ်	tɕʰòtɕʰɪ̀ɴ
ချိုချဉ်ကြော်	tɕʰòtɕʰɪ̀ɴdʑɔ̀
ချိုင်း	dʑáɪɴ
ချိုင်းထောက်	dʑáɪɴdaʊʔ
ချိုး	tɕʰó
ချီဆီနော	tɕʰìsʰìnɔ́
ချီလီ	tɕʰìlì
ချီး	tɕʰí
ချုပ်	tɕʰoʊʔ
ချူးအင်းဂမ်း	tɕʰúʔɪ́ɴgáɴ
ချေ	dʑè
ချေ	dʑì
ချေ	tɕʰè
ချေ	tɕʰì
ချော	tɕʰɔ́
ချောကလက်	tɕʰɔ́kəlɛʔ
ချောက်	tɕʰaʊʔ
ချောင်	tɕʰàʊɴ
ချောင်း	tɕʰáʊɴ
ချောင်းဆိုး	tɕʰáʊɴsʰó
ချောင်းဆိုး	tɕʰáʊɴzó
ချော်	tɕʰɔ̀
ချေး	tɕʰí
ချေးငွေ	tɕʰíŋwè
ချေးထုပ်	tɕʰétʰoʊʔ
ချေးပါ	tɕʰépà
ချဲ့	tɕʰɛ̰
ချဲ့ချဲ့	tɕʰɛ̰dʑɛ̰
ချွတ်	tɕʰʊʔ
ချွန်	tɕʰʊ̀ɴ
ချွန်ထက်	tɕʰʊ̀ɴtʰɛʔ
ချွေး	tɕʰwé
ချွေးမ	tɕʰwéma̰
ချွံချွံ	tɕʰʊ̀ɴdʑʊ̀ɴ
ခြ	tɕʰa̰
ခြင်	tɕʰɪ̀ɴ
ခြင်း	tɕʰɪ́ɴ
ခြင်းလုံး	tɕʰɪ́ɴlóʊɴ
ခြင်္သေ့	tɕʰɪ̀ɴðḛ
ခြင်္သေ့ကလေး	tɕʰɪ̀ɴðḛgəlé
ခြင်္သေ့မ	tɕʰɪ̀ɴðḛma̰
ခြစ်	tɕʰɪʔ
ခြည်	tɕʰì
ခြတောင်ပို့	tɕʰa̰tàʊɴbo̰
ခြမ်း	tɕʰáɴ
ခြား	tɕʰá
ခြားနား	tɕʰáná
ခြားနားချက်	tɕʰánádʑɛʔ
ခြိုက်	tɕʰaɪʔ
ခြေ	tɕʰè
ခြေစွပ်	tɕʰèzʊʔ
ခြေထောက်	tɕʰèdaʊʔ
ခြေနင်း	tɕʰènɪ́ɴ
ခြေဖနောင့်	tɕʰèbəna̰ʊɴ
ခြေဖဝါး	tɕʰèbəwá
ခြေသည်း	tɕʰèðé
ခြေအိတ်	tɕʰèʔeɪʔ
ခြောက်	tɕʰaʊʔ
ခြောက်လ	tɕʰaʊʔla̰
ခြံ	tɕʰàɴ
ခြွေ	tɕʰwè
ခွက်	kʰwɛʔ
ခွင့်	kʰwɪ̰ɴ
ခွင့်လွှတ်	kʰwɪ̰ɴl̥ʊʔ
ခွင်	kʰwɪ̀ɴ
ခွင်	gwɪ̀ɴ
ခွဆုံ	gwa̰zòʊɴ
ခွန်	kʰʊ̀ɴ
ခွန်း	kʰʊ́ɴ
ခွာ	kʰwà
ခွာနာလျှာနာ	kʰwànàʃànà
ခွေ	kʰwè
ခွေး	kʰwé
ခွေးမ	kʰwéma̰
ခွေးမသား	kʰwéma̰ðá
ခွေးရူးပြန်ရောဂါ	kʰwéjúbjàɴjɔ́gà
ခွေးသူတောင်းစား	kʰwéðədáʊɴzá
ခွေးအ	kʰwéʔa̰
ခွေးအိမ်	kʰwéʔèɪɴ
ခွဲ	kʰwɛ́
ခွံ	kʰʊ̀ɴ
ခွံဝါသီးမွှေး	kʰʊ̀ɴwàθím̥wé
ဂ	ga̰
ဂငယ်	ga̰ŋɛ̀
ဂငယ်ကွေ့	ga̰ŋɛ̀gwḛ
ဂင်းနီဗစ်ဆော	gɪ́ɴnìbɪʔsʰɔ́
ဂင်္ဂါ	gɪ̀ɴgà
ဂဏန်း	gənáɴ
ဂဏန်းတွက်စက်	gənáɴtwɛʔsɛʔ
ဂန္ထဗေဒ	gàɴtʰa̰bèda̰
ဂန္ထဝင်	gàɴdəwɪ̀ɴ
ဂန္ဒမာ	gàɴdəmà
ဂန္ဓာရ	gàɴdàɹa̰
ဂန္ဓာရုံ	gàɴdàjòʊɴ
ဂန်ဂျာ	gàɴdʑà
ဂန်ဒူး	gàɴdú
ဂမ္ဘီရ	gàɴbìja̰
ဂမ်ဘီယာ	gàɴbìjà
ဂယ်လက်ဆီ	gɛ̀lɛʔsʰì
ဂရင်းလန်	gəɹɪ́ɴlàɴ
ဂရပ်	gəɹaʔ
ဂရမ်	gəɹàɴ
ဂရိ	gəɹḭ
ဂရိတ်ဗြိတိန်	gəɹeɪʔbəɹḭtèɪɴ
ဂရု	gəjṵ
ဂရုစိုက်	dəθa̰pàɹəmì
ဂလင်း	gəlɪ́ɴ
ဂဠုန်	gəlòʊɴ
ဂါထာ	gàtʰà
ဂါနာ	gànà
ဂါဘွန်	gàbʊ̀ɴ
ဂိတ်	geɪʔ
ဂိတ်ဆုံး	geɪʔsʰóʊɴ
ဂိမှာန်	gèɪɴm̥àɴ
ဂိရိမေခလာ	gḭɹḭmèkʰəlà
ဂိလာန	gḭlàna̰
ဂိုင်ယာနာ	gàɪɴjànà
ဂိုဏ်း	gón
ဂိုဏ်းချုပ်	gáɪɴdʑoʊʔ
ဂိုဏ်းထောက်	góndaʊʔ
ဂိုဏ်းအုပ်	gónʔoʊʔ
ဂိုဒေါင်	gòdàʊɴ
ဂီတ	gìta̰
ဂီတပညာ	gìta̰pjɪ̀ɴɲà
ဂီတသမား	gìta̰ðəmá
ဂီတာ	gìtà
ဂီနီ	gìnì
ဂီရိ	gìjḭ
ဂုဏ်	gòʊɴ
ဂုန္တန်	gòʊɴdàɴ
ဂုန်နီအိတ်	gòʊɴnìʔeɪʔ
ဂုရု	gṵɹṵ
ဂူ	gù
ဂေဟဗေဒ	gèha̰ta̰bèda̰
ဂေဟာ	gèhà
ဂေါက်	gaʊʔ
ဂေါတမ	gɔ́təma̰
ဂေါတမဘုရား	gɔ́təma̰pʰəjá
ဂေါပက	gɔ́pəka̰
ဂေါပကအဖွဲ့	gɔ́pəka̰ʔəpʰwɛ̰
ဂေါ်	gɔ̀
ဂေါ်ဖီ	gɔ̀bì
ဂေါ်ဖီထုပ်	gɔ̀bìdoʊʔ
ဂေါ်ဖီပန်း	gɔ̀bìpáɴ
ဂေါ်မိတ်	gɔ̀meɪʔ
ဂေါ်ရခါး	gɔ̀ɹəkʰá
ဂေါ်ရခါးသီး	gɔ̀jəkʰáθí
ဂေါ်လီ	gɔ̀lì
ဂေးရှား	géʃá
ဂံ	gàɴ
ဂျက်	dʑɛʔ
ဂျက်လေယာဉ်	dʑɛʔlèjɪ̀ɴ
ဂျင်	dʑɪ̀ɴ
ဂျင်နရေတာ	dʑɪ̀ɴnəɹètà
ဂျင်းဘောင်းဘီ	dʑɪ́ɴbáʊɴbì
ဂျပန်	dʑəpàɴ
ဂျမေကာ	dʑəmèkà
ဂျလေဘီ	dʑəlèbì
ဂျာမနီ	dʑàmənì
ဂျာမန်	dʑàmàɴ
ဂျိုး	dʑó
ဂျီ	dʑì
ဂျီဘူတီ	dʑìbùtì
ဂျီဩမေတြီ	dʑìʔɔ́mètɹì
ဂျုတ်	dʑoʊʔ
ဂျုံ	dʑòʊɴ
ဂျုံမှုန့်	dʑòʊɴm̥o̰ʊɴ
ဂျူဘာ	dʑùbà
ဂျူလိုင်	dʑùlàɪɴ
ဂျူး	dʑú
ဂျူးဘာသာ	dʑúbàðà
ဂျေ	dʑè
ဂျေရုဆလင်	dʑèɹṵsʰa̰lɪ̀ɴ
ဂျော့ခ်ျ	dʑɔ̰tɕʰə
ဂျော်ဂျီယာ	dʑɔ̀dʑìjà
ဂျော်ဒန်	dʑɔ̀dàɴ
ဂျော်နီ	dʑɔ̀nì
ဂြိုဟ်	dʑò
ဂြိုဟ်တု	dʑòdṵ
ဂွမ်း	gʊ́ɴ
ဂွါတီမာလာ	gwàtìmàlà
ဂွေး	gwé
ဃ	ga̰
ဃကြီး	ga̰dʑí
င	ŋa̰
ငချိတ်	ŋətɕʰeɪʔ
ငတ်	ŋaʔ
ငန်	ŋàɴ
ငန်း	ŋáɴ
ငယ်	ŋɛ̀
ငရုတ်	ŋəjoʊʔ
ငရုတ်ကောင်း	ŋəjoʊʔgáʊɴ
ငရုတ်ဆီ	ŋəjoʊʔsʰì
ငရုတ်မှုန့်	ŋəjoʊʔm̥o̰ʊɴ
ငရဲ	ŋəjɛ́
ငရဲကြီးရှစ်ထပ်	ŋəjɛ́dʑíʃɪʔtʰaʔ
ငရဲမင်း	ŋəjɛ́mɪ́ɴ
ငရဲသား	ŋəjɛ́ðá
ငလျင်	ŋəljɪ̀ɴ
ငါ	ŋà
ငါတို့	ŋàto̰
ငါ့	ŋa̰
ငါး	ŋá
ငါးကျပ်တင်	ŋátɕaʔtɪ̀ɴ
ငါးကြင်း	ŋádʑɪ́ɴ
ငါးခူ	ŋəkʰù
ငါးပါးသီလ	ŋábáθìla̰
ငါးပိ	ŋəpḭ
ငါးပိထောင်း	ŋápḭtʰáʊɴ
ငါးပိရည်	ŋəpḭjè
ငါးပုဏ္ဏား	ŋəpòʊɴná
ငါးပေါင်းထုပ်	ŋəbáʊɴdoʊʔ
ငါးဖန်ခွက်	ŋəpʰàɴgwɛʔ
ငါးဖယ်	ŋəpʰɛ̀
ငါးဖျင်းသလက်	ŋəpʰjɪ́ɴθəlɛʔ
ငါးမန်း	ŋəmáɴ
ငါးမုန့်	ŋámo̰ʊɴ
ငါးမူး	ŋámú
ငါးမျှားတံ	ŋəm̥jádàɴ
ငါးမြစ်ချင်း	ŋəmjɪʔtɕʰɪ́ɴ
ငါးရံ့	ŋəja̰ɴ
ငါးလ	ŋála̰
ငါးသလောက်	ŋəθəlaʊʔ
ငါးသလောက်ပေါင်း	ŋəθəlaʊʔbáʊɴ
ငါးဥ	ŋáʔṵ
ငို	ŋò
ငု	ŋṵ
ငုစပ်	ŋṵzaʔ
ငုပ်	ŋoʊʔ
ငုသိမ်	ŋṵðèɪɴ
ငုံး	ŋóʊɴ
ငူတူတူ	ŋùtùdù
ငံ	ŋàɴ
ငံပြာရည်	ŋàɴbjàjè
ငြင်း	ɲɪ́ɴ
ငြမ်း	ɲáɴ
ငြာ	ɲà
ငြိမ်းချမ်းရေး	ɲéɪɴdʑáɴjé
ငြိမ်းချမ်းရေးဝါဒ	ɲéɪɴdʑáɴjèwàda̰
ငွေ	ŋwè
ငွေကိုင်	ŋwèkàɪɴ
ငွေကြေး	ŋwètɕé
ငွေစက္ကူ	ŋwèsɛʔkù
ငွေသား	ŋwèðá
ငွေ့ငွေ့	ŋwḛŋwḛ
ငှက်	ŋ̊ɛʔ
ငှက်ကုလားအုတ်	ŋ̊ɛʔkəláʔoʊʔ
ငှက်ဆိုး	ŋ̊ɛʔsʰó
ငှက်ပျော	ŋəpjɔ́
ငှက်ပျောပေါင်း	ŋ̊əbjɔ́báʊɴ
ငှက်ဖျား	ŋ̊ɛʔpʰjá
ငှက်သိုက်	ŋ̊ɛʔθaɪʔ
ငှါး	ŋ̊á
ငှား	ŋ̊á
စ	sa̰
စက	zəga̰
စကင်ဒီနေးဗီးယား	səkɪ̀ɴdìnébíjá
စကတ်	səkaʔ
စကား	zəgá
စကားထာ	zəgətʰà
စကားနည်းရန်စဲ	zəgánɛ́jàɴzɛ́
စကားပုံ	zəgəbòʊɴ
စကားပြန်	zəgəbjàɴ
စကားပြောကြေးနန်း	zəgábjɔ́tɕénáɴ
စကားလုံး	zəgəlóʊɴ
စကားဝှက်	zəgəʍɛʔ
စကော့တလန်	səkɔ̰təlàɴ
စက္ကန့်	sɛʔka̰ɴ
စက္ကရီတေရီ	sɛʔkəɹìtèjì
စက္ကူ	sɛʔkù
စက်	sɛʔ
စက်ကိရိယာ	sɛʔkəɹḭjà
စက်ခေါင်း	sɛʔgáʊɴ
စက်ဆရာ	sɛʔsʰəjà
စက်ဆုပ်	sɛʔsʰoʊʔ
စက်တင်ဘာ	sɛʔtɪ̀ɴbà
စက်တော်ခေါ်	sɛʔdɔ̀kʰɔ̀
စက်ဘီး	sɛʔbéɪɴ
စက်ရုပ်	sɛʔjoʊʔ
စက်ရုံ	sɛʔjòʊɴ
စက်လှေကား	sɛʔl̥ègá
စက်သုံးဆီဆိုင်	sɛʔθóʊɴsʰìsʰàɪɴ
စက်သေနတ်	sɛʔθənaʔ
စကျင်	sədʑɪ̀ɴ
စကျင်ကျောက်	sədʑɪ̀ɴtɕaʊʔ
စကြဝဠာ	sɛʔtɕàwəlà
စကြာ	sɛʔtɕà
စကြာမုန့်	sɛʔtɕàmo̰ʊɴ
စကြာဝဠာဗေဒ	sɛʔtɕàwəlàbèda̰
စခန်း	səkʰáɴ
စင်	sɪ̀ɴ
စင်ကာပူ	sɪ̀ɴgəpù
စင်စင်	sɪ̀ɴzɪ̀ɴ
စင်တီမီတာ	sɪ̀ɴtìmìtà
စင်း	sɪ́ɴ
စင်္ကာပူ	sɪ̀ɴgəpù
စင်္ကြံ	zɪ́ɴdʑàɴ
စစ်	sɪʔ
စစ်ကိုင်း	zəgáɪɴ
စစ်ကဲ	sɪʔkɛ́
စစ်ခွေး	sɪʔkʰwé
စစ်ဆင်ရေး	sɪʔsʰɪ̀ɴjé
စစ်တန်းလျား	sɪʔtáɴjá
စစ်တပ်	sɪʔtaʔ
စစ်တလင်း	sɪʔtəlɪ́ɴ
စစ်တုရင်	sɪʔbəjɪ̀ɴ
စစ်တောင်း	sɪʔtáʊɴ
စစ်တွေ	sɪʔtwè
စစ်ဗိုလ်	sɪʔbò
စစ်မြေပြင်	sɪʔmjèbjɪ̀ɴ
စစ်ဝါဒ	sɪʔwàda̰
စစ်သင်္ဘော	sɪʔθɪ̀ɴbɔ́
စစ်သမီး	sɪʔθəmí
စစ်သား	sɪʔθá
စစ်အာဏာရှင်ဝါဒ	sɪʔʔànàʃɪ̀ɴwàda̰
စစ်အုပ်ချုပ်ရေးအမိန့်	sɪʔʔoʊʔtɕʰoʊʔjéʔəmḛɪɴ
စစ်အေး	sɪʔʔé
စစ်အေးတိုက်ပွဲ	sɪʔʔétaɪʔpwɛ́
စဉ်	sɪ̀ɴ
စဉ်းစား	sɪ́ɴzá
စဉ်းဝါး	sɪ́ɴwá
စည့်	sḭ
စည်	sì
စည်ပိုင်း	sìbáɪɴ
စည်ဖောင်း	sìbáʊɴ
စည်သူ	sìðù
စည်း	sí
စည်းပုံ	síbòʊɴ
စည်းလုံး	sílóʊɴ
စည်းလုံးညီညွတ်မှု	sílóʊɴɲìɲʊʔm̥ṵ
စတစ်ကာ	sətɪʔkà
စတိ	zədḭ
စတိတ်ရှိုး	səteɪʔʃó
စတိုး	sətó
စတီရီယို	sətìɹìjò
စတီရီယိုတေးစီးရီး	sətìɹìjòtésíɹí
စတု	zətṵ
စတုဂံ	sətṵgàɴ
စတုတ္ထ	zədoʊʔtʰa̰
စတုဒိသာ	sətṵdḭθà
စတုမဟာရာဇ်	sətṵməhàjɪʔ
စတုရန်း	sətṵjáɴ
စတေဒီယံ	sətèdìjàɴ
စနစ်	sənɪʔ
စနေ	sənè
စနေဂြိုဟ်	sənèdʑò
စန္ဒရား	sàɴdəjá
စန္ဒာ	sàɴdà
စန္ဒီ	sàɴdì
စန္ဒြမာသ	sàɴdɹa̰màθa̰
စန္ဒြာ	sàɴdɹà
စန်း	sáɴ
စပ	sa̰pa̰
စပယ်ရာ	səpɛ̀jà
စပါး	zəbá
စပါးကျီ	zəbədʑì
စပါးလင်	zəbəlɪ̀ɴ
စပိန်	səpèɪɴ
စပ်	saʔ
စပ်စု	saʔsṵ
စပျစ်	zəbjɪʔ
စပျစ်စေ့ဆီ	zəbjɪʔsḛzì
စပျစ်သီး	zəbjɪʔθí
စပွတ်နစ်	səpʊʔnɪʔ
စမတ်	səmaʔ
စမတ်ကျ	səmaʔtɕa̰
စမုန်	səmòʊɴ
စမုန်စပါး	səmòʊɴzəbá
စမုန်နက်	səmòʊɴnɛʔ
စမုန်ဖြူ	səmòʊɴpʰjù
စမူဆာ	səmùzà
စမူဆာသုပ်	səmùzàθoʊʔ
စမ်း	sáɴ
စမြိတ်	səmjeɪʔ
စရန်	səjàɴ
စရာ	səjà
စရိတ်	zəjeɪʔ
စရိုက်	zəjaɪʔ
စလုံး	sa̰lóʊɴ
စလွယ်	səlwè
စအို	səʔò
စာ	sà
စာကိုယ်	sàgò
စာကြည့်တိုက်	sàtɕḭdaɪʔ
စာကြည့်တိုက်မှူး	sàtɕḭdaɪʔm̥ú
စာချန်မှတ်	sàdʑàɴm̥aʔ
စာချုပ်	sətɕʰoʊʔ
စာစီစာကုံး	sàsìsàgóʊɴ
စာစောင်	sàzàʊɴ
စာဆို	sàzò
စာတမ်းငယ်	sàdáɴŋɛ̀
စာတိုက်	sàdaɪʔ
စာတိုက်သေတ္တာ	sàdaɪʔθɪʔtà
စာပို့	sàbo̰
စာပို့	sàpo̰
စာပို့လုလင်	sàpo̰lṵlɪ̀ɴ
စာပုံး	sàbóʊɴ
စာပေ	sàpè
စာဖတ်	sàpʰaʔ
စာမရီ	sàməjì
စာမေးပွဲ	sàmébwɛ́
စာမျက်နှာ	sàmjɛʔn̥à
စာမွဲ	səmwɛ́
စာရင်း	səjɪ́ɴ
စာရင်းကိုင်	səjɪ́ɴgàɪɴ
စာရင်းကိုင်ပညာ	səjɪ́ɴgàɪɴpjɪ̀ɴɲà
စာရင်းအင်း	sàjɪ́ɴʔɪ́ɴ
စာရင်းအင်းပညာ	səjɪ́ɴʔɪ́ɴpjɪ̀ɴɲà
စာရေး	səjé
စာရေးဆရာ	sàjésʰəjà
စာရွက်စာတမ်း	sàjwɛʔsàdáɴ
စာလုံးပေါင်းသတ်ပုံ	səlóʊɴbáʊɴθaʔpòʊɴ
စာသင်ခန်း	sàθɪ̀ɴgáɴ
စာသား	sàðá
စာအိတ်	sàʔeɪʔ
စာအုပ်	sàʔoʊʔ
စာအုပ်ဆိုင်	sàʔoʊʔsʰàɪɴ
စား	sá
စားကျက်	zədʑɛʔ
စားချဉ့်ပြန်	sətɕʰɪ̰ɴpjàɴ
စားစရာ	sázəjà
စားတော်ခေါ်	sádɔ̀kʰɔ̀
စားတော်ဆက်	sádɔ̀sʰɛʔ
စားတော်ဆက်	sádɔ̀zɛʔ
စားတော်ပဲ	zədɔ̀bɛ́
စားပြီးပြီလား	sápíbìlá
စားပွဲ	sábwɛ́
စားပွဲ	zəbwɛ́
စားပွဲထိုး	zábwɛ́dó
စားဖို	səpʰò
စားဖိုဆောင်	səpʰòzàʊɴ
စားမြုံ့ပြန်	səmjo̰ʊɴpjàɴ
စားလဒ်	sálaʔ
စားဝတ်နေရေး	sáwʊʔnèjé
စားသုံးသူ	sáθóʊɴðù
စားသုံးသူသမဝါယမ	sáθóʊɴðəma̰wàjəma̰
စားသောက်ဆိုင်	sáθaʊʔsʰàɪɴ
စားအုန်းဆီ	sáʔóʊɴzì
စိတ္တဇ	seɪʔdəza̰
စိတ္တဇပန်းချီ	seɪʔdəza̰bədʑì
စိတ္တဇရောဂါ	seɪʔdəza̰jɔ́gà
စိတ္တဗေဒ	seɪʔta̰bèda̰
စိတ်	seɪʔ
စိတ်ကူး	seɪʔkú
စိတ်ကူးဉာဏ်	seɪʔkúɲàn
စိတ်ကျန်းမာရေး	seɪʔtɕáɴmàjé
စိတ်ဆိုး	seɪʔsʰó
စိတ်ဓာတ်	seɪʔdàt
စိတ်ပညာ	seɪʔpjɪ̀ɴɲà
စိတ်မှတ်	seɪʔm̥aʔ
စိတ်ရောဂါ	seɪʔjɔ́gà
စိန်	sèɪɴ
စိန်တစ်လုံး	sèɪɴtəlóʊɴ
စိန်ဖြူ	sèɪɴpʰjù
စိမ့်	sḛɪɴ
စိမ်း	séɪɴ
စိမ်းစားဥ	séɪɴzáʔṵ
စို	sò
စိုက်	saɪʔ
စိုက်ခင်း	saɪʔkʰɪ́ɴ
စိုက်ပျိုးရေး	saɪʔpjójé
စိုင်ပြင်	sàɪɴpjɪ̀ɴ
စိုင်း	sáɪɴ
စိုထိုင်း	sòtʰáɪɴ
စို့	so̰
စိုး	só
စီဒီ	sìdì
စီလုံ	sìlòʊɴ
စီလုံတီး	sìlòʊɴtí
စီး	sí
စီးကရက်	síkəɹɛʔ
စီးကလိပ်	síkəleɪʔ
စီးနင်း	sínɪ́ɴ
စီးနိတ်	síneɪʔ
စီးပွား	síbwá
စီးပွားရေး	síbwájé
စီးပွားရေးသမား	síbwájéðəmá
စီးရီး	síɹí
စုက္ကတေး	soʊʔkəté
စုစုပေါင်း	sṵzṵbáʊɴ
စုဏ္ဏိယ	sòʊɴnḭja̰
စုတ်	soʊʔ
စုန်း	sóʊɴ
စုပ်	soʊʔ
စုပ်စုပ်	soʊʔsoʊʔ
စုလျား	sṵjá
စုံ	sòʊɴ
စုံစမ်း	sòʊɴzáɴ
စုံထောက်	sòʊɴdaʊʔ
စုံဖက်	sòʊɴpʰɛʔ
စူပါမားကတ်	sùpəmákaʔ
စူးစူး	súzú
စေတနာ	sèdənà
စေတနာရှင်	sèdənàʃɪ̀ɴ
စေတီ	zèdì
စော	sɔ́
စောက်	saʊʔ
စောင့်	sa̰ʊɴ
စောင်	sàʊɴ
စောင်း	sáʊɴ
စောင်းလျား	záʊɴjá
စောစလာ	sɔ́səlà
စောစော	sɔ́zɔ́
စောပြာ	sɔ́bjà
စောဥမ္မာ	sɔ́ʔòʊɴmà
စော်	sɔ̀
စော်ဘွား	sɔ̀bwá
စေ့စပ်	sḛzaʔ
စေ့စပ်ရေး	sḛzaʔjé
စဲ	sɛ́
စံ	sàɴ
စံကား	zəgá
စံပယ်	zəbɛ̀
စံပါ	sàɴpà
စွင့်	swɪ̰ɴ
စွတ်	sʊʔ
စွတ်စွတ်နာ	sʊʔsʊʔnà
စွတ်ဖါး	sʊʔpʰá
စွန့်	sʊ̰ɴ
စွန်	sʊ̀ɴ
စွန်ကုပ်	sʊ̀ɴgoʊʔ
စွပ်	sʊʔ
စွပ်ပြုတ်	sʊʔpjoʊʔ
စွမ်း	swáɴ
စွမ်းအင်	swáɴʔɪ̀ɴ
စွယ်	swɛ̀
စွေ့စွေ့	swḛzwḛ
ဆ	sʰa̰
ဆက္ကဂံ	sʰɛʔkəgàɴ
ဆက်	sʰɛʔ
ဆက်ဆံ	sʰɛʔsʰàɴ
ဆက်သွယ်ရေး	sʰɛʔθwɛ̀jé
ဆင့်	sʰɪ̰ɴ
ဆင့်ကဲဖြစ်စဉ်	sʰɪ̰ɴgɛ́pʰjɪʔsɪ̀ɴ
ဆင်	sʰɪ̀ɴ
ဆင်ခေါင်းပဲ	sʰɪ̀ɴgáʊɴbɛ́
ဆင်ခြေထောက်ရောဂါ	sʰɪ̀ɴtɕʰèdaʊʔjɔ́gà
ဆင်ခြေဖုံး	sʰɪ̀ɴtɕʰèbóʊɴ
ဆင်စွယ်	sʰɪ̀ɴzwɛ̀
ဆင်တာရာ	sʰɪ̀ɴtàjà
ဆင်ဖိုနီ	sʰɪ̀ɴpʰònì
ဆင်ဝင်	sʰɪ̀ɴwɪ̀ɴ
ဆင်အံ	sʰɪ̀ɴʔàɴ
ဆင်း	sʰɪ́ɴ
ဆင်းရဲ	sʰɪ́ɴjɛ́
ဆင်းရဲခြင်း	sʰɪ́ɴjɛ́dʑɪ́ɴ
ဆစ်ဒနီ	sʰɪʔdənì
ဆဋ္ဌဂံ	sʰaʔtʰəgàɴ
ဆဋ္ဌမ	sʰaʔtʰəma̰
ဆဋ္ဌမအာရုံ	sʰaʔtʰəma̰ʔàjòʊɴ
ဆတ္တာသည်	sʰaʔtàðè
ဆတ်	sʰaʔ
ဆတ်သား	sʰaʔθá
ဆန့်ကျင်	sʰa̰ɴdʑɪ̀ɴ
ဆန့်ကျင်ဘက်	sʰa̰ɴdʑɪ̀ɴbɛʔ
ဆန္ဒ	sʰàɴda̰
ဆန္ဒခံယူပွဲ	sʰàɴda̰kʰàɴjùbwɛ́
ဆန္ဒပြပွဲ	sʰàɴda̰pja̰bwɛ́
ဆန်	sʰàɴ
ဆန်ကုန်မြေလေး	sʰàɴkòʊɴmjèlé
ဆန်ကွဲ	zəgwɛ́
ဆန်ခါ	zəgà
ဆန်ညှာ	sʰàɴɲ̊à
ဆန်တာကလော့စ်	sʰàɴtàkəlɔ̰s
ဆန်နာရာ	sʰàɴnàjà
ဆန်ပြား	sʰàɴbjá
ဆန်ပြုတ်	sʰàɴbjoʊʔ
ဆန်ဖရန်စစ္စကို	sʰàɴpʰəɹàɴsɪʔsəkò
ဆန်ဖျား	sʰàɴbjá
ဆန်မာရီနို	sʰàɴmàɹìnò
ဆန်မှုန့်	sʰàɴm̥o̰ʊɴ
ဆန်ရင်း	sʰàɴjɪ́ɴ
ဆန်လတ်	sʰàɴlaʔ
ဆန်း	sʰáɴ
ဆန်းဒဝစ်	sʰáɴdəwɪʔ
ဆနွင်းမကင်း	sʰənwɪ́ɴməkɪ́ɴ
ဆပ္ပတ်	sʰaʔpaʔ
ဆပ်	sʰaʔ
ဆပ်ကပ်	sʰaʔkaʔ
ဆပ်ပြာ	sʰaʔpjà
ဆပ်သွားဖူး	sʰaʔθwápʰú
ဆယ့်ကိုး	sʰɛ̰kó
ဆယ့်ခုနှစ်	sʰɛ̰kʰʊ̀ɴnɪʔ
ဆယ့်ခြောက်	sʰɛ̰tɕʰaʊʔ
ဆယ့်ငါး	sʰɛ̰ŋá
ဆယ့်တစ်	sʰɛ̰tɪʔ
ဆယ့်တစ်လ	sʰɛ̰tɪʔla̰
ဆယ့်နှစ်	sʰɛ̰n̥ɪʔ
ဆယ့်နှစ်ရာသီ	sʰɛ̰n̥əjàθì
ဆယ့်နှစ်လ	sʰɛ̰n̥əla̰
ဆယ့်ရှစ်	sʰɛ̰ʃɪʔ
ဆယ့်လေး	sʰɛ̰lé
ဆယ့်သုံး	sʰɛ̰θóʊɴ
ဆယ်	sʰɛ̀
ဆယ်စုနှစ်	sʰɛ̀zṵn̥ɪʔ
ဆယ်လ	sʰɛ̀la̰
ဆရာ	sʰəjà
ဆရာတော်	sʰəjàdɔ̀
ဆရာမ	sʰəjàma̰
ဆရာလေး	sʰəjàlé
ဆရာဝန်	sʰa̰jàwʊ̀ɴ
ဆရာသမား	sʰa̰jàθəmá
ဆလင်ဒါ	sʰəlɪ̀ɴdà
ဆလတ်	sʰəlaʔ
ဆလဗ	sʰəla̰ba̰
ဆလိမ်	sʰa̰lèɪɴ
ဆလိုင်း	sʰəláɪɴ
ဆလိုဗားကီးယား	sʰəlòbákíjá
ဆလိုဗေးနီးယား	sʰəlòbéníjá
ဆာ	sʰà
ဆာဂျင်	sʰàdʑɪ̀ɴ
ဆာမူရိုင်း	sʰàmùɹáɪɴ
ဆာယာ	sʰàjà
ဆာရာယေဗို	sʰàɹàjèbò
ဆာရီ	sʰàɹì
ဆာရှိမိ	sʰàʃḭmḭ
ဆာလဖာ	sʰàləpʰà
ဆား	sʰá
ဆားကြက်ဥ	sʰátɕɛʔʔṵ
ဆားစိမ်	sʰásèɪɴ
ဆားဘီးယား	sʰábíjá
ဆားဘဲဥ	sʰábɛ́ʔṵ
ဆားရည်	sʰájè
ဆိတ်	sʰeɪʔ
ဆိတ်ကုလား	sʰeɪʔkəlá
ဆိတ်ချေး	sʰeɪʔtɕʰí
ဆိတ်ထီး	sʰeɪʔtʰí
ဆိတ်မ	sʰeɪʔma̰
ဆိပ်	sʰeɪʔ
ဆိပ်ကမ်း	sʰeɪʔkáɴ
ဆိမ့်	sʰḛɪɴ
ဆို	sʰò
ဆိုကရေးတီး	sʰòka̰jétí
ဆိုကရေးတီး	sʰòkəɹétí
ဆိုက်	sʰaɪʔ
ဆိုက်ကား	sʰaɪʔká
ဆိုက်ပရပ်စ်	sʰaɪʔpəɹaʔs
ဆိုက်ဘေးရီးယား	sʰaɪʔbéɹíjá
ဆိုင်	sʰàɪɴ
ဆိုင်း	sʰáɪɴ
ဆိုင်းထိုး	sʰáɪɴtʰó
ဆိုင်းဘုတ်	sʰáɪɴboʊʔ
ဆိုင်းဝိုင်း	sʰáɪɴwáɪɴ
ဆိုဆုံးမ	sʰòsʰóʊɴma̰
ဆိုတော်မူ	sʰòdɔ̀mù
ဆိုထုံး	sʰòdóʊɴ
ဆိုဒီယမ်	sʰòdìjàɴ
ဆိုဖာ	sʰòpʰà
ဆိုဖီယာ	sʰòpʰìjà
ဆိုဗီယက်	sʰòbìjɛʔ
ဆိုမာလီယာ	sʰòmàlìjà
ဆိုမြည်	sʰòmjì
ဆိုရိုးစကား	sʰòjózəgá
ဆိုလျှင်	sʰòl̥jɪ̀ɴ
ဆိုး	sʰó
ဆိုးဆေး	sʰózé
ဆီ	sʰì
ဆီချက်	sʰìdʑɛʔ
ဆီချက်ခေါက်ဆွဲ	sʰìdʑɛʔkʰaʊʔsʰwɛ́
ဆီထမင်း	sʰìtʰəmɪ́ɴ
ဆီနိတ်	sʰìneɪʔ
ဆီနီဂေါ	sʰìnìgɔ́
ဆီပြန်	sʰìbjàɴ
ဆီမီး	sʰìmí
ဆီမီးတောက်	sʰìmídaʊʔ
ဆီယူ	sʰìjù
ဆီရာလီယွန်	sʰìɹàlìjʊ̀ɴ
ဆီဥကြော်	sʰəʔṵdʑɔ̀
ဆီး	sʰí
ဆီးချို	sʰídʑò
ဆီးချုပ်ရောဂါ	sʰídʑoʊʔjɔ́gà
ဆီးပူညောင်းကျ	sʰípùɲáʊɴtɕa̰
ဆီးဖြူ	zíbjù
ဆီးရီးယား	sʰíɹíjá
ဆီးသွား	sʰíθwá
ဆီးအိမ်	sʰíʔèɪɴ
ဆီးအောင့်ရောဂါ	sʰíʔa̰ʊɴjɔ́gà
ဆု	sʰṵ
ဆုံ	sʰòʊɴ
ဆုံး	sʰóʊɴ
ဆုံးပါး	sʰóʊɴpá
ဆုံးဖြတ်	sʰóʊɴpʰjaʔ
ဆုံးမ	sʰóʊɴma̰
ဆူ	sʰù
ဆူဒန်	sʰùdàɴ
ဆူရာနမ်	sʰùɹànàɴ
ဆူရှီ	sʰùʃì
ဆူး	sʰú
ဆူးပုပ်	sʰúboʊʔ
ဆောက်	sʰaʊʔ
ဆောင်	sʰàʊɴ
ဆောင်တောင်း	sʰàʊɴdáʊɴ
ဆောင်ပုဒ်	sʰàʊɴboʊʔ
ဆောင်း	sʰáʊɴ
ဆောင်းပါး	sʰáʊɴbá
ဆောင်းရာသီ	sʰáʊɴjàðì
ဆောင်းဦး	sʰáʊɴʔú
ဆောင်းဦးရာသီ	sʰáʊɴʔújàðì
ဆောရီး	sʰɔ́ɹí
ဆော့	sʰɔ̰
ဆော့ဖ်ဝဲလ်	sʰaʊʔwɛ́
ဆော်ဒီအာရေဗျ	sʰɔ̀dìʔàɹèbja̰
ဆေး	sʰé
ဆေးခန်း	sʰékʰáɴ
ဆေးခြောက်	sʰédʑaʊʔ
ဆေးစာ	sʰézà
ဆေးဆိုင်	sʰézàɪɴ
ဆေးတံ	sʰédàɴ
ဆေးပေါ့လိပ်	sʰébɔ̰leɪʔ
ဆေးပြင်းလိပ်	sʰébjɪ́ɴleɪʔ
ဆေးဘဲဥ	sʰébɛ́ʔṵ
ဆေးရုံ	sʰéjòʊɴ
ဆေးရှဲ	sʰéʃɛ́
ဆေးလိပ်	sʰéleɪʔ
ဆေးလိပ်မသောက်ရ	sʰéleɪʔməθaʊʔja̰
ဆေးလုံး	sʰélóʊɴ
ဆံ	sʰàɴ
ဆံကျင်တာရာ	sʰàɴtɕɪ̀ɴtàjà
ဆံခြည်	sʰàɴtɕʰì
ဆံတော်ချ	sʰàɴtɔ̀tɕʰa̰
ဆံပင်	zəbɪ̀ɴ
ဆံပင်ညှပ်	zəbɪ̀ɴɲ̊aʔ
ဆံပင်ညှပ်ဆိုင်	zəbɪ̀ɴɲ̊aʔsʰàɪɴ
ဆံပင်တု	zəbɪ̀ɴdṵ
ဆံပင်ပုံစံ	zəbɪ̀ɴpòʊɴzàɴ
ဆွစ်ဇာလန်	sʰwɪʔzəlàɴ
ဆွဆွ	sʰwa̰zwa̰
ဆွပ်	sʰʊʔ
ဆွမ်း	sʰʊ́ɴ
ဆွမ်းကျွေး	sʰʊ́ɴtɕwé
ဆွမ်းမွှေး	sʰʊ́ɴm̥wé
ဆွမ်းအုပ်	sʰʊ́ɴʔoʊʔ
ဆွယ်တာ	sʰwɛ̀tà
ဆွာဇီလန်	sʰwàzìlàɴ
ဆွီဒင်	sʰwìdɪ̀ɴ
ဆွေခုနစ်ဆက်မျိုးခုနစ်ဆက်	sʰwèkʰənəzɛʔmjókʰənəzɛʔ
ဆွဲ	sʰwɛ́
ဆွဲကြိုး	sʰwɛ́dʑó
ဆွဲအံ	sʰwɛ́ʔàɴ
ဇ	za̰
ဇက်ခွံ့	zɛʔkʰʊ̰ɴ
ဇကွဲ	za̰gwɛ́
ဇင့်ခ်	zɪ̰ɴ
ဇင်ဘာဘွေ	zɪ̀ɴbàbwè
ဇင်းမယ်	zɪ́ɴmɛ̀
ဇင်္ဂမဥစ္စာ	zɪ̀ɴgəma̰ʔoʊʔsà
ဇစ်	zɪʔ
ဇနကထာ	zəna̰gətʰà
ဇနပုဒ်	zənəpoʊʔ
ဇနီး	zəní
ဇန်နဝါရီ	zàɴnəwàɹì
ဇမ္ဗုသပြေ	zəbṵðəpjè
ဇမ္ဗူ	zəbù
ဇမ္ဗူဒီပါ	zəbùdìpà
ဇမ္ဗူပနီ	zəbùpənì
ဇမ်ဘီယာ	zàɴbìjà
ဇယ	zəja̰
ဇယား	zəjá
ဇရပ်	zəjaʔ
ဇရာ	zəjà
ဇလပ်	zəlaʔ
ဇလဗေဒ	zəla̰bèda̰
ဇလုံ	zəlòʊɴ
ဇာ	zà
ဇာဂနာ	zàgənà
ဇာဂရက်	zàgəɹɛʔ
ဇာတိ	zàtḭ
ဇာတိပ္ဖိုလ်	zàdeɪʔpʰò
ဇာတိပ္ဖိုလ်စေ့	zàdeɪʔpʰòzḛ
ဇာတိမာန်	zàtḭmàn
ဇာတိမြို့	zàtḭmjo̰
ဇာတိမြေ	zàtḭmjè
ဇာတိသွေး	zàtḭðwé
ဇာတ်	zaʔ
ဇာတ်ကား	zaʔká
ဇာတ်ကြီးဆယ်ဘွဲ့	zàtdʑísʰɛ̀bwɛ̰
ဇာတ်ခုံ	zaʔkʰòʊɴ
ဇာတ်ဆောင်	zaʔsʰàʊɴ
ဇာတ်ညွှန်း	zàtɲ̊ʊ́ɴ
ဇာတ်တော်	zàt
ဇာတ်ရုံ	zaʔjòʊɴ
ဇာနည်	zànì
ဇိန	zḭna̰
ဇိမ်	zèɪɴ
ဇိမ်မယ်	zèɪɴmɛ̀
ဇီဇဝါ	zìzəwà
ဇီရာ	zìjà
ဇီရာစေ့	zìjàsḛ
ဇီဝ	zìwa̰
ဇီဝကမ္မဗေဒ	zìwa̰kàɴma̰bèda̰
ဇီဝစက်	zìwa̰sɛʔ
ဇီဝဓာတုဗေဒ	zìwa̰dàtṵbèda̰
ဇီဝဗေဒ	zìwa̰bèda̰
ဇီး	zí
ဇီးလျှော	zíʃɔ́
ဇူလိုင်	zùlàɪɴ
ဇေ	zè
ဇေယျ	zèja̰
ဇေယျာပူရ	zèja̰pùɹa̰
ဇော်ဂျီ	zɔ̀dʑì
ဇွန်	zʊ̀ɴ
ဇွန်း	zʊ́ɴ
ဈ	za̰
ဈမျဉ်းဆွဲ	za̰mjɪ́ɴzwɛ́
ဈာန်	zàn
ဈာပန	zàpəna̰
ဈေး	zé
ဈေးကြီး	zétɕí
ဈေးကွက်စီးပွားရေး	zégwɛʔsíbwájé
ဈေးချို	zétɕʰò
ဈေးဆိုင်	zésʰàɪɴ
ဈေးဆိုင်	zézàɪɴ
ဈေးနှုန်း	zén̥óʊɴ
ဈေးဝယ်	zéwɛ̀
ဈေးဝယ်စင်တာ	zéwɛ̀sɪ̀ɴtà
ဈေးသည်	zéðɛ̀
ဉ	ɲa̰
ဉာဉ်	ɲɪ̀ɴ
ဉာဏလုပ်သား	ɲàna̰loʊʔðá
ဉာဏ်	ɲàn
ဉာဏ်စမ်း	ɲànsáɴ
ဉာဏ်တော်	ɲàɴdɔ̀
ဉာဏ်ပူဇော်ခ	ɲànpùzɔ̀kʰa̰
ဉာဏ်သစ်အရေးတော်ပုံ	ɲàɴθɪʔʔəjédɔ̀bòʊɴ
ဉာတိ	ɲàtḭ
ည	ɲa̰
ညကလေး	ɲa̰kəlé
ညကြီး	ɲa̰tɕí
ညချမ်း	ɲa̰dʑáɴ
ညစာ	ɲa̰zà
ညစ်	ɲɪʔ
ညစ်ထည်း	ɲɪʔtʰé
ညဈေး	ɲa̰zé
ညဉ့်	ɲɪ̰ɴ
ညဉ့်ဦးယံ	ɲɪ̰ɴʔújàɴ
ညည်း	ɲí
ညနေ	ɲa̰nè
ညနေခင်း	ɲa̰nègɪ́ɴ
ညလေး	ɲa̰lé
ညသန်းခေါင်	ɲa̰ðəgàʊɴ
ညအိပ်ဝတ်စုံ	ɲa̰ʔeɪʔwʊʔsòʊɴ
ညာ	ɲà
ညိ	ɲḭ
ညို	ɲò
ညီ	ɲì
ညီနောင်	ɲìnàʊɴ
ညီမ	ɲìma̰
ညီမျှခြင်း	ɲìm̥ja̰dʑɪ́ɴ
ညီလာခံ	ɲìlàgàɴ
ညီအစ်ကို	ɲìʔəkò
ညီအစ်မ	ɲìʔəma̰
ညောင်	ɲàʊɴ
ညောင်ဖြူ	ɲàʊɴbjù
ညောင်ဗောဓိ	ɲàʊɴbɔ́dḭ
ညောင်ရမ်းတိုင်	ɲàʊɴjáɴdàɪɴ
ညောင်လေးပင်	ɲàʊɴlépɪ̀ɴ
ညောင်းကျရောဂါ	ɲáʊɴtɕa̰jɔ́gà
ညေး	ɲé
ညဲ	ɲɛ́
ညံစာစာ	ɲàɴsàzà
ညွန့်	ɲʊ̰ɴ
ညွန့်ပေါင်း	ɲʊ̰ɴbáʊɴ
ညွှန်	ɲ̊ʊ̀ɴ
ညှင်း	ɲ̊ɪ́ɴ
ညှစ်	ɲ̊ɪʔ
ညှပ်	ɲ̊aʔ
ညှာ	ɲ̊à
ဋ	ta̰
ဋသန်လျင်းချိတ်	ta̰θəjɪ́ɴdʑeɪʔ
ဌ	tʰa̰
ဌဝမ်းဘဲ	tʰa̰wʊ́ɴbɛ́
ဌာန	tʰàna̰
ဌာနေ	tʰànè
ဌာပနာ	tʰàpənà
ဌေး	tʰé
ဍ	da̰
ဍရင်ကောက်	da̰jɪ̀ɴgaʊʔ
ဎ	da̰
ဎရေမှုတ်	da̰jèm̥oʊʔ
ဏ	na̰
ဏကြီး	na̰dʑí
တ	ta̰
တ	tə
တကယ်	dəgɛ̀
တကာ	dəgà
တက္ကစီ	tɛʔkəsì
တက္ကဗေဒ	tɛʔka̰bèda̰
တက္ကသိုလ်	tɛʔkəθò
တက်	tɛʔ
တက်တက်မ	tɛʔtɛʔma̰
တကွ	dəgwa̰
တချို့	tətɕʰo̰
တခြား	tətɕʰá
တင့်ကား	tɪ̰ɴká
တင်	tɪ̀ɴ
တင်ကူး	tɪ̀ɴgú
တင်ဒါ	tɪ̀ɴdà
တင်ပါ့ဘုရား	tɪ̀ɴba̰pʰəjá
တင်းတင်း	tɪ́ɴtɪ́ɴ
တင်းထိမ်	tɪ́ɴdèɪɴ
တင်းနစ်	tɪ́ɴnɪʔ
တစပြင်	dəza̰bjɪ̀ɴ
တစောင်း	dəzáʊɴ
တစ္ဆေ	təsʰè
တစ်	tɪʔ
တစ်ခုခု	təkʰṵkʰṵ
တစ်ခုလပ်	təkʰṵlaʔ
တစ်ချောင်းပုဒ်	tətɕʰáʊɴpoʊʔ
တစ်စုံ	dəzòʊɴ
တစ်စုံတစ်ခု	təzòʊɴtəkʰṵ
တစ်စုံတစ်ယောက်	təzòʊɴtəjaʊʔ
တစ်စုံတစ်ရာ	təzòʊɴtəjà
တစ်စုံတစ်ဦး	təzòʊɴtəʔú
တစ်ဆယ်	təzɛ̀
တစ်ထောင်	tətʰàʊɴ
တစ်ပင်တိုင်မင်းသမီး	dəbɪ̀ɴdàɪɴmɪ́ɴðəmí
တစ်ပတ်	dəbaʔ
တစ်ယောက်ယောက်	təjaʊʔjaʊʔ
တစ်ရာ	təjà
တစ်လ	təla̰
တဆယ်	təzɛ̀
တဆေး	təsʰé
တညင်း	dəɲɪ́ɴ
တညင်းသီး	dəɲɪ́ɴðí
တည်	tì
တည်	tɛ̀
တည်ဆောက်	tìsʰaʊʔ
တည်တံ့	tìda̰ɴ
တည်ထောင်	tìdàʊɴ
တည်လည်	tìlì
တည်း	tʰɛ́
တည်းခိုခန်း	tʰɛ́kʰògáɴ
တဏှင်္ကရာ	tən̥ɪ̀ɴkəɹà
တဏှင်္ကရာဘုရား	tən̥ɪ̀ɴkəɹàpʰəjá
တဏှာ	tən̥à
တတိယ	ta̰tḭja̰
တတ်	daʔ
တတ်	taʔ
တတ်	ɴ
တတ်	ʔ
တန	ta̰na̰
တနင်္ဂနွေ	tənɪ̀ɴgənwè
တနင်္လာ	tənɪ́ɴlà
တနင်္သာရီ	tənɪ̀ɴθàjì
တန်	tàɴ
တန်ခိုးရှင်	tàɴkʰóʃɪ̀ɴ
တန်ခူး	dəgú
တန်ဆောင်	dəzàʊɴ
တန်ဆောင်မုန်း	dəzàʊɴmóʊɴ
တန်ဇေးနီးယား	tàɴzéníjá
တန်း	táɴ
တပည့်တော်	dəbḭdɔ̀
တပည့်တော်မ	dəbḭdɔ̀ma̰
တပို့တွဲ	dəbo̰dwɛ́
တပေါင်း	dəbáʊɴ
တပေါင်းလပြည့်နေ့	dəbáʊɴla̰pjḭnḛ
တပ်	taʔ
တပ်ကြပ်	taʔtɕaʔ
တပ်ကြပ်ကြီး	taʔtɕaʔtɕí
တပ်ခွဲတပ်ကြပ်ကြီး	taʔkʰwɛ́taʔtɕaʔtɕí
တပ်စု	taʔsṵ
တပ်ပြေး	taʔpjé
တပ်မတော်	taʔmədɔ̀
တပ်မတော်နေ့	taʔmədɔ̀nḛ
တပ်မဟာ	taʔməhà
တပ်ရင်း	taʔjɪ́ɴ
တပ်သား	taʔθá
တဘက်	dəbɛʔ
တဘီလစ်ဆီ	təbìlɪʔsʰì
တမန်	təmàɴ
တမန်တော်	təmàɴdɔ̀
တမလန်း	təməláɴ
တမ်း	táɴ
တယော	təjɔ́
တယ်	tɛ̀
တယ်လင်း	tɛ̀lɪ́ɴ
တယ်လီဖုန်း	tɛ̀lìpʰóʊɴ
တယ်လီဗီးရှင်း	tɛ̀lìbíʃɪ́ɴ
တရဖျား	ta̰ja̰pʰjá
တရား	təjá
တရားခံ	təjəkʰàɴ
တရားခွင်	təjəkʰwɪ̀ɴ
တရားစွဲ	təjáswɛ́
တရားရုံး	təjájóʊɴ
တရားလို	təjálò
တရားလွှတ်တော်	təjál̥ʊʔtɔ̀
တရားလွှတ်တော်ချုပ်	təjál̥ʊʔtɔ̀dʑoʊʔ
တရားသူကြီး	təjáðùdʑí
တရုတ်	təjoʊʔ
တရုတ်ကတ်	təjoʊʔkaʔ
တရုတ်စံကား	ta̰joʊʔsàɴká
တရုတ်ဆီးသီး	təjoʊʔzíθí
တရုတ်နံနံ	ta̰joʊʔnàɴnàɴ
တရုတ်နှင်းသီး	ta̰joʊʔn̥ɪ́ɴθí
တရုတ်မဆလာ	təjoʊʔməsʰəlà
တရှကင့်	ta̰ʃəkɪ̰ɴ
တလည်း	təlé
တလိုင်း	təláɪɴ
တလွဲ	təlwɛ́
တာ	tà
တာချီလိတ်	tàtɕʰìleɪʔ
တာဂျစ်ကစ္စတန်	tàdʑɪʔkɪʔsətàɴ
တာတား	tàtá
တာမွေ	tàmwè
တာယာ	tàjà
တာရာ	tàjà
တာလုဇ	tàlṵza̰
တာဝတိံသာ	tàwa̰tèɪɴθà
တာဝန်	tàwʊ̀ɴ
တာဝန်ခံအဖွဲ့	tàwʊ̀ɴkʰàɴʔəpʰwɛ̰
တာ့ခ်မင်နစ္စတန်	ta̰kʰmɪ̀ɴnɪʔsətàɴ
တား	tá
တိ	tḭ
တိတ်	teɪʔ
တိန်းညက်	téɪɴɲɛʔ
တိပိဋက	tḭpḭtəka̰
တိပ်ခွေ	teɪʔkʰwè
တိမ်	tèɪɴ
တိရစ္ဆာန်	təɹeɪʔsʰàɴ
တိရစ္ဆာန်ရုံ	təɹeɪʔsʰàɴjòʊɴ
တို	tò
တိုက်	taɪʔ
တိုက်ခန်း	taɪʔkʰáɴ
တိုက်ပုံ	taɪʔpòʊɴ
တိုက်ပွဲ	taɪʔpwɛ́
တိုက်လေယာဉ်	taɪʔlèjɪ̀ɴ
တိုက်အိမ်	taɪʔʔèɪɴ
တိုကျို	tòtɕò
တိုဂို	tògò
တိုင်	tàɪɴ
တိုင်ကီ	tàɪɴkì
တိုင်ပင်	tàɪɴbɪ̀ɴ
တိုင်ဖွန်း	tàɪɴpʰʊ́ɴ
တိုင်း	táɪɴ
တိုင်းဒေသကြီး	táɪɴdèθa̰dʑí
တိုင်းပြည်	táɪɴpjì
တိုင်းမင်းကြီး	táɪɴmɪ́ɴdʑí
တိုင်းရင်းသား	táɪɴjɪ́ɴðá
တိုဖူး	tòpʰú
တိုရ	tòɹa̰
တိုရှေ	tòʃè
တိုဟူး	tòhú
တိုဟူးနွေး	tòhúnwé
တိုဟူးသုပ်	tòhúθoʊʔ
တို့	do̰
တိုး	tó
တိုးတက်	tótɛʔ
တိုးတက်ခြင်း	tótɛʔdʑɪ̀ɴ
တိုးတက်ရေး	tótɛʔjé
တိုးတိုး	tódó
တိုးနရား	tónəjá
တိဿ	teɪʔθa̰
တိဿဘုရား	teɪʔθa̰pʰəjá
တီ	tì
တီကောင်	tìgàʊɴ
တီကေ့	tìkḛ
တီချယ်	tìtɕʰɛ̀
တီထွင်	tìtʰwɪ̀ɴ
တီထွင်မှု	tìtʰwɪ̀ɴm̥ṵ
တီဗီ	tìbì
တီရာနာ	tìɹànà
တီရှပ်	tìʃaʔ
တီဟီရန်	tìhìɹàɴ
တီး	tí
တီးတိုးပြော	tídópjɔ́
တုတ်	doʊʔ
တုတ်ထိုး	doʊʔtʰó
တုတ်မီး	doʊʔmí
တုသိတာ	toʊʔθḭtà
တုံး	tóʊɴ
တူ	tù
တူညီဝတ်စုံ	tùɲìwʊʔsòʊɴ
တူနစ်စ်	tùnɪʔs
တူနီးရှား	tùníʃá
တူမ	tùma̰
တူရကီ	tùɹəkì
တူရိယာ	tùɹḭjà
တူး	tú
တူးမြောင်း	túmjáʊɴ
တူးရစ်	túɹɪʔ
တေဇော	tèzɔ́
တေသံ	tèðàɴ
တော	tɔ́
တောက်တောက်ကြော်	taʊʔtaʊʔtɕɔ̀
တောက်တဲ့	taʊʔtɛ̰
တောက်ပ	taʊʔpa̰
တောကြက်မောက်	tɔ́tɕɛʔmaʊʔ
တောခွေး	tɔ́gwé
တောင်	tàʊɴ
တောင်ကိုရီးယား	tàʊɴkòɹíjá
တောင်ကြား	tàʊɴdʑá
တောင်ကြီး	tàʊɴdʑí
တောင်ခြင်္သေ့	tàʊɴtɕʰɪ̀ɴθḛ
တောင်ငူ	tàʊɴŋù
တောင်ဆူဒန်	tàʊɴsʰùdàɴ
တောင်ပိုင်းသမုဒ္ဒရာ	tàʊɴbáɪɴθəmoʊʔdəjà
တောင်ပံ	tàʊɴbàɴ
တောင်ဖက်ဝန်း	tàʊɴpʰɛʔwʊ́ɴ
တောင်သူ	tàʊɴðù
တောင်သူလယ်သမား	tàʊɴðùlɛ̀ðəmá
တောင်သူလယ်သမားနေ့	tàʊɴðùlɛ̀θəmánḛ
တောင်အမေရိက	tàʊɴʔəmèɹḭka̰
တောင်အာဖရိက	tàʊɴʔàpʰəɹḭka̰
တောင်အာရှ	tàʊɴʔàʃa̰
တောင်း	táʊɴ
တောင်းပန်	táʊɴbàɴ
တောမန်ကျည်း	tɔ́mədʑí
တောသား	tɔ́ðá
တောသီတင်း	tɔ́θìdɪ́ɴ
တော်	tɔ̀
တော်ပြီ	tɔ̀bì
တော်လေးဝ	tɔ̀léwa̰
တော်လှန်	tɔ̀l̥àɴ
တော်လှန်ရေး	tɔ̀l̥àɴjé
တော်လှန်ရေးသမား	tɔ̀l̥àɴjéðəmá
တော်သလင်း	tɔ̀ðəlɪ́ɴ
တေး	té
တေးစီးရီး	tésíɹí
တေးသံရှင်	téθàɴʃɪ̀ɴ
တေးသွား	téðwá
တဲ	tɛ́
တဲ့	dɛ̰
တံ	tàɴ
တံခါး	dəgá
တံခါးခုံ	dəgəkʰòʊɴ
တံခါးဗိုလ်	dəgábò
တံခွန်	dəgʊ̀ɴ
တံခွန်တိုင်	dəgʊ̀ɴdàɪɴ
တံငါ	təŋà
တံငါတာရာ	tàɴŋàtàjà
တံစဉ်	dəzɪ̀ɴ
တံစဉ်း	dəzɪ́ɴ
တံဆိပ်	dəzeɪʔ
တံဆိပ်ခေါင်း	dəzeɪʔgáʊɴ
တံတား	dədá
တံတိုင်း	dədáɪɴ
တံတောင်	dədàʊɴ
တံပိုး	dəbó
တံပူ	dəbù
တံမြက်စည်း	dəbjɛʔsí
တံ့တံ့	ta̰ɴda̰ɴ
တြိ	təɹḭ
တြိဂံ	tɹḭgàɴ
တြိပူရ	təɹḭpùja̰
တွက်	twɛʔ
တွင်	twɪ̀ɴ
တွင်း	twɪ́ɴ
တွတ်	tʊʔ
တွန်း	tʊ́ɴ
တွပ်	tʊʔ
တွေ	dwè
တွေ့	twḛ
တွေး	twé
ထ	tʰa̰
ထက်	tʰɛʔ
ထက်ဝယ်ဖွဲ့ခွေ	tʰɛʔwɛ̀pʰwɛ̰kʰwè
ထင်	tʰɪ̀ɴ
ထင်စား	tʰɪ̀ɴzá
ထင်း	tʰɪ́ɴ
ထဆင်ထူး	tʰa̰sʰɪ̀ɴdú
ထည်	tʰɛ̀
ထနောင်း	tʰənáʊɴ
ထန်း	tʰáɴ
ထန်းပင်မြစ်	tʰáɴpɪ̀ɴmjɪʔ
ထန်းလျက်	tʰəɲɛʔ
ထပ်	tʰaʔ
ထပ်တစ်ရာ	tʰaʔtəjà
ထဘီ	tʰəmì
ထမင်း	tʰəmɪ́ɴ
ထမင်းကြော်	tʰəmɪ́ɴdʑɔ̀
ထမင်းချဉ်	tʰəmɪ́ɴdʑɪ̀ɴ
ထမင်းချိုး	tʰəmɪ́ɴdʑó
ထမင်းဆိုင်	tʰəmɪ́ɴzàɪɴ
ထမင်းသုပ်	tʰa̰mɪ́ɴθoʊʔ
ထမနဲ	tʰa̰ma̰nɛ́
ထမ်း	tʰáɴ
ထမ်းစင်	tʰáɴzɪ̀ɴ
ထမ်းပိုး	tʰáɴpó
ထယ်	tʰɛ̀
ထရီလီယံ	tʰəɹìlìjàɴ
ထာဝရ	tʰàwəja̰
ထာဝရဘုရား	tʰàwəɹəpʰəjá
ထာဝရဥစ္စာ	tʰàwəja̰ʔoʊʔsà
ထား	tʰá
ထားဝယ်	dəwɛ̀
ထိ	tʰḭ
ထိကပေါက်	tʰḭgəbaʊʔ
ထိန်းသိမ်း	tʰéɪɴθéɪɴ
ထိပ်	tʰeɪʔ
ထိပ်ခေါင်တင်	tʰeɪʔkʰàʊɴtɪ̀ɴ
ထိပ်စုဖုရား	tʰeɪʔsṵpʰəjá
ထိပ်ပေါက်	tʰeɪʔpaʊʔ
ထိပ်သီးညီလာခံ	tʰeɪʔθíɲìlàgàɴ
ထိမ်	tʰèɪɴ
ထိမ်းမြား	tʰéɪɴmjá
ထို	tʰò
ထိုင်	tʰàɪɴ
ထိုင်ခုံ	tʰàɪɴgòʊɴ
ထိုင်ပေ	tʰàɪɴpè
ထိုင်မသိမ်း	tʰàɪɴməθéɪɴ
ထိုင်ဝမ်	tʰàɪɴwàɴ
ထိုင်း	tʰáɪɴ
ထိုမှာ	tʰòm̥à
ထိုး	tʰó
ထိုးကွင်း	tʰógwɪ́ɴ
ထိုးမုန့်	tʰómo̰ʊɴ
ထီ	tʰì
ထီလာ	tʰìlà
ထီလာသား	tʰìlàθá
ထီး	tʰí
ထီးကြီးသုပ်	tʰídʑíθoʊʔ
ထီးတင်	tʰítɪ̀ɴ
ထီးဖြူ	tʰíbjù
ထု	tʰṵ
ထုတ်ကုန်	tʰoʊʔkòʊɴ
ထုတ်လုပ်	tʰoʊʔloʊʔ
ထုတ်လုပ်မှု	tʰoʊʔloʊʔm̥ṵ
ထုတ်ဝေသူ	tʰoʊʔwèðù
ထုံး	tʰóʊɴ
ထုံးကျောက်	tʰóʊɴdʑaʊʔ
ထုံးစံ	tʰóʊɴzàɴ
ထူ	tʰù
ထူထဲ	tʰùdɛ́
ထူပါ	tʰùpà
ထူး	tʰú
ထေရဝါဒ	tʰèja̰wàda̰
ထေရီ	tʰèjì
ထေရ်	tʰè
ထော	tʰɔ́
ထောက်	tʰaʊʔ
ထောက်ကြံ့	tʰaʊʔtɕa̰ɴ
ထောက်ခံ	tʰaʊʔkʰàɴ
ထောက်ပံ့	tʰaʊʔpa̰ɴ
ထောင့်	da̰ʊɴ
ထောင်	tʰàʊɴ
ထောင်ကဲ	tʰàʊɴkɛ́
ထောင်စုနှစ်	tʰàʊɴzṵn̥ɪʔ
ထောင်မှူး	tʰàʊɴm̥ú
ထောင်သား	tʰàʊɴðá
ထောပတ်	tʰɔ́baʔ
ထောပတ်ထမင်း	tʰɔ́baʔtʰəmɪ́ɴ
ထောပတ်သီး	tʰɔ́paʔθí
ထော်လာဂျီ	tʰɔ̀làdʑì
ထဲ	tʰɛ́
ထံ	tʰàɴ
ထွက်	tʰwɛʔ
ထွက်ကုန်	tʰwɛʔkòʊɴ
ထွက်ပေါက်	tʰwɛʔpaʊʔ
ထွက်ပြေး	tʰwɛʔpjé
ထွန်	tʰʊ̀ɴ
ထွန်ခြစ်	tʰʊ̀ɴdʑɪʔ
ထွန်စက်	tʰʊ̀ɴzɛʔ
ထွန်း	tʰʊ́ɴ
ထွေး	tʰwé
ဒ	da̰
ဒကာ	dəgà
ဒကာမ	dəgàma̰
ဒက္ခိဏ	dɛʔkʰḭna̰
ဒဂုံ	dəgòʊɴ
ဒင်္ဂါး	dɪ̀ɴgá
ဒင်္ဂါးတိုက်	dɪ̀ɴgádaɪʔ
ဒစ္စကို	dɪʔsəkò
ဒဏ္ဍာရီ	dàndàjì
ဒဏ်	dàɴ
ဒဏ်ငွေ	dàɴŋwè
ဒဏ်ရာ	dàɴjà
ဒထွေး	da̰dwé
ဒန့်သလွန်	da̰ɴðəlʊ̀ɴ
ဒန်ပူ	dəbù
ဒန်း	dáɴ
ဒပ်ဗလင်	daʔbəlɪ̀ɴ
ဒဗ္ဗလျူ	dàbba̰jù
ဒမားစကပ်	da̰másəkaʔ
ဒရာမာ	dəɹàmà
ဒလန်	dəlàɴ
ဒသဂံ	dəθəgàɴ
ဒသပါရမီ	dəθa̰pàɹəmì
ဒသမ	da̰θəma̰
ဒါ	dà
ဒါဇင်	dàzɪ̀ɴ
ဒါန	dàna̰
ဒါပါပဲ	dàbàbɛ́
ဒါပေမဲ့	dàbèmɛ̰
ဒါပော့	dàpɔ̰
ဒါမှမဟုတ်	dàm̥a̰məhoʊʔ
ဒါယကာ	dàjəkà
ဒါယိကာ	dàjəkà
ဒါလီ	dàlì
ဒိန်ခဲ	dèɪɴgɛ́
ဒိန်ချဉ်	dèɪɴdʑɪ̀ɴ
ဒိန်ချဉ်ခဲ	dèɪɴdʑɪ̀ɴgɛ́
ဒိန်းမတ်	déɪɴmaʔ
ဒိုင်ခွက်	dàɪɴgwɛʔ
ဒိုင်နိုဆော	dàɪɴnòsʰɔ́
ဒိုင်ယာနာ	dàɪɴjànà
ဒိုင်ယာရီ	dàɪɴjəɹì
ဒိုဘီ	dòbì
ဒိုဟာ	dòhà
ဒီ	dì
ဒီဂရီ	dìgəɹì
ဒီဃ	dìga̰
ဒီဇင်ဘာ	dìzɪ̀ɴbà
ဒီဇိုင်နာ	dìzàɪɴnà
ဒီဇိုင်း	dìzáɪɴ
ဒီည	dìɲa̰
ဒီနေ့	dìnḛ
ဒီပင်္ကရာ	dìpɪ̀ɴkəɹà
ဒီပင်္ကရာဘုရား	dìpɪ̀ɴkəɹàpʰəjá
ဒီပလိုမာ	dìpəlòmà
ဒီပါ	dìpà
ဒီပါဝလီ	dìpàwəlì
ဒီဗီဒီ	dìbìdì
ဒီမိုကရေစီ	dìmòkəɹèsì
ဒီမှာ	dìm̥à
ဒီလို	dìlò
ဒီဟာ	dìhà
ဒု	dṵ
ဒုက္ခ	doʊʔkʰa̰
ဒုက္ခသည်	doʊʔkʰa̰ðè
ဒုက္ခိတ	doʊʔkʰḭta̰
ဒုဂ္ဂတိ	doʊʔgədḭ
ဒုတိယ	dṵtḭja̰
ဒုတိယကမ္ဘာစစ်	dṵtḭja̰gəbàsɪʔ
ဒုတိယတပ်ကြပ်	dṵtḭja̰taʔtɕaʔ
ဒုတိယဗိုလ်	dṵtḭja̰bò
ဒုတိယဗိုလ်ချုပ်ကြီး	dṵtḭja̰bòdʑoʊʔdʑí
ဒုတိယဗိုလ်ချုပ်မှူးကြီး	dṵtḭja̰bòdʑoʊʔm̥údʑí
ဒုတိယဗိုလ်မှူးကြီး	dṵtḭja̰bòm̥údʑí
ဒုတိယအရာခံဗိုလ်	dṵtḭja̰ʔəjàgàɴbò
ဒုဗ္ဘိက္ခန္တရကပ်	doʊʔbeɪʔkʰàɴtəɹa̰kaʔ
ဒုယင်တော်	dəjɪ̀ɴdɔ̀
ဒုံမင်း	dòʊɴmɪ́ɴ
ဒုံး	dóʊɴ
ဒုံးပျံ	dóʊɴbjàɴ
ဒူရှန်ဘဲ	dùʃàɴbɛ́
ဒူလာ	dùlà
ဒူဝါ	dùwà
ဒူး	dú
ဒူးခေါင်း	dúgáʊɴ
ဒူးထောက်	dútʰaʊʔ
ဒူးရင်းယို	dújɪ́ɴjò
ဒူးရင်းသီး	dújɪ́ɴθí
ဒူးလေး	dúlé
ဒူးဝါး	dúwá
ဒေတာဘေ့စ်	dètàbḛs
ဒေဝ	dèwa̰
ဒေဝဒတ်	dèwədaʔ
ဒေဝနာဂရီ	dèwa̰nàgəɹì
ဒေဝါလီခံ	dèwàlìkʰàɴ
ဒေဝီ	dèwì
ဒေသ	dèθa̰
ဒေသန္တရ	dèθàɴtəja̰
ဒေသန္တရစကား	dèθàɴtəɹa̰zəgá
ဒေသိယစကား	dèθḭja̰zəgá
ဒေါ	dɔ́
ဒေါက်တာ	daʊʔtà
ဒေါင်း	dáʊɴ
ဒေါင်းလန်း	dáʊɴláɴ
ဒေါသ	dɔ́θa̰
ဒေါ်	dɔ̀
ဒေါ်ကြီး	dɔ̀dʑí
ဒေါ်စိန်အေး	dɔ̀sèɪɴʔé
ဒေါ်လာ	dɔ̀là
ဒေါ်လေး	dɔ̀lé
ဒံပေါက်	dàɴpaʊʔ
ဒြပ်	dɹaʔ
ဒြပ်စင်	dəɹaʔsɪ̀ɴ
ဒြပ်ထု	dəɹaʔtʰù
ဒွယံဒွယံ	dwa̰jàɴdwa̰jàɴ
ဒွါဒသမ	dwàda̰θəma̰
ဒွာရ	dwàja̰
ဒွိ	dwḭ
ဒွိလိင်	dwḭlèɪɴ
ဒွေးဘော်	dwébɔ̀
ဒဿဂီရိ	dəθa̰gìjḭ
ဒဿနဗေဒ	da̰θəna̰bèda̰
ဒဿနိကဗေဒ	da̰θənḭka̰bèda̰
ဓ	da̰
ဓနရှင်	dəna̰ʃɪ̀ɴ
ဓနိတ	dənḭta̰
ဓနု	dənṵ
ဓမ္မ	dəma̰
ဓမ္မတာ	dəmədà
ဓမ္မတာကာလ	dəmədàkàla̰
ဓမ္မတာလာ	dəmədàlà
ဓမ္မတာဝန်	dəmədàwʊ̀ɴ
ဓမ္မဒဿီ	dəma̰ma̰daʔθì
ဓမ္မဒဿီဘုရား	dəma̰dətθìpʰəjá
ဓမ္မပါလ	dàɴma̰pàla̰
ဓမ္မသတ်	dəməθaʔ
ဓလေ့	dəlḛ
ဓအောက်ခြိုက်	da̰ʔaʊʔtɕʰaɪʔ
ဓာတုဗေဒ	dàtṵbèda̰
ဓာတ်	daʔ
ဓာတ်ကြီးလေးပါး	dàttɕílépá
ဓာတ်ခဲ	daʔkʰé
ဓာတ်ခွက်	dàtkʰwɛʔ
ဓာတ်ခွဲခန်း	daʔkʰwɛ́gáɴ
ဓာတ်ငွေ့	daʔŋwḛ
ဓာတ်စက်	daʔsɛʔ
ဓာတ်ဆီ	daʔsʰì
ဓာတ်ဆီဆိုင်	daʔsʰìzàɪɴ
ဓာတ်ပုံ	daʔpòʊɴ
ဓာတ်ပြား	daʔpjà
ဓာတ်မီးခြစ်	daʔmídʑɪʔ
ဓာတ်မီးပူ	daʔmíbù
ဓာတ်မှန်	dàtm̥àɴ
ဓာတ်လှေကား	daʔl̥ègá
ဓာတ်သွား	dàtθwá
ဓာတ်အား	dàtʔá
ဓာတ်အားပေးစက်ရုံ	dàtʔábésɛʔjòʊɴ
ဓာတ်အိုး	daʔʔó
ဓား	dá
ဓားစာခံ	dəzàgàɴ
ဓားပြ	dəmja̰
ဓားပြား	dəbjá
ဓားမြှောင်	dəm̥jàʊɴ
ဓားအိမ်	dəʔèɪɴ
န	na̰
နက္ခတ္တဗေဒ	nɛʔkʰəta̰bèda̰
နက္ခတ်	nɛʔkʰaʔ
နက္ခတ်တာရာပြခန်း	nɛʔkʰaʔtàjàpja̰kʰáɴ
နက္ခတ်မျှော်စင်	nɛʔkʰaʔm̥jɔ̀zɪ̀ɴ
နက်	nɛʔ
နက်ပကျွန်း	nɛʔpətɕʊ́ɴ
နက်ဖြန်	nɛʔpʰjàɴ
နက်ဗျူလာ	nɛʔbjùlà
နကျယ်ကောင်	nədʑɛ̀gàʊɴ
နဂါး	nəgá
နဂါးကျစ်	nəgádʑɪʔ
နဂါးငွေ့တန်း	na̰gáŋwḛtáɴ
နဂါးမောက်	na̰gámaʊʔ
နဂါးမောက်သီး	na̰gámaʊʔθí
နဂါးလှည့်	nəgál̥ḭ
နငယ်	na̰ŋɛ̀
နင်	nɪ̀ɴ
နင်တို့	nɪ̀ɴdo̰
နင်း	nɪ́ɴ
နစ်	nɪʔ
နည်း	ní
နည်းနည်း	nɛ́nɛ́
နည်းနည်းချင်း	nínítɕʰɪ́ɴ
နည်းနယ	nínəja̰
နည်းပညာ	nípjɪ̀ɴɲà
နည်းလမ်း	níláɴ
နတ်	naʔ
နတ်ကွန်း	naʔkʊ́ɴ
နတ်ဆိုး	naʔsʰó
နတ်တော်	nədɔ̀
နတ်နန်း	naʔnáɴ
နတ်နိုးလ	naʔnóla̰
နတ်ပြည်ခြောက်ထပ်	naʔpjìtɕʰaʊʔtʰaʔ
နတ်ပြည်စံ	naʔpjìsàɴ
နတ်ရွာစံ	naʔjwàsàɴ
နတ်လျောင်းလ	naʔjáʊɴla̰
နတ်သုဓာ	naʔθoʊʔdà
နတ်သုဓာထမင်း	naʔθoʊʔdàtʰəmɪ́ɴ
နဒီ	nədì
နန္ဒာ	nàɴdà
နန်း	náɴ
နန်းကထိ	náɴkətʰḭ
နန်းကြီး	náɴtɕí
နန်းကြီးသုပ်	náɴtɕíθoʊʔ
နန်းတက်	náɴtɛʔ
နန်းတက်ပွဲ	náɴtɛʔbwɛ́
နန်းတော်	náɴdɔ̀
နန်းပြား	náɴbjá
နန်းပြားကြီး	náɴbjádʑí
နန်းပြားသုပ်	náɴbjáθoʊʔ
နန်းမတော်	náɴmədɔ̀
နန်းမြင့်	náɴmjɪ̰ɴ
နန်းလတ်	náɴlaʔ
နန်းသေး	náɴθé
နနွင်း	sʰənwɪ́ɴ
နပန်း	nəbáɴ
နဖူး	na̰pʰú
နဖူးစာ	nəpʰúzà
နမီးဘီးယား	na̰míbíjá
နမူနာ	nəmùnà
နမ်း	náɴ
နယ	nəja̰
နယုန်	nəjòʊɴ
နယူးဇီလန်	nəjúzìlàɴ
နယူးဒေလီ	nəjúdèlì
နယူးယောက်	nəjújaʊʔ
နယ်	nɛ̀
နယ်စပ်	nɛ̀zaʔ
နယ်ပယ်	nɛ̀pɛ̀
နယ်မြေ	nɛ̀mjè
နယ်သာလန်	nɛ̀ðəlàɴ
နရက်	nəɹɛʔ
နရန်း	nəjáɴ
နရား	nəjá
နရွဲ	nəjwɛ́
နဝ	nəwa̰
နဝကမ္မ	nəwa̰kàɴma̰
နဝဂံ	nəwəgàɴ
နဝမ	nəwəma̰
နဝရတ်	nəwəɹaʔ
နဝရူပ	na̰wa̰jùpa̰
နဟုတံ	nəhoʊʔtàɴ
နာ	nà
နာဂဒေဝ	nàga̰dèwa̰
နာဂရီ	nàgəɹì
နာဆူလ်တန်	nàsʰùltàɴ
နာဇီ	nàzì
နာဇီဝါဒ	nàzìwàda̰
နာတာလူးပွဲ	nàtàlúbwɛ́
နာနတ်	nənaʔ
နာနတ်ပွင့်	nənaʔpwɪ̰ɴ
နာနတ်သီး	nànaʔθí
နာနာ	nànà
နာနာဘာဝ	nànàbàwa̰
နာမ	nàma̰
နာမကရဏ	nàma̰kəɹəna̰
နာမကျန်း	nàmətɕáɴ
နာမကျန်းခွင့်	nàmətɕáɴkʰwɪ̰ɴ
နာမည်	nàmjì
နာမဝိသေသန	nàma̰wḭθèθəna̰
နာမ်	nàɴ
နာမ်စား	nàmzá
နာရဒ	nàɹəda̰
နာရဒဘုရား	nàɹəda̰pʰəjá
နာရီ	nàjì
နာရီဝက်	nàjìwɛʔ
နား	ná
နားကပ်	nágaʔ
နားကြပ်	nədʑaʔ
နားကွင်း	nágwɪ́ɴ
နားထင်	nətʰɪ̀ɴ
နားထောင်	nátʰàʊɴ
နားရွက်	nəjwɛʔ
နားလည်	nálɛ̀
နိကာယ	nḭkàja̰
နိခါတကဗေဒ	nḭkʰàtəka̰bèda̰
နိဂ္ဂဟိတ	neɪʔgəhḭta̰
နိစ္စ	nèsa̰
နိဒါန်း	nḭdáɴ
နိဒ္ဒေသ	neɪʔdèθa̰
နိန္နဟုတံ	nèɪɴnəhoʊʔtàɴ
နိပေါ	nḭpɔ́
နိပ်	neɪʔ
နိဗ္ဗာန်	neɪʔbàɴ
နိမိတ်	nəmeɪʔ
နိမ္မာနရတိ	nèɪɴmànəɹətḭ
နိယာမ	nḭjàma̰
နိရဗ္ဗုဒ	nḭɹaʔboʊʔda̰
နိုက်ထရိုဂျင်	naɪʔtʰəɹòdʑɪ̀ɴ
နိုင်	nàɪɴ
နိုင်ဂျာ	nàɪɴdʑà
နိုင်ဂျီးရီးယား	nàɪɴdʑíɹíjá
နိုင်ငံ	nàɪɴŋàɴ
နိုင်ငံကူးလက်မှတ်	nàɪɴŋàɴgúlɛʔm̥aʔ
နိုင်ငံခြား	nàɪɴŋàɴdʑá
နိုင်ငံခြားသား	nàɪɴgàɴdʑáðà
နိုင်ငံတော်	nàɪɴŋàɴdɔ̀
နိုင်ငံတော်တံဆိပ်	nàɪɴŋàɴdɔ̀dəzeɪʔ
နိုင်ငံတော်သီချင်း	nàɪɴŋàɴdɔ̀θətɕʰɪ́ɴ
နိုင်ငံရေး	nàɪɴŋàɴjé
နိုင်ငံရေးသမား	nàɪɴŋàɴjèðəmá
နိုင်ငံသား	nàɪɴŋàɴðá
နိုင်ငံသားအဖြစ်	nàɪɴŋàɴðáʔəpʰjɪʔ
နိုင်နိုင်	nàɪɴnàɪɴ
နိုင်လွန်	nàɪɴlʊ̀ɴ
နိုင်သူ	nàɪɴðù
နိုဝင်ဘာ	nòwɪ̀ɴbà
နို့	no̰
နို့ဆီ	no̰zì
နို့ပူတင်း	no̰pùdɪ́ɴ
နို့မှုန့်	no̰m̥o̰ʊɴ
နို့လိမ်	no̰lèɪɴ
နို့သီး	no̰ðí
နို့သီးခေါင်း	no̰ðígáʊɴ
နိုး	nó
နိဿယ	neɪʔθəja̰
နီ	nì
နီကာရာဂွါ	nìkàɹàgwà
နီတိ	nìtḭ
နီလာ	nìlà
နီး	ní
နုန်း	nóʊɴ
နုပ်	noʊʔ
နေ	nè
နေကောင်း	nèkáʊɴ
နေကောင်းရဲ့လား	nèkáʊɴjɛ̰lá
နေကြာ	nèdʑà
နေကြာဆီ	nètɕàzì
နေစကြဝဠာ	nèsɛʔtɕàwəlà
နေစာ	nèzà
နေတက်	nètɛʔ
နေထွက်	nètʰwɛʔ
နေပြည်တော်	nèpjìdɔ̀
နေရာ	nèjà
နေရာငါးသွယ်	nèjàŋáθwɛ̀
နေရာထိုင်ခင်း	nèjàtʰàɪɴgɪ́ɴ
နေရောင်	nèjàʊɴ
နေဝင်	nèwɪ̀ɴ
နေဝင်ဖျိုးဖျ	nèwɪ̀ɴpʰjóbja̰
နေအိမ်	nèʔèɪɴ
နောက်	naʊʔ
နောက်ကျ	naʊʔtɕa̰
နောက်ဆက်	naʊʔsʰɛʔ
နောက်ပြီး	naʊʔpí
နောက်ရုံး	naʊʔjóʊɴ
နောင်	nàʊɴ
နော်	nɔ̀
နော်ရထာ	nɔ̀jətʰà
နော်ဝေ	nɔ̀wè
နေ့	nḛ
နေ့ခင်း	nḛgɪ́ɴ
နေ့စဉ်	nḛzɪ̀ɴ
နေ့စဉ်မှတ်တမ်း	nḛzɪ̀ɴm̥aʔtáɴ
နေ့စွဲ	nḛzwɛ́
နေ့လည်	nḛlɛ̀
နေ့လယ်	nḛlɛ̀
နေ့လယ်စာ	nḛlɛ̀zà
နဲ့	nɛ̰
နံကထိုင်	nàɴkətʰàɪɴ
နံနက်	nàɴnɛʔ
နံနက်စာ	nàɴnɛʔsà
နံနံ	nàɴnàɴ
နံပါတ်	nàɴbaʔ
နံပြား	nàɴbjá
နံရိုး	nàɴjó
နံရံ	nàɴjàɴ
နံ့သာ	na̰ɴθà
နံ့သာပု	na̰ɴθàpṵ
နျူကလိယ	njùkəlḭja̰
နွပ်ချောက်	nʊʔtɕʰaʊʔ
နွမ်း	nʊ́ɴ
နွယ်တာ	nwɛ̀tà
နွား	nwá
နွားထီး	nətʰí
နွားနို့	nwáno̰
နွားနို့ခေါက်ဆွဲ	nwáno̰kʰaʊʔsʰwɛ́
နွားမ	nəma̰
နွေ	nwè
နွေရာသီ	nwèjàðì
နွေဦး	nwèʔú
နွေဦးပေါက်	nwèʔúbaʊʔ
နွေဦးရာသီ	nwèʔújàðì
နွေး	nwé
နွံ	nʊ̀ɴ
နွှဲ	n̥wɛ́
နှင့်	n̥ɪ̰ɴ
နှင့်တကွ	n̥ɪ̰ɴdəgwa̰
နှင်း	n̥ɪ́ɴ
နှင်းကျားသစ်	n̥ɪ́ɴtɕáθɪʔ
နှင်းခဲ	n̥ɪ́ɴgɛ́
နှင်းဆီ	n̥ɪ́ɴzì
နှင်းပွင့်	n̥ɪ́ɴbwɪ̰ɴ
နှင်းလျှောစီး	n̥ɪ́ɴʃɔ́sí
နှင်းသီး	n̥ɪ́ɴðí
နှစ်	n̥ɪʔ
နှစ်ကျိပ်ရှစ်ဆူ	n̥ɪʔtɕeɪʔʃɪʔsʰù
နှစ်ချုပ်	n̥ɪʔdʑoʊʔ
နှစ်ချောင်းပုဒ်	n̥ətɕʰáʊɴpoʊʔ
နှစ်စဉ်	n̥ɪʔzɪ̀ɴ
နှစ်ဆန်းတစ်ရက်	n̥ɪʔsʰáɴtəjɛʔ
နှစ်ဆန်းတစ်ရက်နေ့	n̥ɪʔsʰáɴtəjɛʔnḛ
နှစ်ဆယ့်တစ်	n̥ɪʔsʰɛ̰tɪʔ
နှစ်ဆယ်	n̥əsʰɛ̀
နှစ်ရာ	n̥əjà
နှစ်လ	n̥əla̰
နှပ်	n̥aʔ
နှမ	n̥əma̰
နှမ်း	n̥áɴ
နှမ်းစေ့	n̥áɴzḛ
နှမ်းဆီ	n̥áɴzì
နှလုံး	n̥əlóʊɴ
နှလုံးရောဂါ	n̥əlóʊɴjɔ́gà
နှာ	n̥à
နှာခေါင်း	n̥əkʰáʊɴ
နှာခေါင်းပေါက်	n̥əkʰáʊɴbaʊʔ
နှာဘူး	n̥àbú
နှာမောင်း	n̥əmáʊɴ
နှိပ်	n̥eɪʔ
နှိပ်ကြယ်သီး	n̥eɪʔtɕɛ̀ðí
နှုတ်	n̥oʊʔ
နှုတ်ခမ်း	n̥oʊʔkʰáɴ
နှုတ်ဆက်	n̥oʊʔsʰɛʔ
နှုတ်သီး	n̥oʊʔθí
နှူး	n̥ú
နှော	n̥ɔ́
နှောက်	n̥aʊʔ
နှောင်း	n̥áʊɴ
နှေး	n̥é
နှဲ	n̥ɛ́
နှံကောင်	n̥àɴgàʊɴ
ပ	pa̰
ပကတိ	bəgədḭ
ပကောဋိ	pəkɔ́dḭ
ပက်	pɛʔ
ပက်ကျိ	pɛʔtɕḭ
ပက်လက်	pɛʔlɛʔ
ပခုက္ကူ	pəkʰùkkù
ပခုံး	pəkʰóʊɴ
ပင့်	pɪ̰ɴ
ပင့်ကူ	pɪ̰ɴgù
ပင့်ကူအိမ်	pɪ̰ɴgùʔèɪɴ
ပင်	pɪ̀ɴ
ပင်ဂွင်	pɪ̀ɴgwɪ̀ɴ
ပင်စင်	pɪ̀ɴsɪ̀ɴ
ပင်စင်စား	pɪ̀ɴsɪ̀ɴsá
ပင်စည်	pɪ̀ɴzì
ပင်စိမ်း	pɪ̀ɴzéɪɴ
ပင်စိမ်းမွှေး	pɪ̀ɴzéɪɴm̥wé
ပင်ပေါင်	pɪ̀ɴpàʊɴ
ပင်မှည့်	pɪ̀ɴm̥ɛ̰
ပင်လယ်	pɪ̀ɴlɛ̀
ပင်လယ်ဆား	pɪ̀ɴlɛ̀zá
ပင်လယ်ဓားပြ	pɪ̀ɴlɛ̀dəmja̰
ပင်လယ်အော်	pɪ̀ɴlɛ̀ʔɔ̀
ပင်းယ	pɪ́ɴja̰
ပစောက်	pa̰zaʊʔ
ပစ္စက္ခ	pjɪʔsɛʔkʰa̰
ပစ္စည်း	pjɪʔsí
ပစ္စည်းမဲ့လူတန်းစား	pɪʔsímɛ̰lùdáɴzá
ပစ္စည်းလေးပါး	pjɪʔsílébá
ပစ္စယာ	pjɪʔsəjà
ပစ္စုပ္ပန်	pjɪʔsoʊʔpàɴ
ပစ္ဆိမ	pjɪʔsʰeɪʔma̰
ပစ်	pjɪʔ
ပဇာ	bəzà
ပဉ္စ	pjɪ̀ɴsa̰
ပဉ္စကလျာဏီ	pjɪ̀ɴsa̰kələjànì
ပဉ္စဂံ	pjɪ̀ɴsəgàɴ
ပဉ္စင်တူရိယာ	pjɪʔsɪ̀ɴtùɹḭjà
ပဉ္စင်း	bəzɪ́ɴ
ပဉ္စမ	pɪ̀ɴsəma̰
ပဉ္စရူပ	pjɪ̀ɴsa̰ɹùpa̰
ပဉ္စလက်	pɪ̀ɴsəlɛʔ
ပဉ္စသီလ	pjɪ̀ɴsa̰θìla̰
ပညတ်	pɪ̀ɴɲaʔ
ပညတ်တော်	pjɪ̰ɴnaʔtɔ̀
ပညာ	pjɪ̀ɴɲà
ပညာကျော်	pjɪ̀ɴɲàdʑɔ̀
ပညာပေး	pjɪ̀ɴɲàpé
ပညာဗလ	pjɪ̀ɴɲàbəla̰
ပညာရေး	pjɪ̀ɴɲàjé
ပညာရှင်	pjɪ̀ɴɲàʃɪ̀ɴ
ပညာသင်ဆု	pjɪ̀ɴɲàθɪ̀ɴsʰṵ
ပညာသည်	pjɪ̀ɴɲàðè
ပဋိဇီဝဆေး	pədḭzìwa̰sʰé
ပဋိပက္ခ	pətḭpɛʔkʰa̰
ပဋိပက္ခဒေသ	pədḭpɛʔkʰa̰dèθa̰
ပဋိသန္ဓေ	pədḭθàɴdè
ပဌမ	pa̰tʰa̰ma̰
ပဏ္ဍိတ	pàndḭta̰
ပဏ္ဏာ	pənà
ပတ္တမြား	bədəmjá
ပတ္တလား	paʔta̰lá
ပတ္ထနာ	pətʰənà
ပတ်	paʔ
ပတ်စပို့	paʔsəpo̰
ပတ်တီး	paʔtí
ပတ်ဝန်းကျင်	paʔwʊ́ɴtɕɪ̀ɴ
ပတ်ဝိုင်း	paʔwáɪɴ
ပထမ	pa̰tʰa̰ma̰
ပထမကမ္ဘာစစ်	pa̰tʰəma̰gəbàsɪʔ
ပထမဘွဲ့	pa̰tʰəma̰bwɛ̰
ပထဝီ	pətʰəwì
ပထဝီဝင်	pətʰəwìwɪ̀ɴ
ပထွေး	pətʰwé
ပဒ	bəda̰
ပဒုမ	pədòʊɴma̰
ပဒုမဘုရား	pədṵma̰pʰəjá
ပဒုမုတ္တရ	pədṵmoʊʔtəɹa̰
ပဒုမုတ္တရဘုရား	pədṵmoʊʔtəɹa̰pʰəjá
ပဒေသရာဇ်	bədèθəɹɪʔ
ပဒေသာ	bədèðà
ပဒေသာပင်	bədèðàbɪ̀ɴ
ပဒေသာပင်ခေတ်	bədèθàbɪ̀ɴkʰɪʔ
ပနားမား	pa̰námá
ပန်	pàɴ
ပန်ကာ	pàɴkà
ပန်တျာ	pàɴtəjà
ပန်ထွာ	pàɴtʰwà
ပန်း	páɴ
ပန်းကန်	bəgàɴ
ပန်းခုနစ်မည်	páɴkʰənəmjì
ပန်းချီ	bədʑì
ပန်းချီဆရာ	bədʑìsʰəjà
ပန်းခြောက်	páɴdʑaʊʔ
ပန်းခြံ	páɴdʑàɴ
ပန်းဂေါ်ဖီ	páɴgɔ̀bì
ပန်းစည်း	páɴzí
ပန်းဆယ်မျိုး	páɴsʰɛ̀mjó
ပန်းတဉ်း	bədɪ́ɴ
ပန်းတမော့	páɴdəmɔ̰
ပန်းတုံးတိုင်	páɴtóʊɴtàɪɴ
ပန်းတော့	páɴdɔ̰
ပန်းထိမ်	bədèɪɴ
ပန်းနာ	páɴnà
ပန်းနာရင်ကျပ်	páɴnàjɪ̀ɴtɕaʔ
ပန်းပု	bəbṵ
ပန်းပဲ	bəbɛ́
ပန်းပွတ်	bəbʊʔ
ပန်းမုန်လာ	páɴmòʊɴlà
ပန်းမုန်လာစိမ်း	páɴmòʊɴlàzéɪɴ
ပန်းမုန်လာဖြူ	páɴmòʊɴlàbjù
ပန်းယွန်း	páɴjʊ́ɴ
ပန်းရန်	bəjàɴ
ပန်းရွဲ	páɴjwɛ́
ပန်းဝတ်ရည်	páɴwʊʔjè
ပန်းသီး	páɴðí
ပန်းသေရောဂါ	páɴθèjɔ́gà
ပန်းသေး	páɴðé
ပန်းသေးခေါက်ဆွဲ	páɴθékʰaʊʔsʰwɛ́
ပန်းအိ	páɴʔḭ
ပန်းအိုး	páɴʔó
ပမာဏ	pəmàna̰
ပယောဂ	pəjɔ́ga̰
ပယ်ရှား	pɛ̀ʃá
ပရက်ဂ်	pəɹɛʔg
ပရစ်ဇမ်	pəɹɪʔzàɴ
ပရနိမ္မိတဝသဝတ္တီ	pəɹa̰nèɪɴmḭta̰wəθaʔtì
ပရဟိတ	pəɹa̰hḭta̰
ပရာ့ဂ်	pəɹa̰g
ပရိက္ခရာ	pəɹeɪʔkʰəjà
ပရိတ်	pəjeɪʔ
ပရိဒေဝ	pəɹḭdèwa̰
ပရိဘောဂ	pəɹḭbɔ́ga̰
ပရိယာယ်	pəɹḭjè
ပရိသတ်	pəjeɪʔθaʔ
ပရိုဂရမ်	pəɹògəɹàɴ
ပရိုဂျက်	pəɹòdʑɛʔ
ပရိုင်းမိတ်	pəɹáɪɴmeɪʔ
ပရီတိုရီးယား	pəɹìtòɹíjá
ပရုတ်	pəjoʊʔ
ပလက်ဖောင်း	pəlɛʔpʰáʊɴ
ပလတ်	pəlaʔ
ပလတ်စတစ်	pəlaʔsətɪʔ
ပလပ်ကြွတ်	pa̰laʔtɕʊʔ
ပလပ်စတစ်	pəlaʔsətɪʔ
ပလာတာ	pəlàtà
ပလိပ်	pəleɪʔ
ပလူတိုနီယမ်	pəlùtònìjàɴ
ပလောင်	pəlàʊɴ
ပလ္လင်	pəlɪ̀ɴ
ပလွေ	pa̰lwè
ပဝရ	pəwəɹa̰
ပဝါ	pa̰wà
ပဝေဏီ	pəwènì
ပသီ	pəθì
ပသျှူး	pəʃú
ပသျှူးရာမ	pəʃújàma̰
ပဟိုရ်	bəhò
ပဟေဠိ	pəhèlḭ
ပအိုဝ်း	pəʔów
ပအို့ဝ်	pəʔów
ပါ	pà
ပါကစ္စတန်	pàkɪʔsətàɴ
ပါဆယ်	pàsʰɛ̀
ပါတာနီ	pàtànì
ပါတိတ်	pàteɪʔ
ပါတီ	pàtì
ပါဒ်	paʔ
ပါပူအာနယူးဂီနီ	pàpùʔànəjúgìnì
ပါမောက္ခ	pàmaʊʔkʰa̰
ပါရဂူ	pàɹəgù
ပါရဂူဘွဲ့	pàjəgùbwɛ̰
ပါရမီ	pàɹəmì
ပါရရာ	pàɹəjà
ပါရာဂွေး	pàɹàgwé
ပါရီ	pàɹì
ပါရုပန	pàɹṵpəna̰
ပါရှား	pàʃá
ပါလက်စတိုင်း	pàlɛʔsətáɪɴ
ပါလီမန်	pàlìmàɴ
ပါဝါ	pàwà
ပါဠိ	pàlḭ
ပါး	pá
ပါးစပ်	pəzaʔ
ပါးဟက်	pəhɛʔ
ပိ	pḭ
ပိစပ်	bḭzaʔ
ပိဋကတ်	bḭtəgaʔ
ပိဋကတ်တိုက်	bḭdəgaʔdaɪʔ
ပိတောက်	bədaʊʔ
ပိတ်	peɪʔ
ပိန္နဲ	péɪɴnɛ́
ပိန်းဥ	péɪɴʔṵ
ပိန်းဥမုန့်	péɪɴʔṵmo̰ʊɴ
ပိမ့်	pḛɪɴ
ပိရမစ်	pḭɹəmɪʔ
ပို	pò
ပိုက်	paɪʔ
ပိုက်ကွက်	paɪʔkwɛʔ
ပိုက်ဆံ	paɪʔsʰàɴ
ပိုက်ဆံအိတ်	paɪʔsʰàɴʔeɪʔ
ပိုက်သမား	paɪʔθəmá
ပိုင်ရှင်	pàɪɴʃɪ̀ɴ
ပိုင်း	páɪɴ
ပိုစတာ	pòsətà
ပိုစွန်း	pòzʊ́ɴ
ပိုတက်ဆီယမ်	pòtɛʔsʰìjàɴ
ပိုဒ်	paɪʔ
ပိုလန်	pòlàɴ
ပိုလီနီးရှား	pòlìníʃá
ပို့	po̰
ပို့စကတ်	po̰səkaʔ
ပိုး	pó
ပိုးကြာချည်	pótɕàtɕʰì
ပိုးတောင်မာ	pódàʊɴmà
ပိုးနဂါး	pónəgá
ပိုးလောင်း	póláʊɴ
ပိုးဟပ်	póhaʔ
ပိုးဟပ်ဖြူ	póhaʔpʰjù
ပိဿာ	peɪʔθà
ပီ	pì
ပီကင်း	pìkɪ́ɴ
ပီကေ	pìkè
ပီစီ	pìsì
ပီဇာ	pìzà
ပီတိ	pìtḭ
ပီနန်သီး	pìnàɴθí
ပီပီ	pìbì
ပီယဒဿီ	pìja̰daʔθì
ပီယဒဿီဘုရား	pìja̰daʔθìpʰəjá
ပီရူး	pìɹú
ပီလောပီနံ	pìlɔ́pìnàɴ
ပု	pṵ
ပုခက်	pəkʰɛʔ
ပုဂံ	bəgàɴ
ပုဂ္ဂလိက	poʊʔgəlḭga̰
ပုဂ္ဂိုလ်	poʊʔgò
ပုစဉ်း	bəzɪ́ɴ
ပုစ္ဆာ	poʊʔsʰà
ပုစွန်	bəzʊ̀ɴ
ပုစွန်တာရာ	bəzʊ̀ɴtàjà
ပုဆိန်	pəsʰèɪɴ
ပုဆိုး	pəsʰó
ပုည	pòʊɴɲa̰
ပုဏ္ဍရိက	pòʊɴda̰ɹḭka̰
ပုဏ္ဏ	pòʊɴna̰
ပုဏ္ဏမန္တာနီပုတ္တ	pòʊɴna̰màɴtànìpoʊʔta̰
ပုဏ္ဏမာ	pòʊɴnəmà
ပုဏ္ဏား	pòʊɴná
ပုဏ္ဏားကျွန်း	pòʊɴnádʑʊ́ɴ
ပုတို	bṵdò
ပုတ်သင်ညို	poʊʔθɪ̀ɴɲò
ပုထိုး	pətʰó
ပုထုဇဉ်	pṵtʰṵzɪ̀ɴ
ပုဒ်	poʊʔ
ပုဒ်ကလေး	poʊʔkəlé
ပုဒ်ကြီး	poʊʔdʑí
ပုဒ်ထီး	poʊʔkəlé
ပုဒ်ဖြတ်	poʊʔpʰjaʔ
ပုဒ်မ	poʊʔma̰
ပုန်ကန်	pòʊɴkàɴ
ပုန်း	póʊɴ
ပုန်းရည်ကြီး	póʊɴjèdʑí
ပုပ်	poʊʔ
ပုဗ္ဗ	poʊʔba̰
ပုရစ်	pəjɪʔ
ပုရပိုက်	pəɹəbaɪʔ
ပုရွက်	pəjwɛʔ
ပုရွက်ဆိတ်	pəjwɛʔsʰeɪʔ
ပုလင်း	pəlɪ́ɴ
ပုလိပ်	pəleɪʔ
ပုလဲ	pəlɛ́
ပုသိမ်	pəθèɪɴ
ပုံ	pòʊɴ
ပုံစံ	pòʊɴzàɴ
ပုံဆောင်ခဲ	pòʊɴzàʊɴgɛ́
ပုံဆွဲ	pòʊɴsʰwɛ́
ပုံတူ	pòʊɴdù
ပုံတူကား	pòʊɴdùká
ပုံနှိပ်	pòʊɴn̥eɪʔ
ပုံနှိပ်စက်	pòʊɴn̥eɪʔsɛʔ
ပုံသေနည်း	pòʊɴðèní
ပုံး	póʊɴ
ပူ	pù
ပူဇော်	pùzɔ̀
ပူတင်း	pùtɪ́ɴ
ပူတာအို	pùtàʔò
ပူတူးမုန့်	pùtúmo̰ʊɴ
ပူဒီနာ	pùsìnà
ပူဖောင်း	bùbáʊɴ
ပူရ	pùɹa̰
ပူရီ	pùɹì
ပူရှိမ်းဆီ	pùʃéɪɴzì
ပူး	pú
ပေကျင်း	pètɕɪ́ɴ
ပေစာ	pèsà
ပေယျာလ	pèjàla̰
ပေါက်	paʊʔ
ပေါက်ကရ	paʊʔkəja̰
ပေါက်ကွဲ	paʊʔkwɛ́
ပေါက်ကွဲမှု	paʊʔkwɛ́m̥ṵ
ပေါက်စီ	paʊʔsì
ပေါက်တူး	paʊʔtú
ပေါက်ဖော်	paʊʔpʰɔ̀
ပေါင်	pàʊɴ
ပေါင်ဒါ	pàʊɴdà
ပေါင်မုန့်	pàʊɴmo̰ʊɴ
ပေါင်မုန့်ပူတင်း	pàʊɴmo̰ʊɴpùtɪ́ɴ
ပေါင်မုန့်ဖုတ်သူ	pàʊɴmo̰ʊɴpʰoʊʔθù
ပေါင်း	páʊɴ
ပေါင်းတင်း	páʊɴdɪ́ɴ
ပေါင်းဖို	páʊɴbò
ပေါ့	pɔ̰
ပေါ့ဒ်ဂိုရစ်ဆာ	pɔ̰dgòɹɪʔsʰà
ပေါ်	bɔ̀
ပေါ်	pɔ̀
ပေါ်ဆန်းမွှေး	pɔ̀sʰáɴm̥wé
ပေါ်တူဂီ	pɔ̀tùgì
ပေါ်လစီ	pɔ̀ləsì
ပေး	pé
ပဲ	bɛ́
ပဲ	pɛ́
ပဲကတ္တီပါ	pɛ́gədìpà
ပဲကျပ်ပျဉ်	pɛ́tɕaʔpjɪ̀ɴ
ပဲကျား	pɛ́dʑá
ပဲကြာဆံ	pɛ́tɕàzàɴ
ပဲကြီး	pɛ́dʑí
ပဲခူး	bəgó
ပဲခြမ်း	pɛ́dʑáɴ
ပဲငံပြာရည်	pɛ́ŋàɴbjàjè
ပဲစင်းငုံ	pɛ́zɪ́ɴŋòʊɴ
ပဲစား	pɛ́sá
ပဲစိမ်းစား	pɛ́séɪɴsá
ပဲစိမ်းစားဥ	pɛ́zéɪɴzáʔṵ
ပဲစောင်းလျား	pɛ́záʊɴjá
ပဲစေ့	pɛ́sḛ
ပဲဆန်	pɛ́zàɴ
ပဲဆီ	pɛ́zì
ပဲတီ	pɛ́dì
ပဲတောင့်ပြုတ်	pɛ́da̰ʊɴbjoʊʔ
ပဲတောင့်ရှည်	pɛ́da̰ʊɴʃì
ပဲထောပတ်	pɛ́tʰɔ́baʔ
ပဲဒလက်	pɛ́dəlɛʔ
ပဲနပြား	pɛ́nəbjá
ပဲနီကလေး	pɛ́nìgəlé
ပဲနောက်	pɛ́naʊʔ
ပဲနံ့သာ	pɛ́na̰ɴθà
ပဲပင်ပေါက်	pɛ́bɪ̀ɴbaʊʔ
ပဲပိစပ်	pɛ́bḭzaʔ
ပဲပိုးတီ	pɛ́pódì
ပဲပုစွန်	pəpəzʊ́ɴ
ပဲပုပ်	pɛ́boʊʔ
ပဲပေါင်းဆီ	pɛ́báʊɴzì
ပဲမှုန့်	pɛ́m̥o̰ʊɴ
ပဲယဉ်း	pɛ́jɪ́ɴ
ပဲရာဇာ	pɛ́jàzà
ပဲလင်းမြွေ	pɛ́lɪ́ɴmjwè
ပဲလေးညှင်း	pɛ́nìgəlé
ပဲလွမ်း	pɛ́lʊ́ɴ
ပဲသီတာ	pɛ́θìdà
ပဲ့တင်သံ	pɛ̰tɪ̀ɴðàɴ
ပျက်စီး	pjɛʔsí
ပျင်း	pjɪ́ɴ
ပျစ်	pjɪʔ
ပျဉ်	pjɪ̀ɴ
ပျဉ်းကတိုး	pjɪ́ɴgədó
ပျဉ်းတော်သိမ်	pjɪ́ɴdɔ̀θèɪɴ
ပျဉ်းမ	pjɪ́ɴma̰
ပျဉ်းမနား	pjɪ́ɴma̰ná
ပျပျ	pja̰bja̰
ပျား	pjá
ပျားတူ	ba̰dù
ပျားထီး	pjádí
ပျားရည်	pjájè
ပျားရည်ဆမ်း	pjájìsʰáɴ
ပျားအုံ	pjáʔòʊɴ
ပျိုး	pjó
ပျူ	pjù
ပျောက်	pjaʊʔ
ပျော့	pjɔ̰
ပျော်	pjɔ̀
ပျော်ပျော်	pjɔ̀bjɔ̀
ပျံ	pjàɴ
ပျံကျ	bjàɴdʑa̰
ပျံတော်မူ	pjàɴtɔ̀mù
ပြ	pja̰
ပြက္ခဒိန်	pjɛʔgədèɪɴ
ပြချက်	pja̰dʑɛʔ
ပြင်	pjɪ̀ɴ
ပြင်ပြင်	pjɪ̀ɴbjɪ̀ɴ
ပြင်သစ်	pjɪ̀ɴθɪʔ
ပြင်သစ်တော်လှန်ရေး	pjɪ̀ɴθɪʔtɔ̀l̥àɴjé
ပြင်သည်	pjɪ̀ɴθì
ပြင်း	pjɪ́ɴ
ပြင်းဟုပ်	pjɪ́ɴhoʊʔ
ပြစ်မှု	pjɪʔm̥ṵ
ပြဇာတ်	pja̰zàt
ပြည့်တန်ဆာ	pjḭdəzà
ပြည်	pjì
ပြည်ကြီး	pjìdʑí
ပြည်ကြီးငါး	pjìdʑíŋá
ပြည်ကြီးမွန်	pjìdʑímʊ̀ɴ
ပြည်တွင်း	pjìdwɪ́ɴ
ပြည်တွင်းစစ်	pjìdwɪ́ɴsɪʔ
ပြည်ထောင်စု	pjìdàʊɴzṵ
ပြည်ထောင်စုတော်လှန်ရေးကောင်စီအဖွဲ့	pjìdàʊɴzṵtɔ̀l̥àɴjékàʊɴsìʔəpʰwɛ̰
ပြည်ထောင်စုနေ့	pjìdàʊɴzṵnḛ
ပြည်ထောင်စုလွှတ်တော်	pjìdàʊɴzṵl̥ʊʔtɔ̀
ပြည်နယ်	pjìnɛ̀
ပြည်သူ	pjìðù
ပြည်သူပိုင်	pjìðùbàɪɴ
ပြည်သူပိုင်သိမ်း	pjìðùbàɪɴðéɪɴ
ပြည်သူပြည်သား	pjìðùpjìðá
ပြည်သူ့	pjìðṵ
ပြည်သူ့ကျန်းမာရေး	pjìθṵtɕáɴmàjé
ပြည်သူ့ဆိုင်	pjìðṵsʰàɪɴ
ပြည်သူ့လွှတ်တော်	pjìðṵl̥ʊʔtɔ̀
ပြဌာန်း	pja̰tʰáɴ
ပြတင်းပေါက်	bədɪ́ɴbaʊʔ
ပြတိုက်	pja̰daɪʔ
ပြဒါး	bədá
ပြဒါးချိန်	bədádʑèɪɴ
ပြန့်	pja̰ɴ
ပြန်	pjàɴ
ပြန်ကြား	pjàɴtɕá
ပြန်ကြားရေး	pjàɴtɕájé
ပြန်လှန်	pjàɴl̥àɴ
ပြပွဲ	pja̰bwɛ́
ပြယုဂ်	pja̰joʊʔ
ပြသ	pja̰θa̰
ပြာ	pjà
ပြာခွက်	pjàgwɛʔ
ပြာဋိဟာ	pjàdḭhà
ပြာတာ	pjàtà
ပြာသာဒ်	pjaʔθaʔ
ပြာသို	pjàðò
ပြား	pjá
ပြိတ္တာ	pjeɪʔtà
ပြို	pjò
ပြိုင်	pjàɪɴ
ပြိုင်ပွဲ	pjàɪɴbwé
ပြိဿ	pjeɪʔθa̰
ပြီ	pjì
ပြီး	pí
ပြီးဆုံး	pjísʰóʊɴ
ပြီးတော့	pídɔ̰
ပြီးပြီ	píbì
ပြု	pjṵ
ပြုတ်	pjoʊʔ
ပြုတ်တူ	pjoʊʔtù
ပြုပြင်	pjṵbjɪ̀ɴ
ပြုမူ	pjṵmù
ပြုံယမ်း	pjòʊɴjáɴ
ပြုံး	pjóʊɴ
ပြေ	pjè
ပြော	pjɔ́
ပြောက်ကျား	pjaʊʔtɕá
ပြောက်ကျားစစ်	pjaʊʔtɕásɪʔ
ပြောင်	pjàʊɴ
ပြောင်း	pjáʊɴ
ပြောင်းဖူး	pjáʊɴbú
ပြောင်းလဲ	pjáʊɴlɛ́
ပြေး	pjé
ပြွတ်	pjʊʔ
ပြွန်	pjʊ̀ɴ
ပြွမ်း	pjʊ́ɴ
ပြဿဒါး	pjaʔðədá
ပြဿနာ	pjaʔθənà
ပွင့်ချပ်	pwɪ̰ɴdʑaʔ
ပွတ်	pʊʔ
ပွား	pwá
ပွိုင့်	pwa̰ɪɴ
ပွေး	pwé
ပွဲ	pwɛ́
ပွဲတော်	pwɛ́dɔ̀
ပွဲတော်တည်	pwɛ́dɔ̀tì
ဖ	pʰa̰
ဖက်	pʰɛʔ
ဖက်ဆစ်	pʰɛʔsʰɪʔ
ဖက်ဆစ်ဝါဒ	pʰɛʔsʰɪʔwàda̰
ဖက်ထုပ်	pʰɛʔtʰoʊʔ
ဖက်ဒရယ်	pʰɛʔdəɹɛ̀
ဖက်ဖယ်	pʰɛʔpʰɛ̀
ဖက်ရှင်	pʰɛʔʃɪ̀ɴ
ဖက်ဝန်း	pʰɛʔwʊ́ɴ
ဖခင်	pʰa̰gɪ̀ɴ
ဖငယ်	pʰa̰ŋɛ̀
ဖင်	pʰɪ̀ɴ
ဖင်လန်	pʰɪ̀ɴlàɴ
ဖင်လျက်	pʰɪ̀ɴjɛʔ
ဖတ်	pʰaʔ
ဖတ်စာ	pʰaʔsà
ဖတ်တီး	pʰaʔtí
ဖန်ခါး	pʰàɴgá
ဖန်ခါးသီး	pʰàɴgáðí
ဖန်တီး	pʰàɴdí
ဖန်တူလုံး	pʰàɴtùlóʊɴ
ဖနွမ်ဖင်	pʰənʊ̀ɴpʰɪ̀ɴ
ဖမ်း	pʰáɴ
ဖမ်းဆီး	pʰáɴsʰí
ဖယောင်း	pʰəjáʊɴ
ဖယောင်းတိုင်	pʰəjáʊɴdàɪɴ
ဖယ်ဒရယ်	pʰɛ̀dəɹɛ̀
ဖယ်ဒရေးရှင်း	pʰɛ̀dəɹéʃɪ́ɴ
ဖရန့်	pʰəɹa̰ɴ
ဖရု	pʰa̰jṵ
ဖရုသဝါစာ	pʰəɹṵθa̰wàsà
ဖရုံ	pʰəjòʊɴ
ဖရုံဆွဲ	pʰəjòʊɴzwɛ́
ဖရဲ	pʰəjɛ́
ဖလား	pʰəlá
ဖဝါး	pʰəwá
ဖဦးထုပ်	pʰa̰ʔútʰoʊʔ
ဖာ	pʰà
ဖာခေါင်း	pʰàgáʊɴ
ဖာမ	pʰàma̰
ဖာလာ	pʰàlà
ဖာလာစေ့	pʰàlàsḛ
ဖာလူဒါ	pʰàlùdà
ဖာသည်မ	pʰàθɛ̀ma̰
ဖား	pʰá
ဖားပြုပ်	pʰəbjoʊʔ
ဖားလောင်း	pʰəláʊɴ
ဖိတ်	pʰeɪʔ
ဖိနပ်	pʰənaʔ
ဖိနပ်ချွတ်	pʰənaʔtɕʰʊʔ
ဖိလစ်ပိုင်	pʰḭlɪʔpàɪɴ
ဖိအား	pʰḭʔá
ဖို	pʰò
ဖိုင်	pʰàɪɴ
ဖိုတိုစတက်	pʰòtòsətɛʔ
ဖို့	pʰo̰
ဖိုး	pʰó
ဖိုးသူတော်	pʰóθùdɔ̀
ဖီဂျီ	pʰìdʑì
ဖီးကြမ်း	pʰídʑáɴ
ဖုတ်	pʰoʊʔ
ဖုန်	pʰòʊɴ
ဖုန်စုပ်စက်	pʰòʊɴsoʊʔsɛʔ
ဖုန်း	pʰóʊɴ
ဖုန်းနံပါတ်	pʰóʊɴnàɴbaʔ
ဖုံ	pʰòʊɴ
ဖုံး	pʰóʊɴ
ဖုဿ	pʰoʊʔθa̰
ဖုဿဘုရား	pʰoʊʔθa̰pʰəjá
ဖူး	bú
ဖူးစာ	pʰúzà
ဖေဖော်ဝါရီ	pʰèpʰɔ̀wàɹì
ဖေါဋ္ဌဗ္ဗာရုံ	pʰaʊʔtʰaʔbàjòʊɴ
ဖေါ်ပြချက်	pʰɔ̀pja̰tɕʰɛʔ
ဖောက်	pʰaʊʔ
ဖောက်သည်	pʰaʊʔθɛ̀
ဖောင်	pʰàʊɴ
ဖော့ဖျက်	pʰɔ̰bjɛʔ
ဖော့လုံး	pʰɔ̰lóʊɴ
ဖော်	pʰɔ̀
ဖော်ပြ	pʰɔ̀pja̰
ဖော်လံဖား	pʰɔ̀làɴpʰá
ဖဲ	pʰɛ́
ဖဲကြိုး	pʰɛ́dʑó
ဖျက်ဆီး	pʰjɛʔsʰí
ဖျင်ဖျင်	pʰjɪ̀ɴbjɪ̀ɴ
ဖျာ	pʰjà
ဖျား	pʰjá
ဖျောက်ဆိပ်	pʰjaʊʔsʰeɪʔ
ဖျော်ဖြေ	pʰjɔ̀bjè
ဖျော်ဖြေပွဲ	pʰjɔ̀bjèbwɛ́
ဖျံ	pʰjàɴ
ဖြင့်	pʰjɪ̰ɴ
ဖြစ်	pʰjɪʔ
ဖြည့်	pʰjḛ
ဖြည်းဖြည်း	pʰjébjé
ဖြည်းဖြည်းချင်း	pʰjípʰjítɕʰɪ́ɴ
ဖြတ်	pʰjaʔ
ဖြတ်ပိုင်း	pʰjaʔpáɪɴ
ဖြားယောင်း	pʰjájáʊɴ
ဖြို	pʰjò
ဖြီး	pʰí
ဖြူ	pʰjù
ဖြူး	pʰjú
ဖြေ	pʰjè
ဖြေဖျောက်	pʰjèbjaʊʔ
ဖြေရှင်း	pʰjèʃɪ́ɴ
ဖြောင့်	pʰja̰ʊɴ
ဖြောဖြော	pʰjɔ́bjɔ́
ဖြော်ဖြော်	pʰjɔ̀bjɔ̀
ဖွင့်	pʰwɪ̰ɴ
ဖွတ်	pʰʊʔ
ဖွပ်	pʰʊʔ
ဖွား	pʰwá
ဖွားစော	pʰwásɔ́
ဖွဲ့စည်းပုံ	pʰwɛ̰zíbòʊɴ
ဖွဲ့စည်းပုံအခြေခံဥပဒေ	pʰwɛ̰zíbòʊɴʔətɕʰègàɴʔṵbədè
ဗ	ba̰
ဗက်တီးရီးယား	bɛʔtíɹíjá
ဗင်နီဇွဲလား	bɪ̀ɴnìzwɛ́lá
ဗညား	bəɲá
ဗထက်ခြိုက်	ba̰tʰɛʔtɕʰaɪʔ
ဗန်တို	bàɴdò
ဗန်ရှည်	bàɴʃè
ဗန်းမော်	báɴmɔ̀
ဗမာ	bəmà
ဗမာ့	bəma̰
ဗလ	bəla̰
ဗလဝ	bələwa̰
ဗလာစာအုပ်	bəlàsàʔoʊʔ
ဗလီ	bəlì
ဗဟို	bəhò
ဗဟုဝုစ်	bəhṵwoʊʔ
ဗဟုသုတ	bəhṵθṵta̰
ဗာတီကန်	bàtìkàɴ
ဗာတီကန်မြို့ပြနိုင်ငံ	bàtìkàɴmjo̰pja̰nàɪɴŋàɴ
ဗာဒံ	bàdàɴ
ဗာလ	bàla̰
ဗာလချောင်	bàla̰tɕʰàʊɴ
ဗားနစ်	bánɪʔ
ဗိန္ဒု	bèɪɴdṵ
ဗိမာန်	beɪʔmàɴ
ဗိသုကာ	bḭðəgà
ဗိုက်	baɪʔ
ဗိုက်ကြီး	baɪʔtɕí
ဗိုက်ဆာတယ်	baɪʔsʰàtɛ̀
ဗိုင်း	báɪɴ
ဗိုင်းရပ်စ်	báɪɴɹaʔs
ဗိုလ်	bò
ဗိုလ်ကိတ်ပဲ	bòkeɪʔbɛ́
ဗိုလ်ကျ	bòtɕa̰
ဗိုလ်ကြီး	bòdʑí
ဗိုလ်ချုပ်	bòdʑoʊʔ
ဗိုလ်ချုပ်ကြီး	bòdʑoʊʔdʑí
ဗိုလ်ချုပ်မှူးကြီး	bòdʑoʊʔm̥údʑí
ဗိုလ်ခြေ	bòdʑè
ဗိုလ်စားပဲ	bòzábɛ́
ဗိုလ်မှူး	bòm̥ú
ဗိုလ်မှူးကြီး	bòm̥údʑí
ဗိုလ်မှူးချုပ်	bòm̥údʑoʊʔ
ဗိုလ်လုပွဲ	bòllṵpwɛ́
ဗိုလ်လောင်း	bòláʊɴ
ဗို့	bo̰
ဗို့အား	bo̰ʔá
ဗိဿနိုး	beɪʔθənó
ဗီဇ	bìza̰
ဗီဇနာ	bìzənà
ဗီဇာ	bìzà
ဗီတာမင်	bìtàmɪ̀ɴ
ဗီဒီယို	bìdìjò
ဗီယက်နမ်	bìjɛʔnàɴ
ဗီယင်ကျန်း	bìjɪ̀ɴtɕáɴ
ဗီယင်နာ	bìjɪ̀ɴnà
ဗီရို	bìjò
ဗုဒ္ဓ	boʊʔda̰
ဗုဒ္ဓဘာသာ	boʊʔda̰bàðà
ဗုဒ္ဓဝါဒီ	boʊʔda̰wàdì
ဗုဒ္ဓသာသနာ	boʊʔda̰θàðənà
ဗုဒ္ဓဟူး	boʊʔda̰hú
ဗုဒ္ဓဟူးဂြိုဟ်	boʊʔdəhúdʑò
ဗုန်း	bóʊɴ
ဗုံ	bòʊɴ
ဗုံး	bóʊɴ
ဗုံးကြဲလေယာဉ်	bóʊɴtɕɛ́lèjɪ̀ɴ
ဗူးခရက်	búkʰa̰ɹɛʔ
ဗူးဒပက်	búda̰pɛʔ
ဗေဒ	bèda̰
ဗေဒင်	bèdɪ̀ɴ
ဗေဒင်ဆရာ	bèdɪ̀ɴsʰəjà
ဗောဓိညောင်	bɔ́dḭɲàʊɴ
ဗောဓိသတ်	bɔ́dḭθaʔ
ဗော့ဒ်ကာ	bɔ̰dkà
ဗေ့စဘော	bḛsəbɔ́
ဗျစ်	bjɪʔ
ဗျည်း	bjí
ဗျာဓိ	bjàdḭ
ဗျာပါဆံ	bjàpàsʰàɴ
ဗျိုင်း	bjáɪɴ
ဗျိုင်းတာရာ	bjáɪɴtàjà
ဗျုပ္ပတ်	bjoʊʔpaʔ
ဗျူရို	bjùɹò
ဗျူရိုကရေစီ	bjùɹòkəɹèsì
ဗျူဟာ	bjùhà
ဗြဟ္မစိုရ်တရား	bjəməzòjtəjá
ဗြဟ္မာ	bjəmà
ဗြဟ္မာပုတ္တ	bjàhmàpoʊʔta̰
ဗြာဟ္မဏ	bjàhma̰na̰
ဗြိစ္ဆာ	bjeɪʔsʰà
ဗြိတိန်	bjḭtèɪɴ
ဗြိတိသျှ	bəɹḭtḭʃa̰
ဗြဲတိုက်	bjɛ́daɪʔ
ဗွီ	bwì
ဗွေ	bwè
ဘ	ba̰
ဘကကျောင်း	ba̰ka̰tɕáʊɴ
ဘကုန်း	ba̰kóʊɴ
ဘက္ကဒီးအစ်	bɛʔkədíʔɪʔ
ဘက်	bɛʔ
ဘက်ထရီ	bɛʔtʰa̰ɹì
ဘကြီး	ba̰dʑí
ဘဂ္ဂဒက်	bàggədɛʔ
ဘင်	bɪ̀ɴ
ဘင်နာ	bɪ̀ɴnà
ဘင်း	bɪ́ɴ
ဘင်္ဂလားဒေ့ရှ်	bɪ̀ɴládḛʃ
ဘင်္ဂါလီ	bɪ̀ɴgàlì
ဘဏ္ဍာ	bàndà
ဘဏ္ဍာနှစ်	bàɴdàn̥ɪʔ
ဘဏ္ဍာရေး	bàndàjé
ဘဏ်	bàɴ
ဘဏ်တိုက်	bàɴdaɪʔ
ဘတ်	baʔ
ဘတ်	pʰaʔ
ဘတ်ဂျက်	baʔdʑɛʔ
ဘတ်စ်ကား	baʔsəká
ဘတ်သီး	baʔθí
ဘထွေး	ba̰tʰwé
ဘဒ္ဒန္တ	baʔdàɴta̰
ဘန့်ပွေး	ba̰ɴbwé
ဘန်ကောက်	bàɴkaʊʔ
ဘန်ပါ	bàɴbà
ဘန်း	báɴ
ဘမ်းပရုတ်ဆီ	báɴpəjoʊʔsʰì
ဘယက်	bəjɛʔ
ဘယာ	bəjà
ဘယ်	bɛ̀
ဘယ်တုန်းက	bɛ̀dóʊɴga̰
ဘယ်တော့	bɛ̀dɔ̰
ဘယ်တော့မှ	bɛ̀dəma̰
ဘယ်နှ	bɛ̀n̥a̰
ဘယ်နှစ်	bɛ̀n̥ə
ဘယ်မှ	bɛ̀m̥a̰
ဘယ်ရီလီယမ်	bɛ̀ɹìlìjàɴ
ဘယ်လို	bɛ̀lò
ဘယ်လောက်	bɛ̀laʊʔ
ဘယ်လ်ဂျီယမ်	bɛ̀ldʑìjàɴ
ဘယ်သူ	bəθù
ဘယ်သူ့	bəθṵ
ဘရင်ဂျီ	bəjɪ̀ɴdʑì
ဘရဏီ	ba̰jənì
ဘရပ်ဆဲလ်	bəɹaʔsʰɛ́l
ဘရာစီယာ	bəɹàsìjà
ဘရာဇီး	bəɹàzí
ဘရာတစ်လာဗာ	bəɹàtɪʔlàbà
ဘရိတ်	bəɹeɪʔ
ဘရူနိုင်း	bəɹùnáɪɴ
ဘလိဇ်	bəlìz
ဘလောက်	ba̰laʊʔ
ဘလော့ဂ်	bəloʊʔ
ဘလေး	ba̰lé
ဘဝ	bəwa̰
ဘဝရှင်	bəwa̰ʃɪ̀ɴ
ဘဝဲ	bəwɛ́
ဘဟားမား	ba̰hámá
ဘာ	bà
ဘာကီးနားဖားဆို	bàkínápʰásʰò
ဘာရိန်း	bàɹéɪɴ
ဘာလင်	bàlɪ̀ɴ
ဘာလိ	bàlḭ
ဘာသန္တရ	bàðàɴdəɹa̰
ဘာသာ	bàðà
ဘာသာခြား	bàðàdʑá
ဘာသာစကား	bàθàzəgá
ဘာသာပြန်	bàðàpjàɴ
ဘာသာဗေဒ	bàθàbèda̰
ဘား	bá
ဘား	pʰá
ဘိက္ခု	beɪʔkʰṵ
ဘိက္ခုနီ	bìkkʰṵnì
ဘိန်း	béɪɴ
ဘိန်းစစ်ပွဲ	béɪɴsɪʔpwɛ́
ဘိန်းစား	béɪɴzá
ဘိန်းမုန့်	béɪɴmo̰ʊɴ
ဘိဘိသန	bḭbḭθəna̰
ဘိလပ်	bḭlaʔ
ဘိလပ်မြေ	bḭlaʔmjè
ဘိလပ်ရည်	bḭlaʔjè
ဘိသိက်	beɪʔθeɪʔ
ဘိုကလေး	bògəlé
ဘိုက်	baɪʔ
ဘိုင်စကယ်	bàɪɴsəkɛ̀
ဘိုင်စကုတ်	bàɪɴsəkoʊʔ
ဘိုရွန်	bòɹʊ̀ɴ
ဘိုလီးဗီးယား	bòlíbíjá
ဘိုး	bó
ဘိုးဘိုး	pʰópʰó
ဘီ	bì
ဘီစကွတ်	bìsəkʊʔ
ဘီဒီ	bìdì
ဘီနင်	bìnɪ̀ɴ
ဘီယာ	bìjà
ဘီရှကက်	bìʃəkɛʔ
ဘီလာရုဇ်	bìlàɹùz
ဘီလီယံ	bìlìjàɴ
ဘီလူး	bəlú
ဘီး	béɪɴ
ဘီး	bí
ဘီးကြယ်	bítɕɛ̀
ဘု	bṵ
ဘုဉ်းပေး	bóʊɴpé
ဘုတ်	boʊʔ
ဘုန်း	pʰóʊɴ
ဘုန်းကြီး	pʰóʊɴdʑí
ဘုန်းကြီးကျောင်း	pʰóʊɴdʑítɕáʊɴ
ဘုန်းကြီးပျံ	pʰóʊɴdʑíbjàɴ
ဘုန်းတော်ကြီးဘုရား	pʰóʊɴdɔ̀dʑípʰəjá
ဘုန်းဘုန်း	pʰóʊɴpʰóʊɴ
ဘုမ္မစိုး	bòʊɴməzó
ဘုရင်	bəjɪ̀ɴ
ဘုရင်ခံ	ba̰jɪ̀ɴgàɴ
ဘုရင်မ	ba̰jɪ̀ɴma̰
ဘုရင်မင်းမြတ်	bəjɪ̀ɴmɪ́ɴmjaʔ
ဘုရား	pʰəjá
ဘုရားကိုးဆူ	pʰəjákósʰù
ဘုရားကျောင်း	pʰəjádʑáʊɴ
ဘုရားရှိခိုးကျောင်း	pʰəjáʃḭkʰódʑáʊɴ
ဘုရားလောင်း	pʰəjáláʊɴ
ဘုရားအလောင်း	pʰəjáʔəláʊɴ
ဘုံကျောင်း	bòʊɴdʑáʊɴ
ဘုံပိုင်	bòʊɴbàɪɴ
ဘူ	bù
ဘူဂေးရီးယား	bùgéɹíjá
ဘူတန်	bùtàɴ
ဘူတာ	bùdà
ဘူတာရုံ	bùdàjòʊɴ
ဘူမိဗေဒ	bùmḭbèda̰
ဘူမိရူပဗေဒ	bùmḭjùpa̰bèda̰
ဘူရွန်ဒီ	bùɹʊ̀ɴdì
ဘူး	bú
ဘူးဆို့	búzo̰
ဘူးသီး	búθí
ဘူးသီးတောင်	búðídàʊɴ
ဘေရွတ်	bèɹʊʔ
ဘော	bɔ́
ဘောက်ဆူး	baʊʔsʰú
ဘောဂဗေဒ	bɔ́ga̰ta̰bèda̰
ဘောင်းဘီ	báʊɴbì
ဘောပင်	bɔ́pɪ̀ɴ
ဘောပြား	bɔ́pjá
ဘောပွဲ	bɔ́pwɛ́
ဘောမ	bɔ́ma̰
ဘောလုံး	bɔ́lóʊɴ
ဘော့ဆွာနာ	bɔ̰sʰwànà
ဘော်ဒါ	bɔ̀dà
ဘော်ဒါကြေး	bɔ̀dàtɕé
ဘော်လီဘော	bɔ̀lìbɔ́
ဘေ့စ်ဘော	bḛsbɔ́
ဘေး	bé
ဘေးဆိုး	bézó
ဘေးဆီးရန်ကာ	bézíjàɴgà
ဘေးဘယာ	bébəjà
ဘဲ	bɛ́
ဘဲလေး	bɛ́lé
ဘဲလ်ဂရိတ်	bɛ́lgəɹeɪʔ
ဘဲ့	bɛ̰
ဘွား	bwá
ဘွားဘွား	pʰwápʰwá
ဘွိုင်လာ	bwàɪɴlà
ဘွဲ့	bwɛ̰
ဘွဲ့ချဉ်	bwɛ̰dʑɪ̀ɴ
မ	ma̰
မ	mə
မကန်း	məgáɴ
မကရ	məkəɹa̰
မကိုဋ်	məgaɪʔ
မကုဋ	məkṵta̰
မကောင်းမှု	məkáʊɴm̥ṵ
မက္ကဆီကို	mɛʔkəsʰìkò
မက်	mɛʔ
မက်စီဒိုးနီးယား	mɛʔsìdóníjá
မက်မန်း	mɛʔmáɴ
မက်မွန်	mɛʔmʊ̀ɴ
မကြာမတင်	mətɕàmətɪ̀ɴ
မကွေး	məgwé
မချစ်စု	ma̰tɕʰɪʔsṵ
မဂဓ	məgəda̰
မဂ္ဂင်ရှစ်ပါး	mɛʔgɪ̀ɴʃɪʔbá
မဂ္ဂဇင်း	mɛʔga̰zɪ̀ɴ
မင့်စ်	mɪ̰ɴs
မင်	m̥ɪ̀ɴ
မင်း	mɪ́ɴ
မင်းကြီး	mɪ́ɴdʑí
မင်းကွတ်	mɪ́ɴgʊʔ
မင်းဆက်	mɪ́ɴzɛʔ
မင်းတရား	mɪ́ɴtəjá
မင်းတရားကြီး	mɪ́ɴtəjádʑí
မင်းဘူး	mɪ́ɴbú
မင်းမဲ့စရိုက်	mɪ́ɴmɛ̰zəjaɪʔ
မင်းမြောက်တန်ဆာ	mɪ́ɴmjaʊʔdəzà
မင်းရဲကျော်ထင်	mɪ́ɴjɛ́tɕɔ̀tʰɪ̀ɴ
မင်းသမီး	mɪ́ɴðəmí
မင်းသား	mɪ́ɴðá
မင်္ဂလ	mɪ̀ɴgəla̰
မင်္ဂလဘုရား	mɪ̀ɴgəla̰pʰəjá
မင်္ဂလသုတ်	mɪ̀ɴgəla̰θoʊʔ
မင်္ဂလာ	mɪ̀ɴgəlà
မင်္ဂလာဆောင်	mɪ̀ɴgəlàsʰàʊɴ
မင်္ဂလာပါ	mɪ̀ɴgəlàbà
မစင်	ma̰sɪ̀ɴ
မစင်စွန့်	məsɪ̀ɴsʊ̰ɴ
မဆလာ	ma̰sʰəlà
မဇ္ဈဒေသ	mɪʔza̰dèθa̰
မဉ္ဇူ	mjɪ̀ɴzù
မည်	mjì
မည်စည်	mɛ̀zɛ̀
မည်သည်	mìðì
မည်သူ	mìðù
မည်း	mɛ́
မဏိ	mənḭ
မဏိတော်	mənḭdɔ̀
မဏိပူရ	mənḭpùɹa̰
မဏိမေခလာ	mənḭmèkʰəlà
မဏိဩဂ	mənḭʔɔ́ga̰
မဏ္ဍပ်	máɴdaʔ
မဏ္ဍိုင်	màɴdàɪɴ
မတကဘတ်	mətəka̰baʔ
မတော်တဆ	mətɔ̀təsʰa̰
မတော်တဆမှု	mətɔ̀təsʰa̰m̥ṵ
မတ်	maʔ
မတ်ခွက်	maʔkʰwɛʔ
မတ်စကတ်	maʔsəkaʔ
မတ်စေ့	maʔsḭ
မတ်ပဲ	maʔpɛ́
မတ်မတ်	maʔmaʔ
မထော်မနန်း	ma̰tʰɔ̀ma̰náɴ
မဒရစ်	ma̰dəɹɪʔ
မဒါဂတ်စကား	ma̰dàgaʔsəká
မနက်	mənɛʔ
မနက်ဖြန်	mənɛʔpʰjàɴ
မနီလာ	ma̰nìlà
မနုပ်တာနီ	mənoʊʔtànì
မနုဿ	ma̰noʊʔθa̰
မနုဿဗေဒ	mənoʊʔθa̰bèda̰
မနုဿီဟ	mənoʊʔθìha̰
မနော	mənɔ́
မနောကံ	mənɔ́gàɴ
မနေ့က	mənḛga̰
မန္တန်	màɴdàɴ
မန္တလေး	màɴdəlé
မန်ကျည်း	mədʑí
မန်နေဂျာ	màɴnèdʑà
မန်း	máɴ
မနှစ်	mən̥ɪʔ
မမ	ma̰ma̰
မယား	məjá
မယ်	mɛ̀
မယ်ဇယ်	mɛ̀zɛ̀
မယ်ဇလီ	mɛ̀zəlì
မယ်တော်	mɛ̀dɔ̀
မယ်သီတာ	mɛ̀θìdà
မယ်သီလ	mɛ̀ðìla̰
မရဏ	məɹəna̰
မရန်း	məjáɴ
မရမန်	məɹəmàɴ
မရမာ	məɹəmà
မရမာကြီး	məɹəmàdʑí
မရီး	məjí
မရွေး	məjwé
မလိုင်	ma̰làɪɴ
မလိုင်လုံး	məlàɪɴlóʊɴ
မလုပ်တာနီ	məloʊʔtànì
မလေး	məlé
မလေးရှား	məléʃá
မလ္လိကာ	màɴlḭkà
မသာ	məθà
မသိပါဘူး	ma̰θḭbàbú
မသိဘူး	ma̰θḭbú
မဟာ	ma̰hà
မဟာကစ္စည်း	məhàkɪʔsí
မဟာကထာန	məhàkətʰàna̰
မဟာကဿပ	məhàkaʔθəpa̰
မဟာဂီတ	məhàgìta̰
မဟာဇနပဒ	məhàzəna̰pəda̰
မဟာဒုတ်	məhàdoʊʔ
မဟာဒေဝီ	məhàdèwì
မဟာပညာဗလ	məhàpjɪ̀ɴɲàbəla̰
မဟာပိန္နဲ	məhàpèɪɴnɛ́
မဟာဗျူဟာ	məhàbjùhà
မဟာဘာရတ	məhàbàɹəta̰
မဟာဘုတ်	məhàboʊʔ
မဟာဘွဲ့	məhàbwɛ̰
မဟာမင်းကြီး	məhàmɪ́ɴdʑí
မဟာမိတ်	məhàmeɪʔ
မဟာမောဂ္ဂလာန်	məhàmaʊʔgəlàɴ
မဟာယာန	məhàjàna̰
မဟာရဋ္ဌ	məhàjətʰa̰
မဟာလတာ	məhàlətà
မဟာဝင်	məhàwɪ̀ɴ
မဟာဝိဇ္ဇာဘွဲ့	məhàweɪʔzàbwɛ̰
မဟာသာဝက	məhàθàwəka̰
မဟာသိပ္ပံဘွဲ့	məhàθeɪʔpàɴbwɛ̰
မဟေ	məhè
မဟေသီ	məhèθì
မအလ	ma̰ʔa̰la̰
မအေလိုး	məʔèló
မာ	mà
မာကျောက်	màtɕaʊʔ
မာစကတ်	màsəkaʔ
မာတာ	màtà
မာတာပိတု	màtàpḭtṵ
မာတိကာ	màtḭkà
မာနာမာ	mànàmà
မာန်	màn
မာန်အောင်	mànʔàʊɴ
မာယာ	màjà
မာရ်	mà
မာရ်နတ်	mànaʔ
မာလကာ	màləkà
မာလကာသီး	màləkàθí
မာလဝီ	màla̰wì
မာလာ	màlà
မာလာဖူး	màlàpʰú
မာလာရှမ်းကော	màlàʃáɴkɔ́
မာလာဟင်း	màlàhɪ́ɴ
မာလိန်	màlèɪɴ
မာလီ	màlì
မာသ	màθa̰
မိ	mḭ
မိကောင်းဖခင်	mḭgáʊɴpʰa̰kʰɪ̀ɴ
မိကျောင်း	mḭdʑáʊɴ
မိခင်	mḭgɪ̀ɴ
မိငယ်	mḭŋɛ̀
မိစ္ဆာ	meɪʔzà
မိညော်	mḭɲɔ̀
မိတ္တူ	meɪʔtù
မိတ္ထီလာ	meɪʔtʰìlà
မိတ်	meɪʔ
မိတ်ကပ်	meɪʔkaʔ
မိတ်ဆွေ	meɪʔsʰwè
မိထွေး	mḭdwé
မိနစ်	mḭnɪʔ
မိန့်	mḛɪɴ
မိန့်တော်မူ	mḛɪɴdɔ̀mù
မိန်	mèɪɴ
မိန်းကလေး	méɪɴgəlé
မိန်းမ	méɪɴma̰
မိန်းမလျာ	méɪɴməʃà
မိဖုရား	mḭbəjá
မိဘ	mḭba̰
မိဘပြည်သူများ	mḭba̰pjìðùmjá
မိဘမဲ့	mḭba̰mɛ̰
မိဘမဲ့ဂေဟာ	mḭba̰mɛ̰gèhà
မိမိ	mḭmḭ
မိသားစု	mḭðázṵ
မိုက်	maɪʔ
မိုက်ကယ်	maɪʔkɛ̀
မိုဂါဒစ်ရှူး	mògàdɪʔʃú
မိုင်	màɪɴ
မိုင်လို	màɪɴlò
မိုင်း	máɪɴ
မိုဇမ်ဘစ်	mòzàɴbɪʔ
မိုတယ်	mòtɛ̀
မိုနာကို	mònàkò
မိုနို	mònò
မိုဘိုင်းလ်ဖုန်း	mòbáɪɴpʰóʊɴ
မိုး	mó
မိုးကာအင်္ကျီ	mógàʔɪ̀ɴdʑì
မိုးကုတ်	mógoʊʔ
မိုးကုပ်စက်ဝိုင်း	mógoʊʔsɛʔwáɪɴ
မိုးကြိုး	módʑó
မိုးခေါ်	mókʰɔ̀
မိုးထ	mótʰa̰
မိုးရာသီ	mójàðì
မိုးလေဝသ	mólèwəθa̰
မိုးသီး	móðí
မိုးသောက်	móθaʊʔ
မိုးသောက်ယံ	móθaʊʔjàɴ
မိဿ	meɪʔθa̰
မီတာ	mìtà
မီဒီယာ	mìdìjà
မီနူး	mìnú
မီလီဂရမ်	mìlìgəɹàɴ
မီလီမီတာ	mìlìmìtà
မီလီလီတာ	mìlìlìtà
မီး	mí
မီးခတ်	míkʰaʔ
မီးခတ်	mígaʔ
မီးခိုး	mígó
မီးခိုးရောင်	mígójàʊɴ
မီးခေါင်း	mígáʊɴ
မီးခံသေတ္တာ	mígàɴθɪʔtà
မီးခြစ်	mídʑɪʔ
မီးခွက်	mígwɛʔ
မီးစက်	mísɛʔ
မီးတိုင်	mídàɪɴ
မီးတုတ်	mídoʊʔ
မီးတောင်	mídàʊɴ
မီးပဒေသာ	míbədèθà
မီးပန်း	míbáɴ
မီးပလွေ	mípəlwè
မီးပုံး	míbóʊɴ
မီးပုံးပျံ	míbóʊɴbjàɴ
မီးပူ	míbù
မီးပြတိုက်	míbja̰daɪʔ
မီးပြောင်း	míbjáʊɴ
မီးပွား	míbwá
မီးပွိုင့်	mípwa̰ɪɴ
မီးဖို	míbò
မီးဖို	mípʰò
မီးဖိုချောင်	míbòdʑàʊɴ
မီးဖွားခွင့်	mípʰwákʰwɪ̰ɴ
မီးယပ်	míjaʔ
မီးယပ်ပညာ	míjaʔpjɪ̀ɴɲà
မီးယပ်ရောဂါ	míjaʔjɔ́gà
မီးရထား	míjətʰá
မီးရထားတွဲ	míjətʰádwɛ́
မီးရှူးမီးပန်း	míʃúmíbáɴ
မီးလင်းဖို	mílɪ́ɴbò
မီးသင်္ဘော	míθɪ̀ɴbɔ́
မီးသတ်	míθaʔ
မီးသတ်ကား	míθaʔká
မီးသီး	míθí
မီးသုံးပါး	míθóʊɴbá
မီးသွေး	míðwé
မီးအိမ်	míʔèɪɴ
မုခ်	moʊʔ
မုချ	moʊʔtɕʰa̰
မုစလိန္ဒ	mṵsəlèɪɴda̰
မုဆိုး	moʊʔsʰò
မုဆိုးဖို	mṵsʰóbò
မုဆိုးမ	mṵsʰóma̰
မုတ္ထမ	moʊʔtəma̰
မုတ်ခွံ	moʊʔkʰʊ̀ɴ
မုတ်ဆိတ်	moʊʔsʰeɪʔ
မုဒိမ်း	mədéɪɴ
မုဒိမ်း	mṵdéɪɴ
မုဒ္ဓဇ	mùddəza̰
မုဒြာ	mṵdɹà
မုနိ	mṵnḭ
မုန့်	mo̰ʊɴ
မုန့်ကျွဲသည်း	mo̰ʊɴtɕwɛ́ðɛ́
မုန့်ကြာခွက်	mo̰ʊɴtɕàgwɛʔ
မုန့်ကွမ်းယာ	mo̰ʊɴkʊ́ɴjà
မုန့်ခဲဘွယ်	mo̰ʊɴkʰɛ́bwɛ̀
မုန့်စကြာ	mo̰ʊɴsɛʔtɕà
မုန့်စလင်းထောင်	mo̰ʊɴsəlɪ́ɴdàʊɴ
မုန့်ညက်	mo̰ʊɴɲɛʔ
မုန့်တိုဇံ	mo̰ʊɴtòzàɴ
မုန့်တီ	mo̰ʊɴtì
မုန့်ဖော်ခွက်	mo̰ʊɴpʰɔ̀gwɛʔ
မုန့်လက်ကောက်	mo̰ʊɴlɛʔkaʊʔ
မုန့်လက်ဆောင်း	mo̰ʊɴlɛʔsʰáʊɴ
မုန့်လင်မယား	mo̰ʊɴlɪ̀ɴməjá
မုန့်လုံးရေပေါ်	mo̰ʊɴlóʊɴjèbɔ̀
မုန့်ဟင်းခါး	mo̰ʊɴhɪ́ɴgá
မုန့်အုပ်ကလေး	mo̰ʊɴʔoʊʔgəlé
မုန့်ဦးနှောက်	mo̰ʊɴʔóʊɴðí
မုန်ညင်း	mòʊɴɲɪ́ɴ
မုန်ညင်းဆီ	mòʊɴɲɪ́ɴsʰì
မုန်ညင်းဖြူ	mòʊɴɲɪ́ɴpʰjù
မုန်ညှင်းဖြူ	mòʊɴɲ̊ɪ́ɴbjù
မုန်တိုင်း	m̥òʊɴdáɪɴ
မုန်လာ	mòʊɴlà
မုန်လာခဲ	mòʊɴlàkʰɛ́
မုန်လာထုပ်	mòʊɴlàdoʊʔ
မုန်လာဥ	mòʊɴlàʔṵ
မုန်လာဥနီ	mòʊɴlàʔṵnì
မုန်လာဥဝါ	mòʊɴlàʔṵwà
မုန်း	móʊɴ
မုရား	məjá
မုသား	mṵðá
မုံ	mòʊɴ
မုံရွာ	mòʊɴjwà
မူကြို	mùdʑò
မူကြိုကျောင်း	mùdʑòdʑáʊɴ
မူလ	mùla̰
မူလတန်း	mùla̰táɴ
မူလတန်းကြိုကျောင်း	mùla̰dáɴdʑòdʑáʊɴ
မူလဘာသာ	mùla̰bàθà
မူလီ	mùlì
မူး	mú
မေ	mè
မေကြီး	mèdʑí
မေဃာလယ	mègàləja̰
မေတ္တာ	mjɪʔtà
မေတ္တေယျ	mjɪʔtèja̰
မေထုန်	mètʰòʊɴ
မေဓင်္ကရာ	mèdɪ̀ɴkəɹà
မေဓင်္ကရာဘုရား	mèdɪ̀ɴkəɹàpʰəjá
မေမေ	mèmè
မော	mɔ́
မောက်ချ	maʊʔtɕʰa̰
မောက်ချိုက်	maʊʔtɕʰaɪʔ
မောင်	màʊɴ
မောင်တော	màʊɴtɔ́
မောင်နှမ	màʊɴn̥əma̰
မောင်မခေါ်ပဲ	màʊɴməkʰɔ̀pɛ́
မောင်မယ်	màʊɴmɛ̀
မောင်မယ်သစ်လွင်	màʊɴmɛ̀θɪʔlwɪ̀ɴ
မောင်း	máʊɴ
မောင်းမမိဿံ	máʊɴma̰meɪʔθàɴ
မောရစ်ရှ	mɔ́ɹɪʔʃa̰
မော်စကို	mɔ̀səkò
မော်ဇာ	mɔ̀zà
မော်တော်	mɔ̀tɔ̀
မော်တော်ကား	mɔ̀tɔ̀ká
မော်တော်ဆိုင်ကယ်	mɔ̀tɔ̀sʰàɪɴkɛ̀
မော်တော်ပီကေ	mɔ̀tɔ̀pìkè
မော်တော်ဘုတ်	mɔ̀tɔ̀boʊʔ
မော်တော်ယာဉ်	mɔ̀tɔ̀jɪ̀ɴ
မော်နီတာ	mɔ̀nìtà
မော်ရိုကို	mɔ̀ɹòkò
မော်ရီတေးနီးယား	mɔ̀ɹìténíjá
မော်လတာ	mɔ̀lətà
မော်လဒိုက်	mɔ̀lədaɪʔ
မော်လမြိုင်	mɔ̀ləmjàɪɴ
မော်လီကျူး	mɔ̀lìtɕú
မော်လ်ဒိုဗာ	mɔ̀ldòbà
မေ့	mḛ
မေး	mé
မေးခိုင်ရောဂါ	mékʰàɪɴjɔ́gà
မေးခွန်း	mégʊ́ɴ
မေးစေ့	mézḭ
မဲ	mɛ́
မဲခေါင်မြစ်	mɛ́kʰàʊɴmjɪʔ
မဲဆန္ဒ	mɛ́sʰàɴda̰
မဲဆန္ဒနယ်	mɛ́sʰàɴda̰nɛ̀
မဲဆန္ဒရှင်	mɛ́sʰàɴda̰ʃɪ̀ɴ
မဲဆောက်	mɛ́sʰaʊʔ
မဲဇလီ	mɛ́zəlì
မဲပေး	mɛ́pé
မံ	màɴ
မံသ	màɴθa̰
မျက်ခုံး	mjɛʔkʰóʊɴ
မျက်ခွံ	mjɛʔkʰʊ̀ɴ
မျက်စိ	mjɛʔsḭ
မျက်တောင်	mjɛʔtàʊɴ
မျက်တော်မူ	mjɛʔdɔ̀mù
မျက်နှာ	mjɛʔn̥à
မျက်နှာကြက်	mjɛʔn̥àdʑɛʔ
မျက်နှာဖုံး	mjɛʔn̥əpʰóʊɴ
မျက်နှာသုတ်ပဝါ	mjɛʔn̥àθoʊʔpa̰wà
မျက်ပါး	mjɛʔpá
မျက်မှန်	mjɛʔm̥àɴ
မျက်ရည်	mjɛʔjè
မျက်လုံး	mjɛʔlóʊɴ
မျက်လွှာ	mjɛʔl̥wà
မျက်လှည့်	mjɛʔl̥ɛ̰
မျက်လှည့်ဆရာ	mjɛʔl̥ɛ̰sʰəjà
မျဉ်း	mjɪ́ɴ
မျည်းတံ	mjídàɴ
များ	mjá
များများ	mjámjá
မျို	mjò
မျိုး	mjó
မျိုးချစ်	mjótɕʰɪʔ
မျိုးချစ်စိတ်	mjótɕʰɪʔseɪʔ
မျိုးခွဲပညာ	mjógwɛ́pjɪ̀ɴɲà
မျိုးစဉ်	mjózɪ̀ɴ
မျိုးစိတ်	mjózeɪʔ
မျိုးစု	mjózṵ
မျိုးဆက်	mjózɛʔ
မျိုးပေါင်း	mjóbáʊɴ
မျိုးပေါင်းစု	mjóbáʊɴzṵ
မျိုးရင်း	mjójɪ́ɴ
မျိုးရိုး	mjójó
မျိုးရိုးပညာ	mjójópjɪ̀ɴɲà
မျိုးဥအိမ်	mjóʔṵʔèɪɴ
မျော	mjɔ́
မျောက်	mjaʊʔ
မျောက်ချော	mjaʊʔtɕʰɔ́
မျောက်လုတ်	mjaʊʔloʊʔ
မျောက်လောင်း	mjaʊʔláʊɴ
မျှင်	m̥jɪ̀ɴ
မျှစ်	m̥jɪʔ
မျှို့	m̥jo̰
မျှော	m̥jɔ́
မျှော့	m̥jɔ̰
မျှော်	m̥jɔ̀
မျှော်စင်	m̥jɔ̀zɪ̀ɴ
မျှော်လင့်	m̥jɔ̀lɪ̰ɴ
မျှော်လင့်ချက်	m̥jɔ̀lɪ̰ɴdʑɛʔ
မြ	mja̰
မြက်	mjɛʔ
မြက်ခင်း	mjɛʔkʰɪ́ɴ
မြက်ခုတ်ဓား	mjɛʔkʰoʊʔdá
မြက်ခြောက်	mjɛʔtɕʰaʊʔ
မြင့်	mjɪ̰ɴ
မြင်	mjɪ̀ɴ
မြင်း	mjɪ́ɴ
မြင်းကလေး	mjɪ́ɴgəlé
မြင်းကျား	mjɪ́ɴdʑá
မြင်းခြံ	mjɪ́ɴdʑàɴ
မြင်းခွာ	mjɪ́ɴkʰwà
မြင်းခွာရွက်သုပ်	mjɪ́ɴkʰwàjwɛʔθoʊʔ
မြင်းစားဂျုံ	mjɪ́ɴzádʑòʊɴ
မြင်းဆေး	mjɪ́ɴzé
မြင်းတာရာ	mjɪ́ɴtàjà
မြင်းမ	mjɪ́ɴma̰
မြင်းမကလေး	mjɪ́ɴma̰gəlé
မြင်းမိုရ်	mjɪ́ɴmò
မြင်းမိုရ်တောင်	mjɪ́ɴmòtàʊɴ
မြင်းမိုရ်ပွဲ	mjɪ́ɴmòbwɛ́
မြင်းလှည်း	mjɪ́ɴl̥ɛ́
မြင်းသံခွာ	mjɪ́ɴθàɴkʰwà
မြစ်	mjɪʔ
မြစ်ကြီးနား	mjɪʔtɕíná
မြည်	mjì
မြည်း	mjí
မြတ်လေး	mjaʔlé
မြန်	mjàɴ
မြန်နှုန်းပြကိရိယာ	mjàɴn̥óʊɴpja̰kḭjḭjà
မြန်မာ	mjàɴmà
မြန်မာကြီး	mjəmàdʑí
မြန်မာ့	mjàɴma̰
မြန်မြန်	mjàɴmjàɴ
မြမ္မာ	mjàɴmà
မြဝတီ	mja̰wədì
မြား	m̥já
မြိတ်	beɪʔ
မြို့	mjo̰
မြို့စား	mjo̰zá
မြို့တော်	mjo̰dɔ̀
မြို့တော်ဝန်	mjo̰dɔ̀wʊ̀ɴ
မြို့နယ်	mjo̰nɛ̀
မြို့ပြနိုင်ငံ	mjo̰pja̰nàɪɴŋàɴ
မြို့ဝန်	mjo̰wʊ̀ɴ
မြို့အုပ်	mjo̰ʔoʊʔ
မြီ	mjì
မြီးရှေ	mjíʃè
မြုံ	mjòʊɴ
မြူ	mjù
မြူစွမ်	mjùswàɴ
မြေ	mjè
မြေကွက်	mjègwɛʔ
မြေချ	mjètɕʰa̰
မြေခွေး	mjègwé
မြေစာ	mjèzà
မြေနင်းခွာစိုက်	mjènɪ́ɴkʰwàzaɪʔ
မြေနုကျွန်းပေါ်	mjènṵtɕʊ́ɴbɔ̀
မြေပုံ	mjèbòʊɴ
မြေပုံဆွဲပညာ	mjèbòʊɴsʰwɛ́pjɪ̀ɴɲà
မြေပုံသီး	mjèbòʊɴðí
မြေပဲ	mjèbɛ́
မြေပြင်	mjèbjɪ̀ɴ
မြေပြန့်	mjèbja̰ɴ
မြေဖြူခဲ	mjèbjùgɛ́
မြေမြုပ်မိုင်း	mjèmjoʊʔmáɪɴ
မြေရိုင်း	mjèjáɪɴ
မြေရှင်	mjèʃɪ̀ɴ
မြေအောက်	mjèʔaʊʔ
မြေအောက်မီးရထား	mjèʔaʊʔmíjətʰá
မြေအောက်ရထား	mjèʔaʊʔjətʰá
မြေဩဇာ	mjèʔɔ́zà
မြောက်	mjaʊʔ
မြောက်ကိုရီးယား	mjaʊʔkòɹíjá
မြောက်မက်စီဒိုးနီးယား	mjaʊʔmɛʔsìdóníjá
မြောက်အမေရိက	mjaʊʔʔəmèɹḭka̰
မြောက်အိုင်ယာလန်	mjaʊʔʔàɪɴjəlàɴ
မြောင်း	mjáʊɴ
မြေး	mjé
မြေးမ	mjéma̰
မြံမာ	mjàɴmà
မြွက်	mjwɛʔ
မြွေ	mwè
မြွေပါ	mwèbà
မြွေဟောက်	mjwèhaʊʔ
မြှား	m̥já
မြှုပ်	m̥joʊʔ
မြှုပ်နှံ	m̥joʊʔn̥àɴ
မြှောက်	m̥jaʊʔ
မြှောက်ရကိန်း	m̥jaʊʔja̰kéɪɴ
မွတ်	mʊʔ
မွတ်စလင်	mʊʔsəlɪ̀ɴ
မွန်	mʊ̀ɴ
မွန်ဂိုးလီးယား	mʊ̀ɴgólíjá
မွန်တီနီဂရိုး	mʊ̀ɴtìnìgəɹó
မွန်း	mʊ́ɴ
မွန်းစောင်း	mʊ́ɴsáʊɴ
မွန်းတည့်	mʊ́ɴtḭ
မွန်းတိမ်း	mʊ́ɴtéɪɴ
မွန်းလတ်	mʊ́ɴlaʔ
မွန်းလွဲ	mʊ́ɴlwɛ́
မွာချီး	mwàtɕʰí
မွေ့	mwḛ
မွေ့ရာ	mwḛjà
မွေး	mwé
မွေးနေ့	mwénḛ
မွေးနေ့ကိတ်မုန့်	mwénḛkeɪʔmo̰ʊɴ
မွေးနေ့မင်္ဂလာပါ	mwénḛmɪ̀ɴgəlàbà
မွေးရပ်	mwéjaʔ
မွေးရပ်မြေ	mwéjaʔmjè
မွဲ	mwɛ́
မွှား	m̥wá
မွှေး	m̥wé
မှ	m̥a̰
မှတ်	m̥aʔ
မှတ်ကျောက်	m̥aʔtɕaʊʔ
မှတ်စု	m̥aʔsṵ
မှတ်စုစာအုပ်	m̥aʔsṵsàʔoʊʔ
မှတ်ဉာဏ်	m̥aʔɲàn
မှတ်တမ်း	m̥aʔtáɴ
မှတ်တိုင်	m̥aʔtàɪɴ
မှတ်မိ	m̥aʔmḭ
မှန်	m̥àɴ
မှန်စာ	m̥àɴzà
မှန်စီရွှေချ	m̥àɴzìʃwètɕʰa̰
မှန်တော့	m̥àɴdɔ̰
မှန်ပါ့ဘုရား	m̥àɴba̰pʰəjá
မှန်ပြောင်း	m̥àɴbjáʊɴ
မှန်ဖြူ	m̥àɴbjù
မှန်ဘီလူး	m̥àɴbəlú
မှန်မှန်	m̥àɴm̥àɴ
မှန်လာ	m̥àɴlà
မှာ	m̥à
မှား	m̥á
မှို	m̥ò
မှု	m̥ṵ
မှုတ်	m̥oʊʔ
မှုန့်	m̥o̰ʊɴ
မှုန်	m̥òʊɴ
မှောင်ခိုဈေး	m̥àʊɴkʰòzé
မှဲ့	m̥ɛ̰
ယ	ja̰
ယက္ခ	jɛʔkʰa̰
ယက်	jɛʔ
ယခု	jəkʰṵ
ယင်	jɪ̀ɴ
ယင်ကောင်	jɪ̀ɴgàʊɴ
ယင်းမာ	jɪ́ɴmà
ယစ်ထုတ်	jɪʔtʰoʊʔ
ယဇ်	jɪʔ
ယဉ်	jɪ̀ɴ
ယဉ်ကျေးမှု	jɪ̀ɴtɕém̥ṵ
ယတြာ	jədəjà
ယနေ့	ja̰nḛ
ယန္တရား	jàɴdəjá
ယပက်လက်	ja̰pɛʔlɛʔ
ယပင့်	ja̰pɪ̰ɴ
ယပ်	jaʔ
ယမက	jəməka̰
ယမကာ	jəməkà
ယမင်း	jəmɪ́ɴ
ယမနေ	jəmənè
ယမန်နှစ်	jəmàɴn̥ɪʔ
ယမမင်း	jəma̰mɪ́ɴ
ယမုန်နာ	jəmòʊɴnà
ယမ်း	jáɴ
ယမ်းတောင့်	jáɴda̰ʊɴ
ယမ်းမှုန့်	jáɴm̥o̰ʊɴ
ယဝဒီပ	ja̰wa̰dìpa̰
ယသောဓရာ	ja̰θɔ́dəjà
ယာ	jà
ယာဉ်	jɪ̀ɴ
ယာဉ်မောင်း	jɪ̀ɴmàʊɴ
ယာဉ်ရပ်	jɪ̀ɴjaʔ
ယာဘ	jàba̰
ယာမာ	jàmà
ယာယီ	jàjì
ယား	já
ယို	jò
ယိုးဒယား	jódəjá
ယိုးဒယားကြေးသွား	jódəjá
ယိုးဒယားဆယ့်နှစ်ခန်း	jódəjásʰɛ̰n̥əkʰáɴ
ယိုးဒယားနှဲသွား	jódəjá
ယိုးဒယားသမင်လိုက်	jódəjáθəmɪ̀ɴlaɪʔ
ယိုးဒယားသီချင်း	jódəjáθətɕʰɪ́ɴ
ယိုးဒယားသံရှစ်မျိုး	jódəjá
ယိုးဒယားအက	jódəjáʔəka̰
ယီမင်	jìmɪ̀ɴ
ယုဂ်	joʊʔ
ယုဇန	jṵza̰na̰
ယုတ္တိ	joʊʔtḭ
ယုတ္တိဗေဒ	joʊʔtḭbèda̰
ယုန်	jòʊɴ
ယုံ	jòʊɴ
ယုံကြည်	jòʊɴtɕì
ယူ	jù
ယူကရိန်း	jùkəɹéɪɴ
ယူဂန်းဒါး	jùgáɴdá
ယူဂိုဆလားဗီးယား	jùgòsʰəlábíjá
ယူနိုက်တက်ကင်းဒမ်း	jùnaɪʔtɛʔkɪ́ɴdáɴ
ယူနီ	jùnì
ယူနီဖောင်း	jùnìpʰáʊɴ
ယူနီဘာစီတီ	jùnìbàsìtì
ယူနီယန်	jùnìjàɴ
ယူရို	jùɹò
ယူရေနတ်	jùɹènaʔ
ယူရေးရှား	jùɹéʃá
ယေရေဗန်	jèɹèbàɴ
ယေရှု	jèʃṵ
ယောက္ခထီး	jaʊʔkʰətʰí
ယောက္ခမ	jaʊʔkʰəma̰
ယောက်	jaʊʔ
ယောက်ဖ	jaʊʔpʰa̰
ယောက်မ	jáʊɴma̰
ယောက်သွား	jaʊʔθwá
ယောက်ျား	jaʊʔtɕá
ယောက်ျားလျာ	jaʊʔkəʃà
ယောဂ	jɔ́ga̰
ယောဇနာ	jɔ́zənà
ယောနိ	jɔ́nḭ
ယဲ့ယဲ့	jɛ̰jɛ̰
ယွင်း	jwɪ́ɴ
ယွန်း	jʊ́ɴ
ယွန်းဇဝါ	jʊ́ɴzəwà
ယွန်းထည်	jʊ́ɴtʰɛ̀
ယွန်းထည်သရိုး	jʊ́ɴtʰìθəjó
ယွန်းပန်း	jʊ́ɴbáɴ
ယွန်းပန်းချီ	jʊ́ɴbədʑì
ယွန်းပေါင်ပုရပိုက်	jʊ́ɴbàʊɴpəɹəbaɪʔ
ယွန်းယွန်း	jʊ́ɴjʊ́ɴ
ယှက်	ʃɛʔ
ယှဉ်ဖက်	ʃɪ̀ɴpʰɛʔ
ယှဉ်း	ʃɪ́ɴ
ရ	ja̰
ရ	ɹa̰
ရကောက်	ja̰kaʊʔ
ရက်	jɛʔ
ရက်ကန်း	jɛʔkáɴ
ရက်ကန်းစင်	jɛʔkáɴzɪ̀ɴ
ရက်စွဲ	jɛʔswɛ́
ရက်ရာဇာ	jɛʔjàzà
ရက်သတ္တပတ်	jɛʔθaʔdəbaʔ
ရခိုင်	jəkʰàɪɴ
ရင့်	jɪ̰ɴ
ရင်	jɪ̀ɴ
ရင်ခံ	jɪ̀ɴkʰàɴ
ရင်ခွဲရုံ	jɪ̀ɴgwɛ́jòʊɴ
ရင်ထိုးတံဆိပ်	jɪ̀ɴdódəzeɪʔ
ရင်ပတ်	jɪ̀ɴbaʔ
ရင်ပြင်	jɪ̀ɴbjɪ̀ɴ
ရင်ဘတ်	jɪ̀ɴbaʔ
ရင်းရဲ	jɪ́ɴjɛ́
ရစ်	jɪʔ
ရည်	jì
ရည်မှန်းချက်	jìm̥áɴdʑɛʔ
ရည်းစား	jízá
ရတနာ	jədənà
ရတနာပုံ	jɛ̀dənàbòʊɴ
ရတနာပူရ	jədənàpùɹa̰
ရတနာသိင်္ဃ	jədənàθèɪɴga̰
ရတနာသုံးပါး	jədənàθóʊɴbá
ရတီ	jətì
ရတု	ja̰tṵ
ရထား	jətʰá
ရနံ့	jəna̰ɴ
ရန်	jàɴ
ရန်ကင်း	jàɴgɪ́ɴ
ရန်ကုန်	jàɴgòʊɴ
ရန်ပြု	jàɴpjṵ
ရန်ဖြစ်	jàɴpʰjɪʔ
ရန်သူ	jàɴðù
ရန်သူမျိုးငါးပါး	jàɴðùmjóŋábá
ရပါတယ်	ja̰bàdɛ̀
ရပ်	jaʔ
ရပ်ကွက်	jaʔkwɛʔ
ရမ္မက်	jəmɛʔ
ရမ်	ɹàɴ
ရမ်းရမ်း	jáɴjáɴ
ရယ်	jì
ရရစ်	ja̰jɪʔ
ရလဒ်	ja̰laʔ
ရဝမ်ဒါ	ɹəwàɴdà
ရဝိန်	jəwèɪɴ
ရဝေ	jəwè
ရဝေတိုင်	jəwèdàɪɴ
ရသ	ja̰ðà
ရသာ	ja̰ðà
ရသာရုံ	ja̰θàjòʊɴ
ရသေ့	jəθḛ
ရဟတ်	jəhaʔ
ရဟတ်ယာဉ်	jəhaʔjɪ̀ɴ
ရဟန်း	jəháɴ
ရာ	jà
ရာခိုင်နှုန်း	jàkʰàɪɴn̥óʊɴ
ရာဂ	jàga̰
ရာစု	jàzṵ
ရာစုနှစ်	jàzṵn̥ɪʔ
ရာဇ	jàza̰
ရာဇဂုရု	jàza̰gṵɹṵ
ရာဇဌာန်	ɹàzətʰàn
ရာဇဝင်	jàzəwɪ̀ɴ
ရာဇဝတ်	jàzəwʊʔ
ရာဇဝတ်ကောင်	jàzəwʊʔkàʊɴ
ရာဇသတ်	jàzəθaʔ
ရာဇာ	jàzà
ရာဇာဓိရာဇဂုရု	jàza̰dḭjàza̰gṵɹṵ
ရာဘ	jàba̰
ရာဘတ်	ɹàbaʔ
ရာဘာ	jàbà
ရာမ	jàma̰
ရာမည	ɹàməɲa̰
ရာရာစစ	jàjàsa̰sa̰
ရာဝဏ	ɹàwəna̰
ရာသီ	jàðì
ရာသီရုပ်	jàðìjoʊʔ
ရာသီဥတု	jàðìʔṵdṵ
ရာဟုဂြိုဟ်	jàhṵdʑò
ရာဟုလာ	jàhṵlà
ရိက္ခါ	jeɪʔkʰà
ရိက္ခာ	jeɪʔkʰà
ရိတ်	jeɪʔ
ရိတ်သိမ်း	jeɪʔθéɪɴ
ရိပ်ရိပ်	jeɪʔjeɪʔ
ရိုက်	jaɪʔ
ရိုင်ဖယ်	ɹàɪɴpʰɛ̀
ရိုင်ရိုင်	jàɪɴjàɪɴ
ရိုဟင်ဂျာ	ɹòhɪ̀ɴdʑà
ရိုး	jó
ရိုးရာအမည်	jójàʔəmjì
ရိုးရိုး	jójó
ရီဂါ	ɹìgà
ရုက္ခစိုး	joʊʔgəzó
ရုက္ခဗေဒ	joʊʔkʰa̰bèda̰
ရုက္ခဗေဒဥယျာဉ်	joʊʔkʰa̰bèda̰ʔṵjɪ̀ɴ
ရုပ်	joʊʔ
ရုပ်ကလာပ်	joʊʔkəlaʔ
ရုပ်တု	joʊʔtṵ
ရုပ်ပုံ	joʊʔpòʊɴ
ရုပ်မြင်သံကြား	joʊʔmjɪ̀ɴθàɴdʑá
ရုပ်ရှင်	joʊʔʃɪ̀ɴ
ရုပ်ရှင်ရုံ	joʊʔʃɪ̀ɴjòʊɴ
ရုပ်သေး	joʊʔθé
ရုပ်သေးအစိုးရ	joʊʔθéʔəsója̰
ရုဘစ်ကုဗတုံး	ɹṵbɪʔkṵbətóʊɴ
ရုရု	jṵjṵ
ရုရှား	ɹṵʃá
ရုံ	jòʊɴ
ရုံး	jóʊɴ
ရုံးပတီ	jóʊɴbətì
ရူပ	jùpa̰
ရူပကအလင်္ကာ	jùpəka̰ʔəlìgà
ရူပနက္ခတ္တဗေဒ	jùpa̰nɛʔkʰaʔta̰bèda̰
ရူပဗေဒ	jùpa̰bèda̰
ရူပါရုံ	jùpàjòʊɴ
ရူပီး	ɹùpí
ရူမေးနီးယား	ɹùméníjá
ရေ	jè
ရေကတော့	jègədɔ̰
ရေကာတာ	jègàdà
ရေကူး	jèkú
ရေကူးကန်	jèkúgàɴ
ရေကြီး	jètɕí
ရေကြီးခြင်း	jètɕídʑɪ́ɴ
ရေခဲ	jègɛ́
ရေခဲခေတ်	jègɛ́kʰɪʔ
ရေခဲခြစ်	jègɛ́dʑɪʔ
ရေခဲတိုက်	jègɛ́daɪʔ
ရေခဲတောင်	jègɛ́dàʊɴ
ရေခဲမုန့်	jègɛ́mo̰ʊɴ
ရေခဲသေတ္တာ	jègɛ́θɪʔtà
ရေချိုး	jètɕʰó
ရေခွက်	jègwɛʔ
ရေဂျာဗစ်	ɹèdʑàbɪʔ
ရေငတ်	jèŋaʔ
ရေငတ်တယ်	jèŋaʔtɛ̀
ရေငုပ်သင်္ဘော	jèŋoʊʔθɪ̀ɴbɔ́
ရေငွေ့	jèŋwḛ
ရေစစ္စရီ	jèsɪʔsəɹì
ရေညှိ	jèɲ̊ḭ
ရေတပ်	jèdaʔ
ရေတံခွန်	jèdàgʊ̀ɴ
ရေတွက်	jètwɛʔ
ရေတွင်း	jèdwɪ́ɴ
ရေဒါ	ɹèdà
ရေဒီယို	ɹèdìjò
ရေနဂါး	jènəgá
ရေနံ	jènàɴ
ရေနံချောင်း	jènàɴdʑáʊɴ
ရေနံဆီ	jènàɴzì
ရေနွေးကြမ်း	jènwédʑáɴ
ရေနွေးအိုး	jènwéʔó
ရေပန်း	jèbáɴ
ရေပိုက်	jèpaɪʔ
ရေပေါ်ဆီ	jèbɔ̀zì
ရေမိုင်	jèmàɪɴ
ရေမြင်း	jèmjɪ́ɴ
ရေမြေသခင်	jèmjèθəkʰɪ̀ɴ
ရေမွှေး	jèm̥wé
ရေမှုတ်	jèm̥oʊʔ
ရေယုန်	jèjòʊɴ
ရေလက်ဝါး	jèlɛʔwá
ရေလုပ်သား	jèloʊʔθá
ရေဝတ	ɹèwəta̰
ရေဝတဘုရား	jèwəta̰pʰəjá
ရေသူ	jèðù
ရေသူမ	jèðùma̰
ရောက်	jaʊʔ
ရောက်တာ	ɹaʊʔtà
ရောဂန္တရကပ်	jɔ́gàɴtəɹa̰kaʔ
ရောဂါ	jɔ́gà
ရောဂါဗေဒ	jɔ́gàbèda̰
ရောင်	jàʊɴ
ရောင်ခြည်	jàʊɴdʑì
ရောင်း	jáʊɴ
ရောမ	ɹɔ́ma̰
ရော်	jɔ̀
ရော်ဘာ	ɹɔ̀bà
ရေး	jé
ရေးချ	jétɕʰa̰
ရေးရေး	jéjé
ရဲ	jɛ́
ရဲစခန်း	jɛ́səkʰáɴ
ရဲတိုက်	jɛ́daɪʔ
ရဲဘော်	jɛ́bɔ̀
ရဲမေ	jɛ́mè
ရဲရင့်	jɛ́jɪ̰ɴ
ရဲရဲ	jɛ́jɛ́
ရဲသား	jɛ́ðá
ရဲ့	jɛ̰
ရွက်	jwɛʔ
ရွက်ကြမ်း	jwɛʔdʑáɴ
ရွက်ကြမ်းရေကျို	jwɛʔtɕáɴjèdʑò
ရွက်ပုန်းသီး	jwɛʔpóʊɴðí
ရွက်လှေ	jwɛʔl̥è
ရွတ်ရွတ်	jʊʔjʊʔ
ရွပ်ရွပ်	jʊʔjʊʔ
ရွရွ	jwa̰jwa̰
ရွာ	jwà
ရွာစား	jwàzá
ရွာသူ	jwàðù
ရွာသူကြီး	jwàθədʑí
ရွေး	jwé
ရွေးကောက်ပွဲ	jwékaʊʔpwɛ́
ရွေးချယ်	jwétɕʰɛ̀
ရွေးချယ်တင်မြှောက်ပွဲ	jwétɕʰɛ̀tɪ̀ɴm̥jaʊʔpwɛ́
ရွံ	jʊ̀ɴ
ရွံ့	jʊ̰ɴ
ရွှေ	ʃwè
ရွှေချည်ထိုး	ʃwèdʑìdó
ရွှေချီ	ʃwèdʑì
ရွှေချီပူတင်း	ʃwèdʑìpùdɪ́ɴ
ရွှေတိုက်	ʃwèdaɪʔ
ရွှေတောင်	ʃwèdàʊɴ
ရွှေတောင်ခေါက်ဆွဲ	ʃwèdàʊɴkʰaʊʔsʰwɛ́
ရွှေတြိဂံ	ʃwètɹḭgàɴ
ရွှေထမင်း	ʃwètʰəmɪ́ɴ
ရွှေနန်းရွှေပြာသာဒ်သခင်	ʃwènáɴʃwèpjaʔθaʔθəkʰɪ̀ɴ
ရွှေနန်းရှင်ဘုရား	ʃwènáɴʃɪ̀ɴpʰəjá
ရွှေနီ	ʃwènì
ရွှေပဲ	ʃwèpɛ́
ရွှေပြည်စိုး	ʃwèpjìsó
ရွှေဖရုံသီး	ʃwèpʰəjòʊɴðí
ရွှေဖြူ	ʃwèbjù
ရွှေဘို	ʃwèbò
ရွှေမျက်ပါး	ʃwèmjɛʔpá
ရွှေရင်အေး	ʃwèjɪ̀ɴʔé
ရွှေ့	ʃwḛ
ရွှဲ	ʃwɛ́
ရွှံ့	ʃʊ̰ɴ
ရွှံ့ပွက်	ʃʊ̰ɴbwɛʔ
ရှက်	ʃɛʔ
ရှင့်	ʃɪ̰ɴ
ရှင်	ʃɪ̀ɴ
ရှင်တို့	ʃɪ̀ɴdo̰
ရှင်ပြု	ʃɪ̀ɴpjṵ
ရှင်ဖ	ʃɪ̀ɴpʰa̰
ရှင်ဘုရင်	ʃɪ̀ɴbəjɪ̀ɴ
ရှင်မွေ့	ʃɪ̀ɴmwḛ
ရှင်ရှင်	ʃɪ̀ɴʃɪ̀ɴ
ရှင်းရှင်း	ʃɪ́ɴʃɪ́ɴ
ရှစ်	ʃɪʔ
ရှစ်ပါးသီလ	ʃɪʔbáθìla̰
ရှစ်လ	ʃɪʔla̰
ရှဉ့်	ʃɪ̰ɴ
ရှည်	ʃè
ရှည်မျော	ʃèmjɔ́
ရှမ်ပိန်	ʃàɴpèɪɴ
ရှမ်း	ʃáɴ
ရှမ်းခေါက်ဆွဲ	ʃáɴkʰaʊʔsʰwɛ́
ရှယ်	ʃɛ̀
ရှယ်ယာ	ʃɛ̀jà
ရှလကာရည်	ʃàləkàjè
ရှလပတ်ရည်	ʃa̰ləpaʔjè
ရှာ	ʃà
ရှား	ʃá
ရှိ	ʃḭ
ရှိန်းခို	ʃéɪɴgò
ရှိုက်	ʃaɪʔ
ရှို့	ʃo̰
ရှိုး	ʃó
ရှူ	ʃù
ရှူတင်	ʃùtɪ̀ɴ
ရှူရှိုက်	ʃùʃaɪʔ
ရှူး	ʃú
ရှူးဖိနပ်	ʃúpʰənaʔ
ရှောက်	ʃaʊʔ
ရှောက်နု	ʃaʊʔnṵ
ရှော့ပင်းစင်တာ	ʃɔ̰pɪ́ɴsɪ̀ɴtà
ရှေ့	ʃḛ
ရှေ့ဆက်	ʃḛzɛʔ
ရှေ့နေ	ʃḛnè
ရှေ့နေချုပ်	ʃḛnèdʑoʊʔ
ရှေ့ရုံး	ʃḛjóʊɴ
ရှေး	ʃé
ရှေးခေတ်ဂရိ	ʃékʰɪʔgəɹḭ
ရှေးဟောင်း	ʃéháʊɴ
ရှေးဟောင်းသုတေသန	ʃéháʊɴθṵtèθəna̰
ရဿ	ɹaʔθa̰
လ	la̰
လက္ခဏ	lɛʔkʰəna̰
လက္ခဏာ	lɛʔkʰənà
လက္ခဏာရေးသုံးပါး	lɛʔkʰənàjéθóʊɴbá
လက်	lɛʔ
လက်ကိုင်ပဝါ	lɛʔkàɪɴpa̰wà
လက်ကောက်	lɛʔkaʊʔ
လက်ကွက်	lɛʔkwɛʔ
လက်ခလယ်	lɛʔkʰəlɛ̀
လက်ခံ	lɛʔkʰàɴ
လက်ချောင်း	lɛʔtɕʰáʊɴ
လက်စွပ်	lɛʔsʊʔ
လက်ဆောင်	lɛʔsʰàʊɴ
လက်ဆွဲသေတ္တာ	lɛʔsʰwɛ́θɪʔtà
လက်ညှိုး	lɛʔɲ̊ó
လက်တင်	lɛʔtɪ̀ɴ
လက်တင်အမေရိက	lɛʔtɪ̀ɴʔəmèɹḭka̰
လက်တန်း	lɛʔtáɴ
လက်တို	lɛʔtò
လက်ထပ်	lɛʔtʰaʔ
လက်ထပ်ခြင်း	lɛʔtʰaʔdʑɪ́ɴ
လက်နက်	lɛʔnɛʔ
လက်နှိပ်စက်	lɛʔn̥eɪʔsɛʔ
လက်နှီးစုတ်	lɛʔn̥ísoʊʔ
လက်ပစ်ဗုံး	lɛʔpɪʔbóʊɴ
လက်ပတ်နာရီ	lɛʔpaʔnàjì
လက်ပံ	lɛʔpàɴ
လက်ပံခါး	lɛʔpàɴgá
လက်ဖက်	ləpʰɛʔ
လက်ဖက်	lɛʔpʰɛʔ
လက်ဖက်စို	ləpʰɛʔsò
လက်ဖက်ထုပ်	ləpʰɛʔtʰoʊʔ
လက်ဖက်ရည်	ləpʰɛʔjè
လက်ဖက်ရည်ကြမ်း	ləpʰɛʔjìdʑáɴ
လက်ဖက်ရည်ဆိုင်	ləpʰɛʔjèzàɪɴ
လက်ဖက်ရည်ဖိုး	lɛʔpʰɛʔjìbó
လက်ဖက်ရည်အချို	ləpʰɛʔjìʔətɕʰò
လက်ဖက်သုပ်	ləpʰɛʔθoʊʔ
လက်ဘနွန်	lɛʔbənʊ̀ɴ
လက်မ	lɛʔma̰
လက်မှတ်	lɛʔm̥aʔ
လက်ရန်း	lɛʔjáɴ
လက်ရှည်	lɛʔʃè
လက်ဝါး	lɛʔwá
လက်ဝါးကပ်တိုင်	lɛʔwəgaʔtàɪɴ
လက်ဝှေ့	lɛʔʍḛ
လက်သည်	lɛʔθɛ̀
လက်သည်း	lɛʔθɛ́
လက်သည်းကွင်း	lɛʔθégwɪ́ɴ
လက်သန်း	lɛʔθáɴ
လက်သမား	lɛʔθa̰má
လက်သီး	lɛʔθí
လက်သုတ်ပဝါ	lɛʔθoʊʔpa̰wà
လက်သုပ်စုံ	lɛʔθoʊʔsòʊɴ
လက်အိတ်	lɛʔʔeɪʔ
လကွယ်	la̰gwɛ̀
လခြမ်း	la̰dʑáɴ
လခြမ်းဆိုင်း	la̰dʑáɴsʰáɪɴ
လငယ်	la̰ŋɛ̀
လင်	lɪ̀ɴ
လင်ကောင်ပိုး	lɪ̀ɴgàʊɴbó
လင်ပန်း	lɪ̀ɴbáɴ
လင်မယား	lɪ̀ɴməjá
လင်း	lɪ́ɴ
လင်းဆွဲ	lɪ́ɴzwɛ́
လင်းဇင်း	lɪ́ɴzɪ́ɴ
လင်းတ	lɪ́ɴda̰
လင်းနို့	lɪ́ɴno̰
လင်းပိုင်	lɪ́ɴbàɪɴ
လင်းမြွေ	lɪ́ɴmjwè
လင်းယဉ်	lɪ́ɴjɪ̀ɴ
လင်းယုန်	lɪ́ɴjòʊɴ
လင်္ကာ	lɪ̀ɴga̰
လစဉ်	la̰zɪ̀ɴ
လစ်	lɪʔ
လစ်စဘွန်း	lɪʔsəbʊ́ɴ
လစ်တန်စတိန်း	lɪʔtàɴsətéɪɴ
လစ်ဗျား	lɪʔbjá
လစ်သူယေးနီးယား	lɪʔθùjéníjá
လဆန်း	la̰záɴ
လဆုတ်	la̰zoʊʔ
လဆွဲ	la̰sʰwɛ́
လည်	lɛ̀
လည်ချောင်း	lɛ̀dʑáʊɴ
လည်စည်း	lèzí
လည်ဆွဲ	lɛ̀zwɛ́
လည်ပင်း	lɛ̀bɪ́ɴ
လည်ပင်းကြီးရောဂါ	lìbɪ́ɴdʑíjɔ́gà
လည်း	lí
လည်း	lɛ́
လတ်	laʔ
လတ်ဗီယာ	laʔbìjà
လဒ်	laʔ
လန်ချား	làɴtɕʰá
လန်ဒန်	làɴdàɴ
လပို့	ləbo̰
လပ်	laʔ
လပြည့်	la̰pjḛ
လပြည့်နေ့	la̰pjḭnḛ
လပြည့်ဝန်း	la̰bjḛwʊ́ɴ
လမု	ləmṵ
လမုန့်	la̰mo̰ʊɴ
လမ်း	láɴ
လမ်းကြား	láɴdʑá
လမ်းကြောင်း	láɴdʑáʊɴ
လမ်းဆုံ	láɴzòʊɴ
လမ်းညွှန်	láɴɲ̊ʊ̀ɴ
လမ်းပြ	láɴpja̰
လမ်းဘေးဆိုင်	láɴbézàɪɴ
လမ်းလျှောက်	láɴʃaʊʔ
လမ်းသရဲ	láɴθəjɛ́
လမွတ်	ləmʊʔ
လယ	ləja̰
လယ်	lɛ̀
လယ်ထွန်	lɛ̀tʰʊ̀ɴ
လယ်ထွန်မင်္ဂလာ	lɛ̀tʰʊ̀ɴmɪ̀ɴgəlà
လယ်ပြင်	lɛ̀bjɪ̀ɴ
လယ်ယာ	lɛ̀jà
လယ်သမား	lɛ̀ðəmá
လဟု	ləhṵ
လာ	là
လာဘ်	laʔ
လာအို	làʔò
လား	lá
လားရှိုး	láʃó
လားဟူ	láhù
လိင်	lèɪɴ
လိင်ဆက်ဆံ	lèɪɴsʰɛʔsʰàɴ
လိင်တံ	lèɪɴdàɴ
လိင်ပညာ	lèɪɴpjɪ̀ɴɲà
လိင်အင်္ဂါ	lèɪɴʔɪ̀ɴgà
လိပ်	leɪʔ
လိပ်ကျောက်	leɪʔtɕaʊʔ
လိပ်ခါးဖားဖင်	leɪʔkʰápʰápʰɪ̀ɴ
လိပ်ခေါင်း	leɪʔgáʊɴjɔ́gà
လိပ်ခေါင်းရောဂါ	leɪʔgáʊɴjɔ́gà
လိပ်စာ	leɪʔsà
လိပ်ပြာ	leɪʔpjà
လိမ္မာ	lèɪɴmà
လိမ္မော်	lèɪɴmɔ̀
လိမ်	lèɪɴ
လိမ်း	léɪɴ
လိမ်းဆေး	léɪɴzé
လို	lò
လိုက်	laɪʔ
လိုက်ချီး	laɪʔtɕʰí
လိုက်ပြေး	laɪʔpjé
လိုက်ပွဲ	laɪʔpwɛ́
လိုက်ဘေးရီးယား	laɪʔbéɹíjá
လိုချင်	lòdʑɪ̀ɴ
လိုင်ကီး	làɪɴkí
လိုင်စင်	làɪɴsɪ̀ɴ
လိုင်း	láɪɴ
လိုင်းကား	láɪɴgá
လိုဏ်	l̥àɪɴ
လိုဏ်ခေါင်း	l̥àɪɴgáʊɴ
လိုအပ်	lòʔaʔ
လို့	lo̰
လိုး	ló
လီ	lì
လီဆိုသို	lìsʰòθò
လီဆူ	lìsʰù
လီတာ	lìtà
လီသီယမ်	lìθìjàɴ
လီး	lí
လု	lṵ
လုပ်	loʊʔ
လုပ်ခ	loʊʔkʰa̰
လုပ်ငန်း	loʊʔŋáɴ
လုပ်ဖော်ကိုင်ဖက်	loʊʔpʰɔ̀kàɪɴbɛʔ
လုပ်ရတ်	loʊʔjaʔ
လုပ်သား	loʊʔθá
လုပ်အား	loʊʔʔá
လုမ္ဗိနီ	lòʊɴbḭnì
လုံချည်	lòʊɴdʑì
လုံခြုံရေး	lòʊɴdʑòʊɴjé
လုံ့လ	lo̰ʊɴla̰
လုံး	lóʊɴ
လုံးလုံး	lóʊɴlóʊɴ
လူ	lù
လူကြီး	lùdʑí
လူကြီးမင်းများခင်ဗျား	lùdʑímɪ́ɴmjákʰəbjá
လူငယ်	lùŋɛ̀
လူစုလူဝေး	lùzṵlùwé
လူဇင်ဘတ်	lùzɪ̀ɴbaʔ
လူတော	lùdɔ́
လူထု	lùdṵ
လူထုကျန်းမာရေး	lùdṵtɕáɴmàjé
လူထုမီဒီယာ	lùdṵmìdìjà
လူနည်းစု	lùnɛ́zṵ
လူနာ	lùnà
လူနာတင်ကား	lùnàdɪ̀ɴká
လူပျို	lùbjò
လူပျိုနာ	lùbjònà
လူဘယာနာ	lùbəjànà
လူများစု	lùmjázṵ
လူမျိုး	lùmjó
လူမျိုးစုလွှတ်တော်	lùmjózṵl̥ʊʔtɔ̀
လူမျိုးတုံးသတ်ဖြတ်မှု	lùmjótóʊɴθaʔpʰjaʔm̥ṵ
လူမျိုးရေးဝါဒ	lùmjójéwàda̰
လူမှုကွန်ရက်	lùm̥ṵkʊ̀ɴjɛʔ
လူမှုဗေဒ	lùm̥ṵbèda̰
လူမှုမီဒီယာ	lùm̥ṵmìdìjà
လူဝင်မှုကြီးကြပ်ရေး	lùwɪ̀ɴm̥ṵtɕítɕaʔjé
လူဝံ	lùwʊ̀ɴ
လူသတ်ပွဲ	lùðaʔpwɛ́
လူသတ်မှု	lùðaʔm̥ṵ
လူသား	lùðá
လူဦးရေ	lùʔújè
လူ့ဘောင်	lṵbàʊɴ
လူ့အဖွဲ့အစည်း	lṵʔəpʰwɛ̰ʔəsí
လေ	lè
လေကတော့	lègədɔ̰
လေချဉ်တက်	lèdʑɪ̀ɴtɛʔ
လေချွန်	lètɕʰʊ̀ɴ
လေစုန်	lèzòʊɴ
လေဆိပ်	lèzeɪʔ
လေထိုးတံ	lètʰódàɴ
လေထီး	lèdí
လေထု	lèdṵ
လေပွေ	lèbwè
လေဖိအား	lèpʰḭʔá
လေဖုတ်	lèpʰoʊʔ
လေဖြတ်ရောဂါ	lèpʰjaʔjɔ́gà
လေမုန်တိုင်း	lèmòʊɴdáɪɴ
လေယာဉ်	lèjɪ̀ɴ
လေယာဉ်ပျံ	lèjɪ̀ɴbjàɴ
လေယာဉ်မယ်	lèjɪ̀ɴmɛ̀
လေယာဉ်မောင်	lèjɪ̀ɴmàʊɴ
လေယာဉ်မှူး	lèjɪ̀ɴm̥ú
လေရဟတ်	lèjəhaʔ
လေလည်	lèlè
လေလံ	lèlàɴ
လေသာခန်း	lèðàgáɴ
လေသာပေါက်	lèðàbaʊʔ
လေသိုက်	lèθaɪʔ
လေအေးစက်	lèʔézɛʔ
လောက	lɔ́ka̰
လောကဓာတ်	lɔ́gədaʔ
လောကဓံ	lɔ́gədàɴ
လောကနတ်	lɔ́ka̰naʔ
လောကဝတ်	lɔ́gəwʊʔ
လောက်	laʊʔ
လောင်	làʊɴ
လောင်စာ	làʊɴzà
လောင်း	láʊɴ
လောဘ	lɔ́ba̰
လောလော	lɔ́lɔ́
လော့စ်အိန်ဂျယ်လိစ်	la̰ʊʔʔèɪɴdʑɛ̀leɪʔ
လေ့ကျင့်	lḛtɕɪ̰ɴ
လေ့ကျင့်ခန်း	lḛtɕɪ̰ɴgáɴ
လေ့လာ	lḛlà
လေး	lé
လေးကြိုး	lédʑó
လေးညှင်း	léɲ̊ɪ́ɴ
လေးညှင်းပွင့်	léɲ̊ɪ́ɴbwɪ̰ɴ
လေးထောင့်	léda̰ʊɴ
လေးလ	léla̰
လေးလံ	lélàɴ
လဲ	lɛ́
လဲ့လဲ့	lɛ̰lɛ̰
လံဗား	làɴbá
လ္ဘက်	ləpʰɛʔ
လျက်	jɛʔ
လျားလျား	jájá
လျောင်း	ljáʊɴ
လျောင်းစက်	jáʊɴsɛʔ
လျှင်	l̥jɪ̀ɴ
လျှပ်	l̥jaʔ
လျှပ်စစ်	l̥jaʔsɪʔ
လျှပ်စစ်ကား	l̥jaʔsɪʔká
လျှပ်စစ်ဓာတ်	l̥jaʔsɪʔdaʔ
လျှပ်စီး	l̥jaʔsí
လျှာ	ʃà
လျှာနာခွာနာ	ʃànàkʰwànà
လျှာရည်	ʃàjì
လျှို့ဝှက်	ʃo̰ʍɛʔ
လျှော	ʃɔ́
လျှောက်	ʃaʊʔ
လွတ်	lʊʔ
လွတ်လပ်	lʊʔlaʔ
လွတ်လပ်ခွင့်	lʊʔlaʔkʰwɪ̰ɴ
လွတ်လပ်ရေးနေ့	lʊʔlaʔjénḛ
လွန်	lʊ̀ɴ
လွန်ဆွဲ	lʊ̀ɴsʰwɛ́
လွမ်း	lwáɴ
လွယ်	lwɛ̀
လွိုင်ကော်	lwàɪɴkɔ̀
လွှ	l̥wa̰
လွှစာ	l̥wa̰zà
လွှတ်	l̥ʊʔ
လွှတ်တော်	l̥ʊʔtɔ̀
လွှတ်ရုံးငါးရပ်	l̥ʊʔjóʊɴŋájaʔ
လွှမ်း	l̥wáɴ
လွှမ်းမိုး	l̥wáɴmó
လွှမ်းမိုးမှု	l̥wáɴmóm̥ṵ
လှ	l̥a̰
လှည့်	l̥ɛ̰
လှည်း	l̥ɛ́
လှည်းကူး	l̥íkú
လှပ	l̥a̰pa̰
လှပ်	l̥aʔ
လှပ်လှပ်	l̥aʔl̥aʔ
လှလှ	l̥a̰l̥a̰
လှိုင်း	l̥áɪɴ
လှိုင်းတို	l̥áɪɴdò
လှိုင်းလတ်	l̥áɪɴlaʔ
လှုပ်	l̥oʊʔ
လှုပ်ရှား	l̥oʊʔʃá
လှုပ်လှုပ်	l̥oʊʔl̥oʊʔ
လှုလှု	l̥ṵl̥ṵ
လှုံ	l̥òʊɴ
လှူ	l̥ù
လှေ	l̥è
လှေကား	l̥ègá
လှောက်	l̥aʊʔ
လှော်	l̥ɔ̀
လှော်ကား	l̥ɔ̀gá
လှေး	l̥é
လှဲ	l̥ɛ́
လှံ	l̥àɴ
ဝ	wa̰
ဝက်	wɛʔ
ဝက်ကြွပ်	wɛʔtɕʊʔ
ဝက်ခြံ	wɛʔtɕʰàɴ
ဝက်ဆီ	wɛʔsʰì
ဝက်ထီး	wɛʔtʰí
ဝက်ဘ်ဆိုဒ်	wɛʔbsʰaɪʔ
ဝက်မ	wɛʔma̰
ဝက်မလွတ်	wɛʔməlʊʔ
ဝက်မှင်ဘီး	wɛʔm̥ɪ̀ɴbí
ဝက်ဝံ	wɛʔwʊ̀ɴ
ဝက်သား	wɛʔθá
ဝက်သားချဉ်	wɛʔθátɕʰɪ̀ɴ
ဝက်သားတုတ်ထိုး	wɛʔθádoʊʔtʰó
ဝက်သားမျှစ်ချဉ်	wɛʔθám̥jɪʔtɕʰɪ̀ɴ
ဝက်အူ	wɛʔʔù
ဝက်အူချောင်း	wɛʔʔùdʑáʊɴ
ဝက်အူလှည့်	wɛʔʔùl̥ɛ̰
ဝင်	wɪ̀ɴ
ဝင်ကုန်	wɪ̀ɴgòʊɴ
ဝင်ငွေ	wɪ̀ɴŋwè
ဝင်ပေါက်	wɪ̀ɴbaʊʔ
ဝင်ရိုး	wɪ̀ɴjó
ဝင်း	wɪ́ɴ
ဝင်္ကပါ	wɪ̀ɴgəbà
ဝစီ	wəzì
ဝစီကံ	wəzìgàɴ
ဝစ်ရှင်နရီ	wɪʔʃɪ̀ɴnəɹì
ဝဆွဲ	wa̰sʰwɛ́
ဝဇီရာ	wəzìjà
ဝဋ်	wʊʔ
ဝဏ္ဏ	wʊ̀ɴna̰
ဝတီ	wədì
ဝတ္ထု	wʊʔtʰṵ
ဝတ်	wʊʔ
ဝတ်ကျောင်း	wʊʔtɕáʊɴ
ဝတ်စုံ	wʊʔsòʊɴ
ဝတ်ရည်	wʊʔjè
ဝတ်လုံ	tʰì
ဝနာ	wənà
ဝန်	wʊ̀ɴ
ဝန်ကြီး	wʊ̀ɴdʑí
ဝန်ကြီးချုပ်	wʊ̀ɴdʑídʑoʊʔ
ဝန်ကြီးချုပ်ကတော်	wʊ̀ɴdʑídʑoʊʔgədɔ̀
ဝန်ကြီးဌာန	wʊ̀ɴdʑítʰàna̰
ဝန်ကြီးအဖွဲ့	wʊ̀ɴdʑíʔəpʰwɛ̰
ဝန်ခံ	wʊ̀ɴkʰàɴ
ဝန်စည်စလယ်	wʊ̀ɴzìzəlɛ̀
ဝန်ထမ်း	wʊ̀ɴdáɴ
ဝန်ထောက်	wʊ̀ɴdaʊʔ
ဝန်ရှင်တော်	wʊ̀ɴʃɪ̀ɴdɔ̀
ဝပ်	waʔ
ဝပ်	wʊʔ
ဝမ်း	wʊ́ɴ
ဝမ်းကျ	wáɴdʑa̰
ဝမ်းစက်	wʊ́ɴsɛʔ
ဝမ်းဆက်	wʊ́ɴsʰɛʔ
ဝမ်းဆွဲ	wʊ́ɴzwɛ́
ဝမ်းတဖိုး	wʊ́ɴda̰pʰó
ဝမ်းနည်း	wáɴné
ဝမ်းဘဲ	wʊ́ɴbɛ́
ဝမ်းရောဂါ	wʊ́ɴjɔ́gà
ဝမ်းသာ	wʊ́ɴθà
ဝမ်းသွား	wʊ́ɴθwá
ဝယ်	wɛ̀
ဝယ်လင်တန်	wɛ̀lɪ̀ɴtàɴ
ဝရဏဗေဒ	wəjəna̰da̰bèda̰
ဝရန်တာ	wəɹàɴdà
ဝလာဟကမြင်း	wəlàhəka̰mjɪ́ɴ
ဝသန္တ	wa̰θàɴta̰
ဝသန်	wəθàɴ
ဝသုန္ဓရာ	wəθòʊɴdəɹà
ဝသုန္ဓရေ	wəθòʊɴdəɹè
ဝါ	wà
ဝါကျ	weɪʔtɕa̰
ဝါခေါင်	wàgàʊɴ
ဝါဂွမ်း	wàgwáɴ
ဝါစင်္ဂ	wàzɪ̀ɴga̰
ဝါဆို	wàsʰò
ဝါဆော	wàsʰɔ́
ဝါဏိဇ္ဇ	wàneɪʔza̰
ဝါဏိဇ္ဇပဋိပက္ခ	wàneɪʔza̰pədḭpɛʔkʰa̰
ဝါဏိဇ္ဇဗေဒ	wàneɪʔza̰bèda̰
ဝါတွင်း	wàdwɪ́ɴ
ဝါဒ	wàda̰
ဝါဒီ	wàdì
ဝါပ	wàba̰
ဝါယမ	wàjəma̰
ဝါယော	wàjɔ́
ဝါရှင်တန်	wàʃɪ̀ɴtàɴ
ဝါရှာ	wàʃà
ဝါသနာ	wàða̰nà
ဝါသနာရှင်	wàðənàʃɪ̀ɴ
ဝါး	wá
ဝိဇယပူရ	wḭzəja̰pùɹa̰
ဝိဇ္ဇာ	weɪʔzà
ဝိဇ္ဇာပညာ	weɪʔzàpjɪ̀ɴɲà
ဝိဇ္ဇာဘွဲ့	weɪʔzàbwɛ̰
ဝိညာဉ်	wèɪɴɲɪ̀ɴ
ဝိဏှု	wḭnù
ဝိတိုရိယ	wḭtòɹḭja̰
ဝိတ်	weɪʔ
ဝိတ်ချ	weɪʔtɕʰa̰
ဝိတ်လျှော့	weɪʔʃɔ̰
ဝိနည်း	wḭní
ဝိနိစ္ဆယ	wḭneɪʔsəja̰ja̰
ဝိပတ္တိတရားလေးပါး	wḭpaʔtḭtəjálébá
ဝိပါကဝဋ်	wḭbàga̰wʊʔ
ဝိပါက်	wḭbeɪʔ
ဝိပဿနာ	wḭpaʔθənà
ဝိပဿီ	wḭpətθì
ဝိပဿီဘုရား	wḭpaʔθìpʰəjá
ဝိဘတ်	wḭbaʔ
ဝိရောဓိ	wḭjɔ́dḭ
ဝိသေသ	wḭθèθa̰
ဝိသေသန	wḭθèθəna̰
ဝိသေသလက္ခဏာ	wḭθèθa̰lɛʔkʰənà
ဝိဟာရ	wḭhàja̰
ဝိုက်ချ	waɪʔtɕʰa̰
ဝိုင်	wàɪɴ
ဝိုင်ယာကြိုး	wàɪɴjàdʑó
ဝိုင်း	wáɪɴ
ဝိုးဝင်း	wówɪ́ɴ
ဝီကီပိဒိယ	wìkìpḭdḭja̰
ဝီကီပီးဒီးယား	wìkìpídíjá
ဝီစကီ	wìsəkì
ဝီစီ	wìsì
ဝီထိ	wìtʰḭ
ဝီရ	wìja̰
ဝီရိယ	wəɹḭja̰
ဝေဒနာ	wèdənà
ဝေယျာဝစ္စ	wèjàwʊʔsa̰
ဝေလ	wèla̰
ဝေလငါး	wèla̰ŋá
ဝေသာလီ	wèθàlì
ဝေဟင်	wèhɪ̀ɴ
ဝေါ	wɔ́
ဝေါဟာရ	wɔ́hàɹa̰
ဝေါဟာရဗေဒ	θaʔda̰bèda̰
ဝေး	wé
ဝေးကွာ	wékwà
ဝေဿ	wɪʔθa̰
ဝေဿဘူ	wètθəbù
ဝေဿဘူဘုရား	wètθa̰bùpʰəjá
ဝံ	wʊ̀ɴ
ဝံပုလွေ	wʊ̀ɴbəlwè
ဝံပုလွေငယ်	wʊ̀ɴpəlwèŋɛ̀
ဝံသ	wʊ̀ɴθa̰
ဝံသာနု	wʊ̀ɴθànṵ
ဝံသာနုရက္ခိတ	wʊ̀ɴθànṵɹɛʔkʰḭta̰
ဝှက်	ʍɛʔ
ဝှက်ဖဲ	ʍɛʔpʰɛ́
ဝှေးစေ့	ʍézḭ
သ	θa̰
သ	θə
သကာ	ðəgà
သကုဏဗေဒ	θa̰kṵna̰bèda̰
သက္ကတ	θɛʔkəta̰
သက္ကရာဇ်	θɛʔkəɹɪʔ
သက်ဆိုင်	θɛʔsʰàɪɴ
သက်တင်	θɛʔtɪ̀ɴ
သက်တော်စောင့်	θɛʔtɔ̀za̰ʊɴ
သက်တံ	θɛʔtàɴ
သက်သာ	θɛʔθà
သက်သေ	θɛʔθè
သက်ဦးဆံပိုင်	θɛʔʔúsʰàɴbàɪɴ
သကြား	ðədʑá
သကြားလုံး	ðədʑálóʊɴ
သခင်	θəkʰɪ̀ɴ
သခင်ဘုရား	θəkʰɪ̀ɴpʰəjá
သခွား	θəkʰwá
သခွားမသီး	θəkʰəma̰ðí
သင်	θɪ̀ɴ
သင်ကြား	θɪ̀ɴtɕá
သင်ခန်းစာ	θɪ̀ɴgáɴzà
သင်တုန်းဓား	θɪ̀ɴdóʊɴdá
သင်ပန်း	θɪ̀ɴbáɴ
သင်ပေါင်း	θɪ̀ɴbáʊɴ
သင်း	θɪ́ɴ
သင်းဝင်	θɪ́ɴwɪ̀ɴ
သင်္ကဒူး	θɪ́ɴgədú
သင်္ကန်း	θɪ̀ɴgáɴ
သင်္ကေတ	θɪ̀ɴkèta̰
သင်္ကြန်	θɪ́ɴtɕàɴ
သင်္ကြန်စာ	θɪ́ɴdʑàɴzà
သင်္ကြန်ထမင်း	ðədʑàɴtʰəmɪ́ɴ
သင်္ကြန်ပန်း	θɪ́ɴdʑàɴpáɴ
သင်္ကြန်မိုး	θɪ̀ɴdʑàɴmó
သင်္ချာ	θɪ̀ɴtɕʰà
သင်္ချိုင်း	θɪ̀ɴdʑáɪɴ
သင်္ဂဟ	θɪ̰ɴgəha̰
သင်္ဂဟတရားလေးပါး	θɪ̀ɴga̰ha̰ta̰jálépá
သင်္ဘော	θɪ́ɴbɔ́
သင်္ဘောကြမ်း	θɪ̀ɴbɔ́dʑáɴ
သင်္ဘောဆိပ်	θɪ̀ɴbɔ́zeɪʔ
သင်္ဘောမညှိုးပန်း	θɪ́ɴbɔ́məɲ̊óbáɴ
သင်္ဘောသား	θɪ̀ɴbɔ́ðá
သင်္ဘောသီး	θɪ́ɴbɔ́ðí
သင်္ဘောသီးထောင်း	θɪ̀ɴbɔ́ðítʰáʊɴ
သင်္ဘောသီးသုပ်	θɪ̀ɴbɔ́θíθoʊʔ
သင်္သကရိုက်	θɪ̀ɴθəkəɹaɪʔ
သစ္စာ	θɪʔsà
သစ္စာဖောက်	θɪʔsàpʰaʊʔ
သစ္စာရှိ	θɪʔsàʃḭ
သစ္စာလေးပါး	θɪʔsàlépá
သစ်	θɪʔ
သစ်ကတိုး	θɪʔgədó
သစ်ကုလားအုတ်	θɪʔkələʔoʊʔ
သစ်ကျုတ်	θɪʔtɕoʊʔ
သစ်ကြံပိုး	θɪʔdʑəbó
သစ်ခွ	θɪʔkʰwa̰
သစ်ခွရည်	θɪʔkʰwa̰jì
သစ်စေး	sɪʔsí
သစ်ဆိမ့်	θɪʔsʰḛɪɴ
သစ်တို	θɪʔtò
သစ်တော	θɪʔtɔ́
သစ်နက်	θɪʔnɛʔ
သစ်ပင်	θɪʔpɪ̀ɴ
သစ်ပုပ်	θɪʔpoʊʔ
သစ်ဖြူ	θɪʔpʰjù
သစ်သစ်	θɪʔθɪʔ
သစ်သီး	θɪʔθí
သစ်သီးရည်	θɪʔθíjè
သဇင်	ðəzɪ̀ɴ
သဉ္ဇာ	θɪ̀ɴzà
သဉ္ဇာလီ	θɪ̀ɴzàlì
သည့်	tθḭ
သည်	θè
သည်မှာ	ðìm̥à
သည်း	θí
သည်းခြေ	θídʑè
သဏ္ဌာန်	θədàɴ
သတင်း	ðədɪ́ɴ
သတင်းစာ	ðədɪ́ɴzà
သတင်းစာဆရာ	ðədɪ́ɴzàsʰəjà
သတင်းထောက်	ðədɪ́ɴdaʊʔ
သတင်းပို့	ðədɪ́ɴpo̰
သတိ	ðədḭ
သတိထား	ðədḭtʰá
သတို့သမီး	ðədo̰θəmí
သတို့သား	ðədo̰θá
သတ္တ	θaʔta̰
သတ္တဂံ	θaʔtəgàɴ
သတ္တဗေဒ	θaʔta̰bèda̰
သတ္တမ	θaʔtəma̰
သတ္တဝါ	θaʔtəwà
သတ္တသိန္ဓု	θaʔta̰θèɪɴdṵ
သတ္တိ	θaʔtḭ
သတ္တု	θaʔtṵ
သတ္တုစပ်	θaʔtṵzaʔ
သတ္တုတွင်း	θaʔtṵdwɪ́ɴ
သတ္တုဗေဒ	θaʔtṵbèda̰
သတ္တုရိုင်း	θaʔtṵjáɪɴ
သတ္ထန္တရကပ်	θaʔtʰàɴtəɹa̰kaʔ
သတ်	θaʔ
သတ်ဖြတ်	θaʔpʰjaʔ
သဒ္ဒဗေဒ	θaʔda̰bèda̰
သဒ္ဒါ	ðədà
သဒ္ဒါဆယ်ပါး	ðədàsʰɛ̀bá
သဒ္ဒါရုံ	θaʔdàjòʊɴ
သဒ္ဓါ	θàddà
သဒ္ဓါကြေး	θədàtɕé
သနပ်	θənaʔ
သနပ်ခါး	θənəkʰá
သနားတော်မူ	θənádɔ̀mù
သန့်ရှင်း	θa̰ɴʃɪ́ɴ
သန့်ရှင်းရေးသမား	θa̰ɴʃɪ́ɴjéðəmá
သန္တာ	θàɴdà
သန္ဓေ	θàɴdè
သန္ဓေဗေဒ	θàɴdèbèda̰
သန္ဓေသား	ðədèðá
သန်ကောင်	θàɴgàʊɴ
သန်တူ	θàɴtù
သန်လျက်	θàɴjɛʔ
သန်လျင်	θəɲɪ̀ɴ
သန်လျင်း	θàɴləjɪ́ɴ
သန်လျင်းချိတ်	θàɴjɪ́ɴdʑeɪʔ
သန်း	θáɴ
သန်းခေါင်	ðəgàʊɴ
သန်းခေါင်ယံ	ðəgàʊɴjàɴ
သပိတ်	ðəbeɪʔ
သပ်	θaʔ
သပြု	ðəbjṵ
သပြေ	ðəbjè
သပြေတိုင်	ðəbjèdàɪɴ
သဘက်ခါ	θəbɛʔkʰà
သဘင်	θəbɪ̀ɴ
သဘာပတိ	θəbàpətḭ
သဘာဝ	ðəbàwa̰
သဘာဝတ္ထဗေဒ	θəbàwʊʔtʰa̰bèda̰
သဘော	ðəbɔ́
သဘောတူ	ðəbɔ́tù
သမ	θəma̰
သမက်	θəmɛʔ
သမဂ္ဂ	θa̰mɛʔga̰
သမင်	θəmɪ̀ɴ
သမင်မ	θəmɪ̀ɴma̰
သမတ	θəməda̰
သမယ	θəməja̰
သမဝါယမ	θəma̰wàjəma̰
သမာသမတ်	θəmàθəmaʔ
သမား	θəmá
သမိန်	θəmèɪɴ
သမိုင်း	θəmáɪɴ
သမိုင်းမတိုင်မီခေတ်	θəmáɪɴmətàɪɴmìkʰɪʔ
သမီး	θəmí
သမီးတော်	θa̰mítɔ̀
သမုဒ္ဒရာ	θəmoʊʔdəjà
သမ္ဗန္ဓ	θàɴbàɴda̰
သမ္မတ	θəməda̰
သမ္မတကတော်	θəma̰da̰gədɔ̀
သမ္မတနိုင်ငံ	θəməda̰nàɪɴŋàɴ
သမ္မာကျမ်း	θəmàtɕáɴ
သမ်း	θáɴ
သယောင်း	θəjáʊɴ
သယံဇာတ	θəjàɴzàta̰
သယ်	θɛ̀
သယ်ရင်း	θɛ̀jɪ́ɴ
သရ	θəɹa̰
သရက်	θəjɛʔ
သရက်ရွက်	θəjɛʔjwɛʔ
သရက်သီးပူတင်း	θəjɛʔθípùdɪ́ɴ
သရက်သီးသနပ်	θəjɛʔθíθa̰naʔ
သရဏဂုံသုံးပါး	θəɹənəgòʊɴθóʊɴbá
သရဏင်္ကရာ	θəɹənɪ̀ɴkəɹà
သရဏင်္ကရာဘုရား	θəɹənɪ̀ɴkəɹàpʰəjá
သရဖီ	θəɹəpʰì
သရဖူ	θəɹəpʰù
သရီရ	θəɹìɹa̰
သရုပ်	θəjoʊʔ
သရုပ်ဆောင်	θəjoʊʔsʰàʊɴ
သရုပ်ဖော်	θəjoʊʔpʰɔ̀
သရော	θəjɔ́
သရော်	θəjɔ̀
သရော်စာ	θəjɔ̀zà
သရဲ	θəjɛ́
သလား	θa̰lá
သလိပ်	θəleɪʔ
သလုံး	θəlóʊɴ
သလဲသီး	θəlɛ́θí
သလွဲ	θəlwɛ́
သဝဏ်လွှာ	θəwʊ̀ɴl̥wà
သာဂူ	θàgù
သာဂူပူတင်း	θàgùpùdɪ́ɴ
သာဂူပြင်	θàgùbjɪ̀ɴ
သာဓက	θàda̰ka̰
သာဓု	θàdṵ
သာမဏေ	θàmənè
သာမိုမီတာ	θàmòmìtà
သာယာ	θàjà
သာယာဝတီ	θàjàwədì
သာရကာ	θàɹəkà
သာရိပုတ္တရာ	θàjḭpoʊʔtəjà
သာလိကာ	θàlḭkà
သာဝက	θàwəka̰
သာဝတ္ထိ	θàwʊʔtʰḭ
သာသနာ	θàðənà
သာသနာ့အာဇာနည်	θàθəna̰ʔàzànì
သား	θá
သားကြီး	θádʑí
သားတော်	θátɔ̀
သားပိုက်ကောင်	θábaɪʔkàʊɴ
သားပျက်	θápjɛʔ
သားမြီးယပ်	θámjíjaʔ
သားရေ	θəjè
သားလောင်း	θáláʊɴ
သားလျှော	θáʃɔ́
သားလှောင်	θál̥àʊɴ
သားသတ်ရုံ	θáðaʔjòʊɴ
သားသတ်သမား	θáθaʔðəmá
သားအိမ်	θəʔèɪɴ
သားအိမ်ခေါင်း	θəʔèɪɴgáʊɴ
သားအိမ်လမ်းကြောင်း	θəʔèɪɴláɴdʑáʊɴ
သားဥ	θáʔṵ
သားဥအိမ်	θáʔṵʔèɪɴ
သိ	θḭ
သိကြား	ðədʑá
သိခီဘုရား	θḭkʰìpʰəjá
သိင်္ဂီ	θèɪɴgì
သိထိလ	θḭtʰḭla̰
သိဒ္ဓတ္ထ	θeɪʔdaʔtʰa̰
သိဒ္ဓတ္ထဘုရား	θìddaʔtʰa̰pʰəjá
သိဒ္ဓတ်မင်း	θeɪʔdaʔmɪ́ɴ
သိဒ္ဓိ	θeɪʔdḭ
သိန္ဓု	θèɪɴdṵ
သိန်	θèɪɴ
သိန်း	θéɪɴ
သိပ္ပံ	θeɪʔpàɴ
သိပ္ပံဘွဲ့	θeɪʔpàɴbwɛ̰
သိပ်	θeɪʔ
သိမ်	θèɪɴ
သိရှိ	θḭʃḭ
သိဝ	θḭwa̰
သိဟ်	θèɪɴ
သိုက်	θaɪʔ
သို့ပေမဲ့	ðo̰bèmɛ̰
သို့မဟုတ်	ðo̰məhoʊʔ
သို့ရာတွင်	ðo̰jàdwɪ̀ɴ
သို့သော်	ðo̰ðɔ̀
သိုး	θó
သိုးကလေး	θókʰəlé
သိုးဆောင်း	θósʰáʊɴ
သိုးထိန်း	θódéɪɴ
သိုးထီး	θódí
သိုးမ	θóma̰
သိုးမွေး	θómwé
သိုးအုပ်	θóʔoʊʔ
သီချင်း	θətɕʰɪ́ɴ
သီဂိရိယ	θìgḭɹḭja̰
သီတဂူ	θìdəgù
သီတင်း	ðədɪ́ɴ
သီတင်းကျွတ်	ðədɪ́ɴdʑʊʔ
သီတင်းသီလ	ðədɪ́ɴθìla̰
သီတာ	θìdà
သီတာဒေဝီ	θìdàdèwì
သီရိ	θìɹḭ
သီရိလင်္ကာ	θìɹḭlɪ̀ɴkà
သီလ	θìla̰
သီလရှင်	θìla̰ʃɪ̀ɴ
သီဟ	θìha̰
သီဟသူ	θìha̰θù
သီဟိုဠ်	θìhò
သီဟိုဠ်စေ့	θìhòzḭ
သီဟိုဠ်သရက်	θìhòθəjɛʔ
သီအိုရီ	θìʔòɹì
သီး	θí
သီးစုံချဉ်ရည်	θízòʊɴtɕʰɪ̀ɴjì
သီးပင်	θíbɪ̀ɴ
သီးမွှေး	θím̥wé
သီးသီး	θíðí
သု	θṵ
သုက်	θoʊʔ
သုက်ကောင်	θoʊʔkàʊɴ
သုက်ပိုး	θoʊʔpó
သုက်ရည်	θoʊʔjè
သုခ	θṵkʰa̰
သုခေါဒယ	θṵkʰɔ́dəja̰
သုဂတိ	θṵgədḭ
သုဇာတဘုရား	θṵzàta̰pʰəjá
သုည	θùɲɲa̰
သုတ	θṵta̰
သုတေသန	θṵtèθəna̰
သုတေသီ	θṵtèθì
သုတ်	θoʊʔ
သုတ်သင်	θoʊʔθɪ̀ɴ
သုဒ္ဒ	θoʊʔda̰
သုဒ္ဒကိန်း	θoʊʔda̰kéɪɴ
သုဒ္ဒကြိယာ	θoʊʔda̰kəɹḭjà
သုဒ္ဓေါဒန	θùddɔ́dəna̰
သုဓမ္မပူရ	θṵdəma̰pùɹa̰
သုဓမ္မသိင်္ဂီ	θṵdàɴma̰θèɪɴgì
သုဓာ	θoʊʔdà
သုန္ဒြေ	θòʊɴdɹè
သုပ်	θoʊʔ
သုဘူတိ	θṵbùtḭ
သုမန	θṵməna̰
သုမနဘုရား	θṵməna̰pʰəjá
သုမေဓာ	θṵmèdà
သုမေဓာဘုရား	θṵmèdàpʰəjá
သုဝဏ္ဏ	θṵwʊ̀ɴna̰
သုဝဏ္ဏဘူမိ	θṵwʊ̀ɴna̰bùmḭ
သုသာန်	θoʊʔθàɴ
သုံး	θóʊɴ
သုံးစွဲ	θóʊɴswɛ́
သုံးစွဲသူ	θóʊɴswɛ́ðù
သုံးဆယ်	θóʊɴsʰɛ̀
သုံးဆောင်	θóʊɴsʰàʊɴ
သုံးပွင့်ဆိုင်	θóʊɴbwɪ̰ɴsʰàɪɴ
သုံးလ	θóʊɴla̰
သူ	θù
သူကောင်	θùgàʊɴ
သူကောင်တင်	θùgàʊɴdɪ̀ɴ
သူကောင်း	θùgáʊɴ
သူကောင်းပြု	θùgáʊɴpjṵ
သူကောင်းမြှောက်	θùgáʊɴm̥jaʊʔ
သူကောင်းသား	θùgáʊɴðá
သူကျက်	θùdʑɛʔ
သူကြီး	θùdʑí
သူကြွယ်	θùtɕwɛ̀
သူခိုး	θəkʰó
သူငယ်	θəŋɛ̀
သူငယ်ချင်း	θəŋɛ̀dʑɪ́ɴ
သူငယ်စာ	θùŋɛ̀zà
သူငယ်တန်း	θùŋɛ̀dáɴ
သူငယ်မ	θəŋɛ̀ma̰
သူစိမ်း	ðəzéɪɴ
သူစိမ်းတစ်ရံဆံ	ðəzéɪɴtəjàɴzàɴ
သူဆင်းရဲ	θùsʰɪ́ɴjɛ́
သူဇာ	θùzà
သူဌေး	θətʰé
သူတကာ	θùdəgà
သူတစ်ခွန်းငါတစ်ခွန်း	θùtəkʰʊ́ɴŋàtəkʰʊ́ɴ
သူတစ်ထူး	θùtətʰú
သူတစ်ပါး	θùdəbá
သူတစ်ပြန်ငါတစ်ပြန်	θùdəbjàɴŋàdəbjàɴ
သူတစ်လူငါတစ်မင်း	θùtəlùŋàtəmɪ́ɴ
သူတို့	θùdo̰
သူတောင်းစား	ðədáʊɴzá
သူတော်	θùdɔ̀
သူတော်ကောင်း	θùdɔ̀gáʊɴ
သူတော်စင်	θùdɔ̀zɪ̀ɴ
သူတော်သူမြတ်	θùdɔ̀θùmjaʔ
သူနာ	θùnà
သူနာတင်ကား	θùnàdɪ̀ɴká
သူနာတင်ယာဉ်	θùnàtɪ̀ɴjɪ̀ɴ
သူနာပြု	θùnàbjṵ
သူနိုင်ငါညှဉ်းလုပ်	θùnàɪɴŋàɲ̊ɪ́ɴloʊʔ
သူပုန်	ðəbòʊɴ
သူပုန်ထ	ðəbòʊɴtʰa̰
သူပုန်သူကန်	ðəbəðùgàɴ
သူပြောငါပြော	θùpjɔ́ŋàpjɔ́
သူဖုန်းစား	θùpʰóʊɴsá
သူမ	θùma̰
သူမသာကိုယ်မသာ	θùməθàkòjməθà
သူမသာငါမသာ	θùməθàŋàməθà
သူမိုက်	θùmaɪʔ
သူများ	θùmjá
သူများနည်းတူ	θùmjánítù
သူယုတ်မာ	θùjoʊʔmà
သူယောင်	θùjàʊɴ
သူယောင်မယ်	θùjàʊɴmɛ̀
သူရ	θùja̰
သူရကန်	θùɹəkàɴ
သူရင်းငှား	θəjɪ́ɴŋ̊á
သူရင်းတိုင်	θəjɪ́ɴdàɪɴ
သူရသတ္တိ	θùja̰θaʔtḭ
သူရိန်	θùjèɪɴ
သူရိယ	θùɹḭja̰
သူရိယမာသ	θùɹḭja̰màθa̰
သူရဲ	θəjɛ́
သူရဲကောင်း	θùjɛ́gáʊɴ
သူရဲကြီး	θùjɛ́dʑí
သူရဲကြီးအလံ	θùjɛ́dʑíʔəlàɴ
သူရဲခို	θəjɛ́kʰò
သူရဲပြေး	θəjɛ́pjé
သူရဲဘောကြောင်	θəjɛ́bɔ́dʑàʊɴ
သူရဲဘောနည်း	θəjɛ́bɔ́ní
သူရဿတီ	θùɹa̰θətì
သူလိုငါလို	θùlòŋàlò
သူလျှို	ðəʃò
သူသူငါငါ	θùθùŋàŋà
သူသေ	θùθè
သူဟောင်းစကား	θùháʊɴzəgá
သူအို	θùʔò
သူ့	θṵ
သေ	θè
သေခြင်း	θèdʑɪ́ɴ
သေတ္တာ	θɪʔtà
သေနတ်	θənaʔ
သေနာပတိ	θènàpətḭ
သော	θɔ́
သောက္ကတဲ	θaʊʔkətɛ́
သောက်	θaʊʔ
သောက်တော်ခွက်	θaʊʔdɔ̀kʰwɛʔ
သောကြာ	θaʊʔtɕà
သောကြာဂြိုဟ်	θaʊʔtɕàdʑò
သောင်း	θáʊɴ
သောင်းသောင်း	θáʊɴðáʊɴ
သောတ	θɔ́ta̰
သောတရှင်	θɔ́ta̰ʃɪ̀ɴ
သောဘိတ	θɔ́bḭta̰
သောဘိတဘုရား	θɔ́bḭta̰pʰəjá
သောမနဿ	θɔ́mənaʔθa̰
သောသော	θɔ́ðɔ́
သော့	θɔ̰
သော့တံ	θɔ̰dàɴ
သော်	ðɔ̀
သော်တာ	θɔ̀dà
သေး	θé
သေးပေါက်	θépaʊʔ
သဲ	θɛ́
သဲကန္တာရ	θégàɴdàja̰
သဲကျောက်	θɛ́dʑaʊʔ
သဲနာရီ	θɛ́nàjì
သဲ့သဲ့	θɛ̰ðɛ̰
သံ	θàɴ
သံကြိုး	θàɴdʑó
သံကြိုးစာ	θàɴdʑózà
သံကြွပ်	θàɴdʑʊʔ
သံခေတ်	θàɴkʰɪʔ
သံချပ်	θədʑaʔ
သံချေး	θàɴdʑí
သံခွာ	θàɴkʰwà
သံဃာ	θàɴgà
သံစုံတီးဝိုင်း	θàɴzòʊɴtíwáɪɴ
သံတမန်	θàɴtəmàɴ
သံတော်ဆင့်	θàɴdɔ̀zɪ̰ɴ
သံတွဲ	θàɴdwɛ́
သံပန်း	θàɴbáɴ
သံပရာ	θàɴbəjà
သံပရို	θàɴba̰jò
သံပေါက်	θàɴbaʊʔ
သံပြိုင်	θàɴbjàɪɴ
သံဖြူ	θàɴbjù
သံမဏိ	θàɴmənḭ
သံယောဇဉ်	θàɴjɔ́zɪ̀ɴ
သံရုံး	θàɴjóʊɴ
သံလမ်း	θàɴláɴ
သံလမ်းရထား	θàɴláɴjətʰá
သံလိုက်	θàɴlaɪʔ
သံလိုက်စက်ကွင်း	θàɴlaɪʔsɛʔkwɪ́ɴ
သံလွင်	θàɴlwɪ̀ɴ
သံဝါသ	θàɴwàθa̰
သံဝေဂ	θàɴwèga̰
သံသယ	θàɴθəja̰
သံအမတ်	θàɴʔəmaʔ
သံ့သံ့	θa̰ɴða̰ɴ
သျှင်	ʃɪ̀ɴ
သျှမ်း	ʃáɴ
သျှောင်	jàʊɴ
သွင်သွင်	θwɪ̀ɴðwɪ̀ɴ
သွင်း	θwɪ́ɴ
သွင်းကုန်	θwɪ́ɴgòʊɴ
သွတ်	θʊʔ
သွတ်သွတ်	θʊʔθʊʔ
သွန်	θʊ̀ɴ
သွန်းသွန်း	θʊ́ɴðʊ́ɴ
သွပ်	θʊʔ
သွား	θwá
သွားကြားထိုးတံ	θwádʑátʰódàɴ
သွားတိုက်ဆေး	θwádaɪʔsʰé
သွားပွတ်တံ	ðəbʊʔtàɴ
သွားဖုံး	θəpʰóʊɴ
သွားရည်	θəjì
သွေ	θwè
သွေ့	θwḛ
သွေး	θwé
သွေးကင်ဆာ	θwékɪ̀ɴsʰà
သွေးကြော	θwédʑɔ́
သွေးကြောမျှင်	θwédʑɔ́m̥jɪ̀ɴ
သွေးတိုးရောဂါ	θwétójɔ́gà
သွေးပေါင်	θwépàʊɴ
သွေးပေါ်	θwépɔ̀
သွေးအုပ်စု	θwéʔoʊʔsṵ
ဟ	ha̰
ဟင့်အင်း	hɪ̰ɴʔɪ́ɴ
ဟင်း	hɪ́ɴ
ဟင်းခါး	hɪ́ɴgá
ဟင်းရည်	hɪ́ɴjè
ဟင်းသီးဟင်းရွက်	hɪ́ɴðíhɪ́ɴjwɛʔ
ဟင်္သာ	hɪ́ɴθà
ဟင်္သာတ	hɪ̀ɴθəta̰
ဟင်္သာတာရာ	hɪ̀ɴθàtàjà
ဟစ်တလာ	hɪʔtəlà
ဟတ်ဇ်	haʔ
ဟထိုး	ha̰tʰó
ဟနူမာန်	hənùmàn
ဟန်ဂေရီ	hàɴgèɹì
ဟန်နီ	hàɴnì
ဟန်လင်း	hàɴlɪ́ɴ
ဟမ်ဘာဂါ	hàɴbàgà
ဟယ်လီကော့ပတာ	hɛ̀lìkɔ̰pətà
ဟယ်လ်ဆင်ကီ	hɛ̀lsʰɪ̀ɴkì
ဟရိဘုဉ္ဇ	həɹḭbòʊɴza̰
ဟလဝါ	ha̰ləwà
ဟာနွိုင်း	hànwáɪɴ
ဟာဗားနား	hàbáná
ဟာသ	hàθa̰
ဟားခါး	hákʰá
ဟိတ်	heɪʔ
ဟိန္ဒီ	hèɪɴdì
ဟိန္ဒူ	hèɪɴdù
ဟိမဝန္တာ	hḭma̰wʊ̀ɴtà
ဟိမာလယ	hḭmàləja̰
ဟို	hò
ဟိုက်ဒရိုဂျင်	haɪʔdəɹòdʑɪ̀ɴ
ဟိုင်းအီနာ	háɪɴʔìnà
ဟိုတယ်	hòtɛ̀
ဟိုမှာ	hòm̥à
ဟိုဟာ	hòhà
ဟီ	hì
ဟီနယာန	hìna̰jàna̰
ဟီလီယမ်	hìlìjàɴ
ဟုတ်	hoʊʔ
ဟုတ်ကဲ့	hoʊʔkɛ̰
ဟုတ်တာပေါ့	hoʊʔtàpɔ̰
ဟုတ်လား	hoʊʔlá
ဟူ	hù
ဟူးရား	hújá
ဟူးဟူး	húhú
ဟေတီ	hètì
ဟေတုပစ္စယော	hètṵpɪʔsa̰jɔ́
ဟေမန္တ	hèmàɴta̰
ဟေမန်	hèmàɴ
ဟေမာ	hèmà
ဟော	hɔ́
ဟောက်	haʊʔ
ဟောင်	hàʊɴ
ဟောင်ကောင်	hàʊɴkàʊɴ
ဟောင်း	háʊɴ
ဟော်	hɔ̀
ဟော်ကီ	hɔ̀kì
ဟော်တယ်	hɔ̀tɛ̀
ဟော်လန်	hɔ̀làɴ
ဟဲလို	hɛ́lò
ဟံသာဝတီ	hàɴθàwədì
ဟွန်ဒူးရပ်စ်	hʊ̀ɴdúɹaʔs
ဟွန်း	hʊ́ɴ
ဠ	la̰
ဠကြီး	la̰tɕí
အ	ʔa̰
အက	ʔəka̰
အကယ်၍	ʔəkɛ̀jwḛ
အကာ	ʔəkà
အကိတ်	ʔəkeɪʔ
အကို	ʔəkò
အကိုင်း	ʔəkáɪɴ
အကုန်	ʔəkòʊɴ
အကုသိုလ်	ʔa̰kṵðò
အကူ	ʔəkù
အကောက်	ʔəkaʊʔ
အကောက်ခွန်	ʔəkaʊʔkʰʊ̀ɴ
အကောက်ဆိပ်	ʔəkaʊʔsʰeɪʔ
အကောင့်	ʔəka̰ʊɴ
အကောင်	ʔəkàʊɴ
အကော်ဒီယံ	ʔəkɔ̀dìjàɴ
အက္ခရာ	ʔɛʔkʰəjà
အက္ခရာသင်္ချာ	ʔɛʔkʰa̰jàθɪ̀ɴtɕʰà
အက်	ʔɛʔ
အက်စစ်	ʔɛʔsɪʔ
အက်စတိုးနီးယား	ʔɛʔsətóníjá
အက်တမ်	ʔɛʔtàɴ
အက်ရှ်ဂါဘတ်	ʔɛʔʃgàbaʔ
အကျဉ်း	ʔətɕɪ́ɴ
အကျဉ်းထောင်	ʔətɕɪ́ɴdàʊɴ
အကျဉ်းသား	ʔətɕɪ́ɴðá
အကျည်း	ʔətɕí
အကျည်းတန်	ʔətɕítàɴ
အကျပ်အတည်း	ʔətɕaʔʔəté
အကျယ်	ʔətɕɛ̀
အကျိတ်	ʔətɕeɪʔ
အကျိုး	ʔətɕó
အကျိုးကျေးဇူး	ʔətɕótɕézú
အကျော်	ʔətɕɔ̀
အကျော်ဇေယျ	ʔətɕɔ̀zèja̰
အကြမ်းဖက်ဝါဒ	ʔətɕáɴpʰɛʔwàda̰
အကြမ်းဖက်သမား	ʔətɕáɴpʰɛʔθəmá
အကြမ်းရည်	ʔətɕáɴjì
အကြောက်	ʔətɕaʊʔ
အကြောင်း	ʔətɕáʊɴ
အကြောမျှင်	ʔətɕɔ́m̥jɪ̀ɴ
အကြော်	ʔa̰tɕɔ̀
အကြေး	ʔətɕé
အကြံ	ʔətɕàɴ
အကြံပေးချက်	ʔətɕàɴpédʑɛʔ
အကြွေး	ʔətɕwé
အကြွေးဝယ်ကတ်ပြား	ʔətɕwéwɛ̀kaʔpjá
အကွ	ʔəkwa̰
အကွာအဝေး	ʔəkwàʔəwé
အခန်း	ʔəkʰáɴ
အခမဲ့	ʔəkʰa̰mɛ̰
အခါတစ်ပါး	ʔəkʰàdəbá
အခိုး	ʔəkʰó
အခု	ʔəkʰṵ
အခုံး	ʔəkʰóʊɴ
အခေါက်	ʔəkʰaʊʔ
အချက်	ʔətɕʰɛʔ
အချင်း	ʔətɕʰɪ́ɴ
အချင်းဝက်	ʔətɕʰɪ́ɴwɛʔ
အချစ်	ʔətɕʰɪʔ
အချဉ်တည်	ʔətɕʰɪ̀ɴtɛ̀
အချဉ်ဖောက်	ʔətɕʰɪ̀ɴpʰaʊʔ
အချပ်	ʔətɕʰaʔ
အချိတ်	ʔətɕʰeɪʔ
အချိန်	ʔətɕʰèɪɴ
အချိန်စာရင်း	ʔətɕʰèɪɴsəjɪ́ɴ
အချို	ʔətɕʰò
အချိုပွဲ	ʔətɕʰòbwɛ́
အချိုမှုန့်	ʔətɕʰòm̥o̰ʊɴ
အချို့	ʔətɕʰo̰
အချိုး	ʔətɕʰó
အချို‌ခြောက်	ʔətɕʰòdʑaʊʔ
အချုပ်ခန်း	ʔətɕʰoʊʔkʰáɴ
အချုပ်အခြာအာဏာ	ʔətɕʰoʊʔʔətɕʰàʔànà
အချွဲ	ʔətɕʰwɛ́
အခြင်း	ʔətɕʰɪ́ɴ
အခြား	ʔətɕʰá
အခြေ	ʔətɕʰè
အခြောက်	ʔətɕʰaʊʔ
အခွင့်	ʔəkʰwɪ̰ɴ
အခွင့်ထူးခံ	ʔəkʰwɪ̰ɴtʰúgàɴ
အခွင့်အရေး	ʔəkʰwɪ̰ɴʔəjé
အခွန်	ʔəkʰʊ̀ɴ
အခွန်ထမ်း	ʔəkʰʊ̀ɴdáɴ
အခွေ	ʔəkʰwè
အခွံ	ʔəkʰʊ̀ɴ
အခွံမာသီး	ʔəkʰʊ̀ɴmàðí
အဂတိ	ʔa̰gədḭ
အဂ္ဂမဟာပဏ္ဍိတ	ʔɛʔga̰məhàpàɴdḭta̰
အဂ္ဂမဟာသေနာပတိ	ʔɛʔga̰məhàθènàpətḭ
အဂ္ဂမဟေသီ	ʔɛʔga̰məhèθì
အငတ်	ʔəŋaʔ
အင်ကြင်း	ʔɪ̀ɴdʑɪ́ɴ
အင်ဂိုလာ	ʔɪ̀ɴgòlà
အင်ဂျင်	ʔɪ̀ɴdʑɪ̀ɴ
အင်ဂျင်နီယာ	ʔɪ̀ɴdʑɪ̀ɴnìjà
အင်တာနက်	ʔɪ̀ɴtànɛʔ
အင်တာဗျူး	ʔɪ̀ɴtəbjú
အင်ဒိုချိုင်းနား	ʔɪ̀ɴdòtɕʰáɪɴná
အင်ဒိုနီးရှား	ʔɪ̀ɴdòníʃá
အင်ဒိုရာ	ʔɪ̀ɴdòɹà
အင်ပါယာ	ʔɪ̀ɴpàjà
အင်း	ʔɪ́ɴ
အင်းကျီ	ʔɪ́ɴdʑì
အင်းစိန်	ʔɪ́ɴsèɪɴ
အင်းဆက်	ʔɪ́ɴsʰɛʔ
အင်းလေး	ʔɪ́ɴlé
အင်းလျား	ʔɪ́ɴjá
အင်းဝ	ʔəwa̰
အင်းဝ	ʔɪ́ɴwa̰
အင်းသား	ʔɪ́ɴðá
အင်္ကျီ	ʔɪ́ɴdʑì
အင်္ကျီတို	ʔéɪɴdʑìtò
အင်္ကျီရှည်	ʔéɪɴdʑìʃè
အင်္ဂတေ	ʔɪ̀ɴgədè
အင်္ဂလန်	ʔɪ̀ɴgəlàɴ
အင်္ဂလိပ်	ʔɪ̀ɴgəleɪʔ
အင်္ဂါ	ʔɪ̀ɴgà
အင်္ဂါဂြိုဟ်	ʔɪ̀ɴgàdʑò
အင်္ဂါဇာတ်	ʔɪ̀ɴgàzaʔ
အငြိမ့်	ʔəɲḛɪɴ
အငြိမ့်တီးမျိုး	ʔa̰ɲḛɪɴtímjó
အငွေ့	ʔa̰ŋwḛ
အစ	ʔəsa̰
အစက်	ʔəsɛʔ
အစဉ်	ʔəsɪ̀ɴ
အစဉ်ထာဝရ	ʔəsətʰəɹa̰
အစည်းအရုံး	ʔəsíʔəjóʊɴ
အစည်းအဝေး	ʔəsíʔəwé
အစပ်	ʔəsaʔ
အစမ်း	ʔəsáɴ
အစာ	ʔəsà
အစာပြွန်	ʔəsàpjʊ̀ɴ
အစား	ʔəsá
အစားလက္ခဏာ	ʔəsálɛʔkʰənà
အစားအစာ	ʔəsáʔəsà
အစိမ်း	ʔəséɪɴ
အစိမ်းမှုန့်	ʔəsèɪɴtɪ̀ɴm̥o̰ʊɴ
အစိုးရ	ʔəsója̰
အစီရင်	ʔəsìjɪ̀ɴ
အစီရင်ခံ	ʔəsìjɪ̀ɴkʰàɴ
အစီရင်ခံစာ	ʔəsìjɪ̀ɴkʰàɴzà
အစီအစဉ်	ʔəsìʔəsɪ̀ɴ
အစီအလျဉ်	ʔəsìʔəljɪ̀ɴ
အစု	ʔəsṵ
အစုရှင်	ʔəsṵʃɪ̀ɴ
အစုံအစုံ	ʔəsòʊɴʔəsòʊɴ
အစေအပါး	ʔəsèʔəpá
အစောင့်	ʔəsa̰ʊɴ
အစေ့	ʔəsḭ
အစ္စရေး	ʔɪʔzəɹé
အစ္စလမ်	ʔɪʔsəlàɴ
အစ္စလာမာဘတ်	ʔɪʔsəlàmàbaʔ
အစ်	ʔɪʔ
အစ်ကို	ʔəkò
အစ်မ	ʔəma̰
အစွန်း	ʔəsʊ́ɴ
အဆင့်	ʔəsʰɪ̰ɴ
အဆင်ပြေ	ʔəsʰɪ̀ɴpjè
အဆန်	ʔəsʰàɴ
အဆိပ်	ʔəsʰeɪʔ
အဆိုတော်	ʔəsʰòdɔ̀
အဆီ	ʔəsʰì
အဆီဓာတ်	ʔəsʰìdaʔ
အဆီးအတား	ʔəsʰíʔətá
အဆုတ်	ʔəsʰoʊʔ
အဆုတ်ရောင်ရောဂါ	ʔa̰sʰoʊʔjàʊɴjɔ́gà
အဆုံး	ʔəsʰóʊɴ
အဆောက်အအုံ	ʔəsʰaʊʔʔəʔú
အဆောက်အဦ	ʔəsʰaʊʔʔəʔù
အဆောင်	ʔəsʰàʊɴ
အဆွေး	ʔəsʰwé
အဇာဘိုင်ဂျန်	ʔa̰zəbàɪɴdʑàɴ
အဉ္ဇလီ	ʔɪ̀ɴzəlì
အညစ်အကြေး	ʔəɲɪʔʔətɕé
အညစ်အထည်း	ʔəɲɪʔʔətʰí
အညမည	ʔɪ̀ɴɲa̰mɪ̀ɴɲa̰
အညာဒေသ	ʔəɲàdèθa̰
အညာသား	ʔəɲàðá
အညို	ʔəɲò
အညီ	ʔəɲì
အညောင်းဆန့်	ʔəɲáʊɴsʰa̰ɴ
အဋဋ	ʔətəta̰
အဋ္ဌဂံ	ʔaʔtʰəgàɴ
အဋ္ဌင်္ဂသီလ	ʔaʔtʰɪ̀ɴga̰θìla̰
အဋ္ဌမ	ʔaʔtʰəma̰
အဏုဇီဝဗေဒ	ʔənṵzìwa̰bèda̰
အဏုမြူ	ʔənṵmjù
အဏုမြူဗုံး	ʔənṵmjùbóʊɴ
အဏုမြူလက်နက်	ʔənṵmjùlɛʔnɛʔ
အဏ္ဏဝါ	ʔàɴnəwà
အဏ္ဏဝါဗေဒ	ʔànnəwàbèda̰
အတင်း	ʔətɪ́ɴ
အတည်	ʔətì
အတည်ပြု	ʔətìpjṵ
အတန်း	ʔətáɴ
အတာ	ʔətà
အတာအိုး	ʔətàʔó
အတားအဆီး	ʔətáʔəsʰí
အတိတ်	ʔəteɪʔ
အတိုက်အခံ	ʔətaɪʔʔəkʰàɴ
အတိုင်ပင်ခံ	ʔətàɪɴbɪ̀ɴgàɴ
အတိုင်း	ʔətáɪɴ
အတိုး	ʔətó
အတီမျှ	ʔətìm̥ja̰
အတီး	ʔətí
အတူ	ʔətù
အတူတူ	ʔətùdù
အတောင်	ʔətàʊɴ
အတ္တ	ʔaʔta̰
အတ္တဒဿီ	ʔaʔta̰daʔθì
အတ္တဒဿီဘုရား	ʔaʔta̰dətθìpʰəjá
အတွင်း	ʔətwɪ́ɴ
အတွင်းခံ	ʔətwɪ́ɴgàɴ
အတွင်းစကား	ʔətwɪ́ɴzəgá
အတွင်းတာရာ	ʔətwɪ́ɴtàjà
အတွင်းရန်	ʔətwɪ́ɴjàɴ
အတွင်းဝန်	ʔətwɪ́ɴwʊ̀ɴ
အတွဲ	ʔətwɛ́
အထက်	ʔətʰɛʔ
အထက်လွှတ်တော်	ʔətʰɛʔl̥ʊʔtɔ̀
အထက်သား	ʔətʰɛʔðá
အထင်	ʔətʰɪ̀ɴ
အထပ်	ʔətʰaʔ
အထပ်မုန့်	ʔətʰaʔmo̰ʊɴ
အထိ	ʔətʰḭ
အထိန်း	ʔətʰéɪɴ
အထိမ်းအမှတ်	ʔətʰéɪɴʔəm̥aʔ
အထီး	ʔətʰí
အထုပ်	ʔətʰoʊʔ
အထုံးအဖွဲ့	ʔətʰóʊɴʔəpʰwɛ̰
အထဲ	ʔətʰɛ́
အထွတ်	ʔətʰʊʔ
အထွေထွေအတွင်းရေးမှူးချုပ်	ʔətʰwètʰwèʔətwɪ́ɴjém̥údʑoʊʔ
အဒေါ်	ʔədɔ̀
အဓမ္မ	ʔədəma̰
အဓိက	ʔədḭka̰
အဓိကရုဏ်း​	ʔədḭka̰jóʊɴ
အဓိဋ္ဌာန်	ʔədìttʰàn
အဓိပတိ	ʔədḭbədḭ
အဓိပ္ပါယ်	ʔədeɪʔbɛ̀
အနက်	ʔənɛʔ
အနဂ္ဂ	ʔa̰nɛʔga̰
အနည်း	ʔənɛ́
အနည်းစု	ʔənɛ́zṵ
အနတ္တ	ʔənaʔta̰
အနန္တ	ʔənàɴda̰
အနန္တောအနန္တငါးပါး	ʔənàɴdɔ́ʔənda̰ŋápá
အနာကြီးရောဂါ	ʔənàdʑíjɔ́gà
အနာဂတ်	ʔənàgaʔ
အနား	ʔəná
အနားယူ	ʔənájù
အနိစ္စ	ʔəneɪʔsa̰
အနို့	ʔəno̰
အနီ	ʔənì
အနုခရာ	ʔənṵkʰəjà
အနုတ်လက္ခဏာ	ʔən̥oʊʔlɛʔkʰənà
အနုပညာ	ʔənṵpjɪ̀ɴɲà
အနုရာဓပူရ	ʔənṵjàda̰pùɹa̰
အနုရုဒ္ဓါ	ʔənṵjoʊʔdà
အနောက်	ʔənaʊʔ
အနောက်တောင်	ʔənaʊʔtàʊɴ
အနောက်မြောက်	ʔənaʊʔmjaʊʔ
အနောက်ဝန်	ʔənaʊʔwʊ̀ɴ
အနောင်	ʔənàʊɴ
အနောမဒဿီ	ʔənɔ́mədətθì
အနောမဒဿီဘုရား	ʔənɔ́mədaʔθìpʰəjá
အနော်ရထာ	ʔənɔ̀jətʰà
အနံ့	ʔəna̰ɴ
အန္တရာယ်	ʔàɴdəjɛ̀
အန္တာတိက	ʔàɴtàtḭka̰
အန်	ʔàɴ
အန်ကယ်	ʔàɴkɛ̀
အန်ကူးမုန့်	ʔàɴkúmo̰ʊɴ
အန်တီ	ʔàɴtì
အန်နီမဲ	ʔàɴnìmɛ́
အန်ပေါင်း	ʔàɴpáʊɴ
အနွယ်	ʔənwɛ̀
အနှစ်	ʔən̥ɪʔ
အနှိပ်	ʔən̥eɪʔ
အနှီဟာ	ʔən̥ìhà
အနှီး	ʔən̥í
အပင်	ʔəpɪ̀ɴ
အပတ်	ʔəpaʔ
အပတ်စဉ်	ʔa̰paʔzɪ̀ɴ
အပန်းဖြေ	ʔəpáɴpʰjè
အပိုင်း	ʔəpáɪɴ
အပိုဒ်	ʔəpaɪʔ
အပူ	ʔəpù
အပေါက်	ʔəpaʊʔ
အပေါက်ဝ	ʔəpaʊʔwa̰
အပေါင်	ʔəpàʊɴ
အပေါင်းလက္ခဏာ	ʔəpáʊɴlɛʔkʰənà
အပေါ့	ʔəpɔ̰
အပေါ့သွား	ʔəpɔ̰θwá
အပေါ်	ʔəpɔ̀
အပေါ်အင်္ကျီ	ʔəpɔ̀ʔɪ́ɴdʑì
အပ်	ʔaʔ
အပ်ချည်	ʔaʔtɕʰì
အပ်ချုပ်စက်	ʔaʔtɕʰoʊʔsɛʔ
အပ်ချုပ်သမား	ʔaʔtɕʰoʊʔðəmá
အပ်ထောက်	ʔaʔtʰaʊʔ
အပျော်အပါး	ʔəpjɔ̀ʔəpá
အပြင်	ʔəpjɪ̀ɴ
အပြစ်	ʔəpjɪʔ
အပြစ်ပေး	ʔəpjɪʔpé
အပြည်ပြည်ဆိုင်ရာ	ʔəpjìpjìsʰàɪɴjà
အပြာ	ʔəpjà
အပြာကား	ʔəpjàká
အပြာမယ်	ʔəpjàmɛ̀
အပြိုင်	ʔəpjàɪɴ
အပြီးသတ်	ʔəpjíðaʔ
အပြုအမူ	ʔəpjṵʔəmù
အပြုံး	ʔəpjóʊɴ
အပြော	ʔəpjɔ́
အပွင့်	ʔəpwɪ̰ɴ
အဖ	ʔəpʰa̰
အဖတ်	ʔəpʰaʔ
အဖန်ခြောက်	ʔəpʰàɴdʑaʊʔ
အဖို	ʔəpʰò
အဖို့	ʔəpʰo̰
အဖိုး	ʔəpʰó
အဖိုးကြီး	ʔəpʰótɕí
အဖုံဖုံ	ʔəpʰòʊɴbòʊɴ
အဖုံး	ʔəpʰóʊɴ
အဖေ	ʔəpʰè
အဖော်	ʔəpʰɔ̀
အဖေ့	ʔəpʰḛ
အဖျား	ʔəpʰjá
အဖျားဖြတ်ဆေး	ʔa̰pʰjápʰjaʔsʰé
အဖြစ်အပျက်	ʔəpʰjɪʔʔəpjɛʔ
အဖြူ	ʔəpʰjù
အဖြေ	ʔəpʰjè
အဖွဲ့	ʔəpʰwɛ̰
အဖွဲ့ချုပ်	ʔəpʰwɛ̰dʑoʊʔ
အဖွဲ့ဝင်	ʔəpʰwɛ̰wɪ̀ɴ
အဗဗ	ʔəbəba̰
အဗ္ဗုဒ	ʔaʔboʊʔda̰
အဘ	ʔəba̰
အဘယဋ္ဌာန	ʔəbəjaʔtʰàna̰
အဘိဓာန်	ʔəbḭdàɴ
အဘိုး	ʔəpʰó
အဘိုးကြီး	ʔəpʰódʑí
အဘီ	ʔa̰bì
အဘူဒါဘီ	ʔa̰bùdàbì
အဘွား	ʔəpʰwá
အမ	ʔəma̰
အမင်း	ʔəmɪ́ɴ
အမည်	ʔəmjì
အမည်း	ʔəmɛ́
အမတ်	ʔəmaʔ
အမယ်	ʔəmɛ̀
အမရပူရ	ʔəməɹa̰pùɹa̰
အမာ	ʔa̰mà
အမိ	ʔəmḭ
အမိန့်	ʔəmḛɪɴ
အမိန့်ရှိပါ	ʔəmḛɪɴʃḭbà
အမိမြေ	ʔəmḭmjè
အမိုး	ʔəmó
အမီးဗား	ʔəmíbá
အမုန်း	ʔəmóʊɴ
အမူအရာ	ʔəmùʔəjà
အမေ	ʔəmè
အမေရိက	ʔəmèɹḭka̰
အမေရိကန်	ʔəmèɹḭkàɴ
အမေရိကန်ပြည်ထောင်စု	ʔəmèɹḭkàɴpjìdàʊɴzṵ
အမေလိုး	ʔəmèló
အမေး	ʔəmé
အမဲလိုက်	ʔəmɛ́laɪʔ
အမဲသား	ʔəmɛ́ðá
အမဲသားမစားပါဘူး	ʔəmɛ́ðáməsábàbú
အမ်စတာဒမ်	ʔàɴsətàdàɴ
အမ်မန်	ʔàɴmàɴ
အမျက်တော်ရှ	ʔəmjɛʔdɔ̀ʃa̰
အများ	ʔəmjá
အများစု	ʔəmjázṵ
အမျိုး	ʔəmjó
အမျိုးဇာတ်	ʔəmjózaʔ
အမျိုးလေးပါး	ʔəmjólébá
အမျိုးသမီး	ʔəmjóðəmí
အမျိုးသမီးလစဉ်သုံးပစ္စည်း	ʔa̰mjóðəmíla̰zɪ̀ɴθóʊɴpjɪʔsí
အမျိုးသား	ʔəmjóðá
အမျိုးသားစိတ်	ʔəmjóðáseɪʔ
အမျိုးသားနေ့	ʔəmjóðánḛ
အမျိုးသားမော်ကွန်းတိုက်	ʔəmjóðámɔ̀gʊ́ɴtaɪʔ
အမျိုးသားလွှတ်တော်	ʔəmjóðál̥ʊʔtɔ̀
အမျိုးသားသီချင်း	ʔəmjóðáθətɕʰɪ́ɴ
အမျိုးသားဥယျာဉ်	ʔəmjóðáʔṵjɪ̀ɴ
အမျိုးအနွယ်	ʔəmjóʔənwɛ̀
အမျှင်	ʔəm̥jɪ̀ɴ
အမြင်	ʔəmjɪ̀ɴ
အမြစ်	ʔəmjɪʔ
အမြတ်	ʔəmjaʔ
အမြန်	ʔəmjàɴ
အမြီး	ʔəm̥í
အမြောက်	ʔəmjaʊʔ
အမြဲ	ʔəmjɛ́
အမြဲတမ်း	ʔəmjɛ́dáɴ
အမြွှာ	ʔəm̥wà
အမြှုပ်	ʔəm̥joʊʔ
အမြှောက်လက္ခဏာ	ʔəm̥jaʊʔlɛʔkʰənà
အမွေ	ʔəmwè
အမွေခံ	ʔəmwèkʰàɴ
အမွေခံ	ʔəmwègàɴ
အမွေခွဲ	ʔəmwèkʰwɛ́
အမွေအနှစ်	ʔəmwèʔən̥ɪʔ
အမွေး	ʔəmwé
အမွှေး	ʔəm̥wé
အမွှေးတိုင်	ʔəm̥wédàɪɴ
အမှတ်	ʔəm̥aʔ
အမှတ်တံဆိပ်	ʔəm̥aʔdəzeɪʔ
အမှန်တရား	ʔəm̥àɴtəjá
အမှာ	ʔəm̥à
အမှား	ʔəm̥á
အမှိုက်	ʔəm̥aɪʔ
အမှိုက်သရိုက်	ʔəm̥aɪʔθəjaɪʔ
အမှုန့်	ʔəm̥o̰ʊɴ
အမှုန်	ʔəm̥òʊɴ
အယုဓျာ	ʔəjoʊʔdəjà
အယူ	ʔəjù
အယူဝါဒ	ʔəjùwàda̰
အယ်ဆာဗေဒို	ʔɛ̀sʰàbèdò
အယ်လဂျီးယား	ʔəla̰dʑíjá
အယ်လဘမ်	ʔɛ̀ləbàɴ
အယ်လ်ကိုဟော	ʔɛ̀lkòhɔ́
အယ်လ်ဂျီးရီးယား	ʔɛ̀ldʑíɹíjá
အယ်လ်ဘေးနီးယား	ʔɛ̀lbéníjá
အရက်	ʔəjɛʔ
အရက်ဆိုင်	ʔəjɛʔsʰàɪɴ
အရင်း	ʔəjɪ́ɴ
အရင်းရှင်	ʔəjɪ́ɴʃɪ̀ɴ
အရင်းရှင်ဝါဒ	ʔəjɪ́ɴʃɪ̀ɴwàda̰
အရင်းအနှီး	ʔəjɪ́ɴʔən̥í
အရည်	ʔəjì
အရပ်	ʔəjaʔ
အရပ်သား	ʔəjaʔθá
အရမ်း	ʔəjáɴ
အရသာ	ʔəja̰ðà
အရာ	ʔəjà
အရာခံဗိုလ်	ʔəjàgàɴbò
အရိပ်	ʔəjeɪʔ
အရိမဒ္ဒနာပူရ	ʔa̰ɹḭmàddənàpùɹa̰
အရိုး	ʔəjó
အရိုးစု	ʔəjózṵ
အရိုးပဒေသာ	ʔəjóbədèθà
အရိုးပျော့နာ	ʔa̰jópjɔ̰nà
အရီး	ʔəjí
အရီးကြီး	ʔəjídʑí
အရီးလေး	ʔəjílé
အရုဏ်	ʔàjòʊɴ
အရုဏ်တက်	ʔa̰jòʊɴtɛʔ
အရုပ်	ʔəjoʊʔ
အရုပ်စာ	ʔəjoʊʔsà
အရေ	ʔəjè
အရေပြား	ʔəjèbjá
အရေပြားရောဂါ	ʔəjèbjájɔ́gà
အရေအတွက်	ʔəjèʔətwɛʔ
အရောင်	ʔəjàʊɴ
အရောင်တင်မှုန့်	ʔəjàʊɴtɪ̀ɴm̥o̰ʊɴ
အရောင်းအဝယ်	ʔəjáʊɴʔəwɛ̀
အရေး	ʔa̰jé
အရေးကြီး	ʔa̰jétɕí
အရေးတော်ပုံ	ʔəjédɔ̀bòʊɴ
အရေးပိုင်	ʔa̰jébàɪɴ
အရံဂြိုဟ်	ʔəjàɴdʑò
အရွက်	ʔəjwɛʔ
အရွတ်	ʔəjʊʔ
အရွယ်ဆယ်ပါး	ʔəjwɛ̀sʰɛ̀bá
အရှင်	ʔəʃɪ̀ɴ
အရှင်ဘုရား	ʔəʃɪ̀ɴpʰəjá
အရှင်မင်းကြီး	ʔəʃɪ̀ɴmɪ́ɴdʑí
အရှင်မင်းမြတ်	ʔəʃɪ̀ɴmɪ́ɴmjaʔ
အရှိန်	ʔəʃèɪɴ
အရှုံး	ʔəʃóʊɴ
အရှေ့	ʔəʃḛ
အရှေ့တီမော	ʔəʃḛtìmè
အရှေ့တောင်	ʔəʃḛtàʊɴ
အရှေ့မြောက်	ʔəʃḛmjaʊʔ
အရှေ့အလယ်ပိုင်းဒေသ	ʔəʃḛʔa̰lɛ̀páɪɴdèθa̰
အရှေ့ဥရောပ	ʔəʃḛʔṵɹɔ́pa̰
အလက်	ʔəlɛʔ
အလင်း	ʔəlɪ́ɴ
အလင်းတန်း	ʔəlɪ́ɴdáɴ
အလင်္ကာ	ʔəlɪ̀ɴgà
အလတ်	ʔəlaʔ
အလယ်	ʔəlɛ̀
အလယ်ခေတ်	ʔəlɛ̀kʰɪʔ
အလယ်အာရှ	ʔəlɛ̀ʔàʃa̰
အလား	ʔəlá
အလိမ္မာ	ʔəlèɪɴmà
အလို	ʔəlò
အလိုရှိ	ʔəlòʃḭ
အလီ	ʔəlì
အလုပ်	ʔəloʊʔ
အလုပ်ပိတ်ရက်	ʔəloʊʔpeɪʔjɛʔ
အလုပ်ရုံ	ʔəloʊʔjòʊɴ
အလုပ်ရှင်	ʔəloʊʔʃɪ̀ɴ
အလုပ်လုပ်	ʔəloʊʔloʊʔ
အလုပ်သမား	ʔəloʊʔθəmá
အလုပ်သမားနေ့	ʔəloʊʔθəmánḛ
အလုံး	ʔəlóʊɴ
အလူမီနီယမ်	ʔəlùmìnìjàɴ
အလောင်း	ʔəláʊɴ
အလေး	ʔəlé
အလေးသွား	ʔəléθwá
အလံ	ʔəlàɴ
အလံတိုင်	ʔəlàɴdàɪɴ
အလ္လာဟ်	ʔàllàh
အလျင်	ʔəjɪ̀ɴ
အလျင်	ʔəljɪ̀ɴ
အလျား	ʔəljá
အလျှံ	ʔəl̥jàɴ
အလွန်	ʔəlʊ̀ɴ
အလွမ်း	ʔəlwáɴ
အလှဆီ	ʔəl̥a̰zì
အလှမယ်	ʔəl̥a̰mɛ̀
အလှမ်း	ʔəl̥áɴ
အလှူဒါန	ʔəl̥ùdàna̰
အလှူရှင်	ʔəl̥ùʃɪ̀ɴ
အဝဂ်	ʔa̰wɛʔ
အဝင်	ʔəwɪ̀ɴ
အဝစား	ʔəwa̰zá
အဝတာရ	ʔa̰wa̰tàja̰
အဝတ်	ʔəwʊʔ
အဝတ်လျှောက်စက်	ʔəwʊʔʃaʊʔsɛʔ
အဝတ်အစား	ʔəwʊʔʔəsá
အဝါ	ʔəwà
အဝေး	ʔəwé
အသက်	ʔəθɛʔ
အသက်အာမံခံ	ʔəθɛʔʔàmàɴkʰàɴ
အသက်ဦးဆံပိုင်	ʔəθɛʔʔúsʰàɴbàɪɴ
အသင်	ʔəθɪ̀ɴ
အသင်း	ʔəθɪ́ɴ
အသင်္ချေ	ʔəθɪ̀ɴtɕʰè
အသည်း	ʔəθɛ́
အသည်းနှလုံး	ʔəθɛ́n̥əlóʊɴ
အသတ်	ʔa̰θaʔ
အသရေ	ʔəθa̰jè
အသား	ʔəθá
အသားညှပ်မုန့်	ʔəθáɲ̊aʔmo̰ʊɴ
အသားဓာတ်	ʔəθádaʔ
အသားမာ	ʔəθəmà
အသားဝါရောဂါ	ʔa̰θáwàjɔ́gà
အသိ	ʔəθḭ
အသိတရား	ʔəθḭtəjá
အသိပညာ	ʔəθḭpjɪ̀ɴɲà
အသိပညာရှင်	ʔəθḭpjɪ̀ɴɲàʃɪ̀ɴ
အသိုက်	ʔəθaɪʔ
အသီး	ʔəθí
အသုပ်	ʔəθoʊʔ
အသုပ်စုံ	ʔəθoʊʔsòʊɴ
အသုဘ	ʔa̰θṵba̰
အသုံး	ʔəθóʊɴ
အသုံးပြု	ʔəθóʊɴpjṵ
အသုံးပြုသူ	ʔa̰θóʊɴpjṵðù
အသူ	ʔa̰θù
အသေ	ʔəθè
အသော	ʔəθɔ́
အသံ	ʔəθàɴ
အသံထွက်	ʔəθàɴdwɛʔ
အသျှင်	ʔəʃɪ̀ɴ
အသွမ်း	ʔəθwáɴ
အသွားအလာ	ʔəθwáʔəlà
အာကာသ	ʔàkàθa̰
အာကာသစခန်း	ʔàkàθa̰səkʰáɴ
အာကာသစိုး	ʔàkàθa̰zó
အာကာသယာဉ်	ʔàkàθa̰jɪ̀ɴ
အာကာသယာဉ်မှူး	ʔàkàθa̰jɪ̀ɴm̥ú
အာခါ	ʔàkʰà
အာချာန်	ʔàtɕʰàɴ
အာဂျင်တီးနား	ʔàdʑɪ̀ɴtíná
အာဃာတ	ʔàgàta̰
အာစရိယ	ʔàsa̰ɹḭja̰
အာဆီယံ	ʔàsʰìjàɴ
အာဇာနည်	ʔàzànì
အာဇာနည်နေ့	ʔàzànìnḛ
အာဏာ	ʔànà
အာဏာရှင်	ʔànàʃɪ̀ɴ
အာဏာရှင်စနစ်	ʔànàʃɪ̀ɴsənɪʔ
အာဏာသား	ʔànàðá
အာဏာသိမ်း	ʔànàθéɪɴ
အာဏာသိမ်းမှု	ʔànàθéɪɴm̥ṵ
အာတိတ်	ʔàteɪʔ
အာတိတ်သမုဒ္ဒရာ	ʔàteɪʔθəmoʊʔdəjà
အာဒိဝန်	ʔàdḭwʊ̀ɴ
အာနန္ဒာ	ʔànàɴdà
အာနီ	ʔànì
အာနုဘော်	ʔànṵbɔ̀
အာပုံ	ʔàpòʊɴ
အာပူလျှာပူ	ʔàpùʃàpù
အာပေါ	ʔàpɔ́
အာပဲ့ခြောက်	ʔàbɛ̰tɕʰaʊʔ
အာဖဂန်နစ်စတန်	ʔàpʰəgàɴnɪʔsətàɴ
အာဖရိက	ʔàpʰəɹḭka̰
အာမခံ	ʔàma̰gàɴ
အာမခံသေတ္တာ	ʔàma̰gàɴθɪʔtà
အာမေဍိတ်	ʔàmèdeɪʔ
အာမေးနီးယား	ʔàméníjá
အာယုဗ္ဗေဒ	ʔàjoʊʔbèda̰
အာရပ်	ʔàɹaʔ
အာရာမ	ʔàjàma̰
အာရာမ်	ʔàjàɴ
အာရိုက်	ʔàjaɪʔ
အာရုံကြော	ʔàjòʊɴdʑɔ́
အာရုံငါးပါး	ʔàjòʊɴŋábá
အာရ်	ʔàɹ
အာရှ	ʔàʃa̰
အာလယ	ʔàləja̰
အာလာပသလ္လာပ	ʔàlàpa̰θəlàpa̰
အာလူး	ʔàlú
အာလူးပူရီ	ʔàlúpùjì
အာလူးဖုတ်	ʔàlúpʰoʊʔ
အာဝါဟဝိဝါဟ	ʔàwàha̰wḭwàha̰
အာဟာရ	ʔàhàja̰
အာဟာရဗေဒ	ʔàhàja̰bèda̰
အား	ʔá
အားကစား	ʔágəzá
အားကစားကွင်း	ʔágəzágwɪ́ɴ
အားကစားရုံ	ʔágəzájòʊɴ
အားကစားသမား	ʔágəzáðəmá
အားကိုး	ʔákó
အားနည်း	ʔánɛ́
အားနာ	ʔánà
အားနာပါးနာ	ʔánàpánà
အားလပ်	ʔálaʔ
အားလပ်ရက်	ʔálaʔjɛʔ
အားလုံး	ʔálóʊɴ
အိတ်	ʔeɪʔ
အိန္ဒိယ	ʔèɪɴdḭja̰
အိန္ဒြာ	ʔèɪɴdɹà
အိန္ဒြေ	ʔèɪɴdɹè
အိပ်	ʔeɪʔ
အိပ်ခန်း	ʔeɪʔkʰáɴ
အိပ်မက်	ʔeɪʔmɛʔ
အိပ်ရာ	ʔeɪʔjà
အိပ်ရာလိပ်	ʔeɪʔjàleɪʔ
အိမ်	ʔèɪɴ
အိမ်စာ	ʔèɪɴzà
အိမ်တက်မင်္ဂလာ	ʔèɪɴtɛʔmɪ̀ɴgəlà
အိမ်ထောင်	ʔèɪɴdàʊɴ
အိမ်ထောင်	ʔèɪɴtʰàʊɴ
အိမ်ထောင်ပြု	ʔèɪɴdàʊɴpjṵ
အိမ်ထောင်ရေး	ʔèɪɴdàʊɴjé
အိမ်နီးချင်း	ʔèɪɴnídʑɪ́ɴ
အိမ်ဖြူတော်	ʔèɪɴpʰjùdɔ̀
အိမ်မြှောင်	ʔèɪɴm̥jàʊɴ
အိမ်ရှင်မ	ʔèɪɴʃɪ̀ɴma̰
အိမ်ရှေ့မင်း	ʔèɪɴʃḛmɪ́ɴ
အိမ်ရှေ့မင်းသား	ʔèɪɴʃḛmɪ́ɴðá
အိမ်လည်	ʔèɪɴlè
အိမ်သာ	ʔèɪɴðà
အိမ်သာသုံးစက္ကူ	ʔèɪɴðàðóʊɴsɛʔkù
အိမ်သူ	ʔèɪɴðù
အို	ʔò
အိုက်စလန်	ʔaɪʔsəlàɴ
အိုက်တင်	ʔaɪʔtɪ̀ɴ
အိုင်	ʔàɪɴ
အိုင်ဒီယာ	ʔàɪɴdìjà
အိုင်ဗရီကို့စ်	ʔàɪɴbəɹìko̰s
အိုင်ယာလန်	ʔàɪɴjəlàɴ
အိုင်အိုင်	ʔàɪɴʔàɪɴ
အိုင်းယွန်း	ʔáɪɴjʊ́ɴ
အိုဇုန်း	ʔòzóʊɴ
အိုဗာတင်း	ʔòbàtɪ́ɴ
အိုမန်	ʔòmàɴ
အိုရှန်းနီးယား	ʔòʃáɴníjá
အိုလံပစ်	ʔòlàɴpɪʔ
အိုအေစစ်	ʔòʔèsɪʔ
အိုး	ʔó
အိုးထိန်းသည်	ʔódéɪɴðì
အီကြာကွေး	ʔìtɕàkwé
အီကွေတာ	ʔìkwètà
အီကွေတာဂီနီ	ʔìkwètàgìnì
အီကွေဒေါ	ʔìkwèdɔ́
အီဂျစ်	ʔìdʑɪʔ
အီစတာ	ʔìsətà
အီတလီ	ʔìta̰lì
အီနောင်	ʔìnàʊɴ
အီရတ်	ʔìɹaʔ
အီရန်	ʔìɹàɴ
အီရီထရီးယား	ʔìɹìtʰəɹíjá
အီလက်ထရွန်	ʔìlɛʔtʰəɹʊ̀ɴ
အီလက်ထရွန်နစ်	ʔìlɛʔtʰəɹʊ̀ɴnɪʔ
အီသီယိုးပီးယား	ʔìθìjópíjá
အီး	ʔí
အီးပါ	ʔípà
အီးပေါက်	ʔípaʊʔ
အီးမေးလ်	ʔímél
အုတ်	ʔoʊʔ
အုတ်ကြွပ်	ʔoʊʔtɕʊʔ
အုန်း	ʔóʊɴ
အုန်းဆီ	ʔóʊɴzì
အုန်းထမင်း	ʔóʊɴtʰəmɪ́ɴ
အုန်းနို့	ʔóʊɴno̰
အုန်းနို့ခေါက်ဆွဲ	ʔóʊɴno̰kʰaʊʔsʰwɛ́
အုန်းမှန်ကူ	ʔóʊɴm̥àɴgù
အုန်းသီးမှုန့်	ʔóʊɴθím̥o̰ʊɴ
အုပ်	ʔoʊʔ
အုပ်ချုပ်	ʔoʊʔtɕʰoʊʔ
အုံ့	ʔo̰ʊɴ
အုံး	ʔóʊɴ
အူ	ʔù
အူမကြီး	ʔùma̰dʑí
အေ	ʔè
အေသင်	ʔèθɪ̀ɴ
အောက်	ʔaʊʔ
အောက်ဆီဂျင်	ʔaʊʔsʰìdʑɪ̀ɴ
အောက်တိုဘာ	ʔaʊʔtòbà
အောက်မြစ်	ʔaʊʔmjɪʔ
အောက်လွှတ်တော်	ʔaʊʔl̥ʊʔtɔ̀
အောက်သား	ʔaʊʔðá
အောင်	ʔàʊɴ
အောင်ပန်း	ʔàʊɴpáɴ
အောင်ပွဲ	ʔàʊɴbwɛ́
အောင်မြင်	ʔàʊɴmjɪ̀ɴ
အောင်မြေ	ʔàʊɴmjè
အောင်လံ	ʔàʊɴlàɴ
အော့	ʔɔ̰
အော့စလို	ʔɔ̰səlò
အော့တဝ	ʔɔ̰ta̰wa̰
အော့အန်	ʔɔ̰ʔàɴ
အော်	ʔɔ̀
အော်ကေ့ကြည်	ʔɔ̀kḛtɕì
အော်ကွေ့	ʔɔ̀kwḛ
အော်ကွေ့ကြည်	ʔɔ̀kwḛtɕì
အော်တိုကရေစီ	ʔɔ̀tòkəɹèsì
အော်တိုမက်တစ်	ʔɔ̀tòmɛʔtɪʔ
အော်တိုမေးရှင်း	ʔɔ̀tòméʃɪ́ɴ
အော်ဒါ	ʔɔ̀dà
အော်ပရာ	ʔɔ̀pəɹà
အော်လီယန်း	ʔɔ̀lìjáɴ
အေး	ʔé
အဲဒါ	ʔɛ́dà
အဲဒါဘာလဲ	ʔɛ́dàbàlɛ́
အဲဒီ	ʔɛ́dì
အဲဒီဟာ	ʔɛ́dìhà
အဲလစ်ဇဘက်	ʔɛ́lɪʔza̰bɛʔ
အံဆွဲ	ʔàɴzwɛ́
ဣ	ʔḭ
ဣန္ဒါ	ʔḭndà
ဣန္ဒာ	ʔḭndà
ဣန္ဒြေ	ʔèɪɴdɹè
ဣရိယာပုတ်	ʔḭɹḭjàboʊʔ
ဤ	ʔì
ဥ	ʔṵ
ဥက္ကဋ္ဌ	ʔoʊʔkəθa̰
ဥက္ကာ	ʔoʊʔkà
ဥက္ကာခဲ	ʔoʊʔkàgɛ́
ဥက္ကာပျံ	ʔoʊʔkàbjàɴ
ဥဂ္ဂါ	ʔoʊʔgà
ဥစ္စာ	ʔoʊʔsà
ဥဇဘက်ကစ္စတန်	ʔṵzəbɛʔkɪʔsətàɴ
ဥဏ္ဏလုံ	ʔòʊɴnəlòʊɴ
ဥဏ္ဏလုံမွေးရှင်	ʔòʊɴnəlòʊɴm̥wéʃɪ̀ɴ
ဥဏှဂူ	ʔòʊɴn̥əgù
ဥဏှိဿ	ʔṵn̥eɪʔθa̰
ဥတု	ʔṵdṵ
ဥတ္တရ	ʔoʊʔtəja̰
ဥတ္တရခဏ္ဍ	ʔoʊʔtəɹa̰kʰànda̰
ဥဒေါင်း	ʔṵdáʊɴ
ဥနီ	ʔṵnì
ဥပစာ	ʔṵbəzà
ဥပဒေ	ʔṵba̰dè
ဥပဒေပညာ	ʔṵbədèpjɪ̀ɴɲà
ဥပဓိရုပ်	ʔṵpa̰dḭjoʊʔ
ဥပမာ	ʔṵbəmà
ဥပရာဇာ	ʔṵpəɹàzà
ဥပါကြယ်	ʔṵpàtɕɛ̀
ဥပါဒါန်	ʔṵpàdàn
ဥပါယ်	ʔṵpɛ̀
ဥပါလိ	ʔṵpàlḭ
ဥပုသ်	ʔṵboʊʔ
ဥပုသ်ဆောင်ဝင်	ʔṵboʊʔsʰàʊɴwɪ̀ɴ
ဥပ္ပလ	ʔoʊʔpəla̰
ဥမင်	ʔṵmɪ̀ɴ
ဥမ္မာ	ʔòʊɴmà
ဥယျာဉ်	ʔṵjɪ̀ɴ
ဥယျာဉ်မှူး	ʔṵjɪ̀ɴm̥ú
ဥရုဂွေး	ʔṵɹṵgwé
ဥရူတိုင်	ʔṵjùdàɪɴ
ဥရောပ	ʔṵɹɔ́pa̰
ဥသျှစ်	ʔoʊʔʃɪʔ
ဥုံ	ʔòʊɴ
ဥဿဖရား	ʔoʊʔθəpʰəjá
ဦ	ʔù
ဦလန်ဘာတာ	ʔùlàɴbàtà
ဦး	ʔú
ဦးကြီး	ʔúdʑí
ဦးခိုက်	ʔúkʰaɪʔ
ဦးချ	ʔútɕʰa̰
ဦးချို	ʔúdʑò
ဦးခွံ	ʔúgʊ̀ɴ
ဦးတည်ချက်	ʔútìdʑɛʔ
ဦးထုပ်	ʔoʊʔtʰoʊʔ
ဦးနှောက်	ʔóʊɴn̥aʊʔ
ဦးပဉ္စင်း	ʔúbəzɪ́ɴ
ဦးလေး	ʔúlé
ဧ	ʔè
ဧက	ʔèka̰
ဧကန္တ	ʔègàɴda̰
ဧကန်	ʔègàɴ
ဧကရာဇ်	ʔègəjɪʔ
ဧကရာဇ်	ʔègəɹɪʔ
ဧကရီ	ʔèkəjì
ဧကဝဏ္ဏဘာသာ	ʔèka̰wʊ̀ɴna̰bàðà
ဧကဝုစ်	ʔègəwoʊʔ
ဧကာဒသမ	ʔèkàda̰θəma̰
ဧကံသိက	ʔèkàɴθḭka̰
ဧည့်	ʔḛ
ဧည့်ဝတ်	ʔḛwʊʔ
ဧည့်သည်	ʔḛðè
ဧဏီ	ʔènì
ဧပြီ	ʔèbəɹì
ဧရာဝတီ	ʔèjàwədì
ဧရိယာ	ʔèɹḭjà
ဩ	ʔɔ́
ဩကာသ	ʔɔ́gàθa̰
ဩဂုတ်	ʔɔ́goʊʔ
ဩစတြီးယား	ʔɔ́sətəɹìja̰
ဩစတြေးလျ	ʔɔ́sətəɹélja̰
ဩဇာ	ʔɔ́zà
ဩဇာသီး	ʔɔ́zàθí
ဩဌဇ	ʔɔ́tʰəza̰
ဩရသ	ʔɔ́jəθa̰
ဩရိဿ	ʔɔ́ɹeɪʔθa̰
ဩသဓ	ʔɔ́θəda̰
ဪ	ʔɔ̀
၌	n̥aɪʔ
၍	jwḛ
၎	ləgáʊɴ
၎င်း	ləgáʊɴ
၏	ʔḭ
