абажур	abaʒur
абайлау	ɑbɑjɫɑw
абак	ɐbak
аббревиатура	ɐbrʲɪvʲɪɐturə
абдикация	ɐbdʲɪkatsɨjə
абдоминопластика	ɐbdəmʲɪnɐpɫasʲtʲɪkə
абиссаль	ɐbʲɪsalʲ
абонемент	ɐbənʲɪmʲent
абонент	ɐbɐnʲent
абсолют	ɐpsɐlʲut
абсолютизм	ɐpsəlʲʉtʲizm
абстракционизм	ɐbstrəktsɨɐnʲizm
абстракция	ɐbstraktsɨjə
авангард	ɐvɐngard
аванс	ɐvans
авиация	ɐvʲɪatsɨɪ̯ə
автономия	ɐftɐnomʲɪjə
автономиялы	ɐftɐnəmʲɪjələ
автономиялық	ɐftɐnəmʲɪjələq
автоспорт	aftɐsport
автохтондық	ɐvtɐxtondɯq
агава	ɐgavə
агностицизм	ɐgnəsʲtʲɪtsɨzm
ағай	ɑ̝ʁɑ̝j
ағза	ɑʁzɑ
ағылшын	ɑɣɯɫʃɯn
аденозин	ɐdɛnɐzʲin
адмирал	ɐdmʲɪraɫ
адрес	adrʲɪs
адрон	ɐdron
адъютант	ɐdjʊtant
ажал	ɑʒɑɫ
азамат	ɑzɑmɑt
азимут	ɑzʲɪmuwt
азшылық	ɑzʃɯɫɯq
азық	ɑzɯq
айдай	ɑ̝jdɑ̝j
айтыс	ɑjtəs
айыр	ɑjɯr
академизм	ɐkədʲɪmʲizm
академик	ɐkɐdʲemʲɪk
академия	ɐkɐdʲemʲɪjə
академиялық	ɐkɐdʲemʲɪjəɫəq
акварель	ɐkvɐrʲelʲ
акварельші	ɐkvɐrʲelʲʃi
аквариум	ɐkvarʲɪʊm
аккордеон	ɐkərdʲɪon
аккредитив	ɐkrʲɪdʲɪtʲif
аккумулятор	ɐkʊmʊlʲatər
акриламид	ɐkrʲɪlɐmʲid
акробатика	ɐkrɐbatʲɪkə
актёр	ɐktʲɵr
ақиқат	ɑqɯjqɑt
ақпарат	ɑqpɑrɑt
ақтау	ɑqtɑw
ақтөбе	ɑqtɵbʲe
алақан	ɑɫɑqɑn
алаң	ɑɫɑŋ
аластау	ɑɫɑstɑw
албания	ɐlbanʲɪjə
алгебра	algʲɪbrə
алгоритм	ɐlgɐrʲitm
алғашқы	ɑɫɣɑʃqɯ
алғытөлем	ɐvans
алжапқыш	ɑɫʒɑpqɯʃ
алкалоид	alkɐloɪd
алкин	ɐlkʲin
алкоголь	ɐɫkɐgolʲ
аллельаралық	ɐlʲelʲɑrɑɫɯq
аллергия	ɐlʲɪrgʲiɪ̯ə
аллотропия	ɐlɐtropʲɪjə
алматы	ɑɫmɑtə
алпразолам	ɐɫprəzɐɫam
алты	ɑɫtə
алушы	ɑɫʊwʃɯ
алхамдулилла	alxamdʊwlʲɪlɑː
алхимия	ɐɫxʲimʲɪɪ̯ə
альдегид	ɐlʲdɨgʲid
альпинизм	ɐlʲpʲɪnʲizm
альтруизм	ɐlʲtrʊizm
альянс	ɐlʲjans
алюминий	ɐlʲʉmʲinʲɪj
аманат	ɑmɑnɑt
аммиак	ɐmʲɪak
анархизм	ɐnɐrxʲizm
анатомия	ɐnɐtomʲɪɪ̯ə
ангидрид	ɐngʲɪdrʲid
ант	ɑnt
антенна	ɐntɛnə
антибиотик	ɐnʲtʲɪbʲɪotʲɪk
антикоммунизм	anʲtʲɪkəmʊnʲizm
антиоксидант	anʲtʲɪəksʲɪdant
антипризма	ɐnʲtʲɪprʲizmə
антисептик	ɐnʲtʲɪsɛptʲɪk
антифриз	ɐnʲtʲɪfrʲiz
антициклон	anʲtʲɪtsɨklon
антоним	antɔnim
антрополог	ɐntrɐpoɫəg
антропология	ɐntrəpɐlogʲɪjə
антропологиялық	ɐntrəpɐlogʲɪjələq
антропометрия	ɐntrəpɐmʲetrʲɪɪ̯ə
антропонимика	ɐntrəpɐnʲimʲɪkə
анық	ɑnɯq
апай	ɑ̝pɑ̝j
апельсин	ɐpʲɪlʲsʲin
арал	ɑrɑɫ
арамшөп	ɑrɑmʃøp
арба	ɐrba
арбалет	ɐrbɐlʲet
аргентина	ɐrgʲɪnʲtʲinə
арккосинус	ɐrkkosʲɪnʊs
арккотангенс	ɐrkkɐtangʲɪns
арксеканс	ɐrksɛkəns
арксинус	ɐrksʲinʊs
арктангенс	ɐrktangʲɪns
арқалық	ɑɾqɑɫɯq
арман	ɑrmɑn
арпеджио	ɐrpʲedʒɨo
артиллерия	ɐrtʲɪlʲerʲɪjə
арфа	arfə
археология	ɐrxʲɪɐɫogʲɪɪ̯ə
аскөк	ɑskøk
асқабақ	ɑsqɑbɑq
асқазан	ɑsqɑzɑn
аспап	ɑspɑp
аспект	ɐspʲekt
аспирантура	ɐspʲɪrɐnturə
ассалаумағалейкум	asɐlawmaʕəlʲejkʊwm
ассалаумағалейкүм	asɐlawmaʕəlʲejkʉm
ассамблея	ɐsɐmblʲejə
ассимиляция	ɐsʲɪmʲɪlʲatsɨɪ̯ə
ассонанс	ɐsɐnans
ассоциация	ɐsətsɨatsɨjə
астана	ɑ̝stɑ̝nɑ̝
астроном	ɐstrɐnom
астрономия	ɐstrɐnomʲɪjə
астрофизика	ɐstrɐfʲizʲɪkə
ата	ɑtɑ
атавизм	ɐtɐvʲizm
атаксия	ɐtɐksʲijə
атлас	atləs
атом	ɑtom
атомаралық	ɑtomɑrɑɫɯq
атропин	ɐtrɐpʲin
аттестат	ɐtʲɪstat
атырау	ɑtərɑw
аудармашы	ɑwdɑrmɑʃɯ
аура	aʊrə
ауру	ɑwrʊw
аустенит	ɐʊstɛnʲit
аутизм	ɐʊtʲizm
ауыл	ɑwɯɫ
ацетилен	ɐtsɨtʲɪlʲen
аштық	ɑʃtɯq
ашу	ɑʃʊw
аяз	ɑjɑz
әдебиет	ædʲebʲiʲet
әдебиеттану	ædebɘjːetːɑnʊw
әдебиеттанушы	ædebɘjːetːɑnʊwʃɯ
әдемі	ædemɘ
әділетсіздік	ædɘletsɘzdɘk
әжетхана	æʒetxɑnɑ
әлхамдулилла	ælxamdʊwlʲɪlɑː
әлхамдулиллаһ	ælxamdʊwlʲɪlɑːh
әлхамдуллиллә	ælxamdʊwlʲɪlæ
әмбебап	æmbʲebap
әңгіме	æŋgɘmʲe
әр	ær
бағбан	bɑɣbɑn
бағдарламалық	bɑɣdɑrɫɑmɑɫɯq
бағдаршам	bɑɣdɑrʃɑm
базальт	bɐzalʲt
бай	bɑ̝j
байдарка	bɐjdarkə
байқоңыр	bɑjqoŋɯr
бактерия	bɐktʲerʲɪjə
бақа	bɑqɑ
бақташы	bɑqtɑʃɯ
бала	bɑɫɑ
бала	bɑ̝ɫɑ̝
балабақша	bɑɫɑbɑqʃɑ
балапан	bɑɫɑpɑn
балға	bɑɫɣɑ
балқаш	bɑɫqaʂ
баллада	bɐɫadə
банда	bandə
банк	bank
банкет	bɐnkʲet
банкнот	bɐnknot
барбадос	bɐrbadəs
бармен	bɐrmʲen
баскетбол	bəskʲɪdbol
батарея	bətɐrʲejə
бауырмалдық	bɑwʊrmɑɫdɯq
бахрейн	bɐxrʲejn
бегемот	bʲɪgʲɪmot
беде	bede
бейәдеби	bejædebɘj
бейсбол	bʲɪjzbol
бек	bʲe̞kʰ
беккерель	bʲɪkʲɪrɛlʲ
берет	bʲɪrʲet
бериллий	bʲɪrʲilʲɪj
беру	bʲerʉw
бес	bʲes
бет	bʲe̞tʰ
бетон	bʲɪton
би	bʲij
биатлон	bʲɪɐtɫon
бидай	bɪjdɑj
бие	bʲije̞
бикини	bʲɪkʲinʲɪ
биогеография	bʲiəgʲɪɐgrafʲɪɪ̯ə
биология	bʲɪɐɫogʲɪɪ̯ə
бихевиоризм	bʲɪxʲɪvʲɪɐrʲizm
білезік	bɘlʲezɘk
біліппін	bɘlɘppɘn
біліпті	bɘlɘptɘ
білу	bɘlʉw
білуге	bɘlʉwgʲe
білуден	bɘlʉwdʲen
білуді	bɘlʉwdɘ
бланк	blank
боран	borɑn
бос	bos
бөлік	bølʏk
бөлме	bølmø
бөлшек	bølʃøk
бөтен	bøtøn
бригадир	brʲɪgɐdʲir
бруней	brʊnʲej
бульдозер	bʊlʲdozʲɪr
буржуазия	bʊrʒʊɐzʲijə
бутерброд	bʊtɨrbrod
бухгалтерия	bʊɣɐɫtʲerʲɪɪ̯ə
бүкіләлемдік	bʉkʉɫælʲemdik
бұзау	bʊzɑw
бұлбұл	bʊɫbʊɫ
бұта	bʊtɑ
бұтақ	bʊtɑq
бюллетень	bʲʉlʲɪtʲenʲ
бюретка	bʲʉrʲetkə
бюро	bʲʊro
бюрократ	bʲʊrɐkrat
вагон	vɐgon
вакуоль	vəkʊolʲ
вакцина	vɐktsɨnə
вакцинация	vəktsɨnatsɨjə
валторна	vɐltornə
ватт	vat
вебер	vʲebʲɪr
ведомство	vʲedəmstvə
вексель	vʲeksʲɪlʲ
вектор	vʲektor
велоспорт	vʲɪlɐsport
вермишель	vʲɪrmʲɪʂɛlʲ
вирус	vʲirʊs
вирусология	vʲɪrʊsɐlogʲɪjə
виски	vʲiskʲɪ
волейбол	vəlʲɪjbol
вотум	votʊm
гадолиний	gədɐlʲinʲɪj
газет	gɐzʲet
галактика	gɐlaktʲɪkə
галерея	gəlʲɪrʲejə
галлюциноген	gəlʲʊtsɨnɐgʲen
галоген	gəlɐgʲen
галстук	gaɫstʊk
гангрена	gɐngrʲenə
гардероб	gərdʲɪrob
гастроль	gɐstrolʲ
гастрономия	gəstrɐnomʲɪɪ̯ə
гафний	gafnʲɪj
гватемала	gvətɨmalə
гемоглобин	gʲɪməglɐbʲin
генерал	gɛnɛraɫ
генетика	gʲɪnɛtʲɪkə
геном	gʲɪnom
генри	gʲenrʲɪ
геодезия	gʲɪɐdɛzʲɪjə
геоморфология	gʲeəmərfɐɫogʲɪɪ̯ə
германий	gʲɪrmanʲɪj
героин	gʲɪrɐin
герц	gʲerts
гигиена	gʲɪgʲɪjenə
гидравлика	gʲɪdravlʲɪkə
гидрид	gʲɪdrʲit
гидрография	gʲɪdrɐgrafʲɪɪ̯ə
гидроксид	gʲɪdrɐksʲid
гидролиз	gʲɪdrolʲɪz
гидромеханика	gʲidrəmʲɪxanʲɪkə
гимнаст	gʲɪmnast
гипербола	gʲɪpʲerbələ
гипертония	gʲɪpʲɪrtɐnʲijə
гипноз	gʲɪpnoz
гистамин	gʲɪstɐmʲin
гистология	gʲɪstɐlogʲɪjə
гликоген	glʲɪkɐgʲen
глицерин	glʲɪtsɨrʲin
глобус	gɫobʊs
глюкагон	glʲʊkɐgon
глюкоза	glʲʊkozə
глюкокортикоид	mʲɪnʲɪraɫəkərtʲɪkoɪd
глюконеогенез	glʲʊkənʲɪəgʲɪnʲes
гном	gnom
гну	gnu
гоблин	goblʲɪn
годограф	gɐdogrəf
госпиталь	gospʲɪtəlʲ
гравитон	grəvʲɪton
градус	gradʊs
грамматика	grɐmatʲɪkə
гранит	grɐnʲit
грант	grant
граффити	grɐfʲitʲɪ
гроссмейстер	grɐsmʲejsʲtʲɪr
гуаңжоу	gwɑŋdʒoʊ
губка	gupkə
гүл	gʏl
ғажайып	ʁɑʒɑjəp
ғаламат	ɣɑɫɑmɑt
ғаламшараралық	ɣɑɫɑmʃɑrɑrɑɫɯq
ғарыш	ɣɑrɯʂ
ғарышкер	ɣɑrɯʃkʲer
ғасыр	ɣɑsɯr
ғашық	ɣɑʃɯq
ғашықтық	ɣɑʃɯqtɯq
ғибадатхана	ɣɯjbɑdɑtxɑnɑ
дағдарыс	dɑɣdɑrɯs
дағдарыссыз	dɑɣdɑrɯssɯz
дайын	dɑjɯn
даңқ	daŋq
дармштадтий	dɐrmʃtatʲːɪj
даршын	dɑrʃɯn
дауыл	dɑwʊɫ
дауыс	dɑwʊs
дәмқосар	dæmqosɑr
дәрі	dærɪ
дәрігер	dærɘgʲer
дәріханашы	dærɘxɑnɑʃɯ
дебютант	dʲɪbʲʊtant
декларация	dʲɪklɐratsɨjə
делегация	dʲɪlʲɪgatsɨɪ̯ə
демалыс	demɑɫɯs
демократия	dʲɪmɐkratʲɪɪ̯ə
деонтология	dɛəntɐɫogʲɪɪ̯ə
департамент	dʲɪpɐrtamʲɪnt
депо	dʲɪpo
деспотизм	dʲɪspɐtʲizm
диагональ	dʲɪəgɐnalʲ
диалектика	dʲɪɐlʲektʲɪkə
диамагнетизм	dʲiəməgnʲɪtʲizm
диахрония	dʲɪəxrɐnʲiɪ̯ə
дизайн	dʲɪzajn
дизентерия	dʲɪzʲɪnʲtʲɪrʲijə
диктатор	dʲɪktatər
диктатура	dʲɪktɐturə
динозавр	dinɔzaw̜r
диод	dʲɪod
директор	dʲɪrʲektor
дирижабль	dʲɪrʲɪʒablʲ
дискотека	dʲɪskɐtʲekə
диспансер	dʲɪspɐnsɛr
дисплей	dʲɪsplɛj
диссертация	dʲɪsʲɪrtatsɨjə
дифтерия	dʲɪftʲɪrʲijə
дифференциал	dʲɪfʲɪrʲɪntsɨaɫ
диффузия	dʲɪfuzʲɪjə
домна	domnə
дөң	døŋ
драма	dramə
драматург	drəmɐturk
драматургия	drəmətʊrgʲiɪ̯ə
дубляж	dʊblʲaʒ
дубний	dubnʲɪj
дүкен	dʉ̞kø̞n
дүниежүзілік	dʉnyjːeʒʉzʉɫik
дүниетаным	dʉnɨjetɐnɯm
дұға	dʊɣɑ
дұрыс	dʊrʊs
дұшпан	dʊʃpɑn
е	ʲɛ
ежелгі	jeʒelgɘ
екібастұз	jekɘbɑsto̙z
елорда	jelordɑ
емдеу	jemdew
емле	jemle
ему	jemʉw
емхана	jemxɑnɑ
ертегі	jertegɘ
ертек	jertek
есепшот	jesʲepʃot
ешкім	jeʃkɘm
ешқашан	jeʃqɑʃɑn
ж	dʒ
жағдай	ʒɑɣdɑj
жақсы	ʑæχsə
жақтаушы	ʒɑqtɑwʃɯ
жаман	dʒɑmɑn
жаман	ʒɑmɑn
жамандық	ʒɑmɑndɯq
жан	ʒɑ̝n
жантану	dʒɑntɑnʊw
жаңаөзен	ʐɑŋɑɵzʲen
жапалақ	ʒɑpɑɫɑq
жарамды	ʒɑrɑmdɯ
жарық	ʒɑrɯq
жас	ʑɑs
жасуша	ʒɑsʊwʃɑ
жатақхана	ʒɑtɑqχɑnɑ
жауынгер	ʒɑwʊŋgʲer
жезқазған	ʐʲezqazɣɑn
жел	ʒel
желтоқсан	ʒeltoqsan
жеңіліс	ʒeŋɘlɘs
жеңімпаз	ʒeŋɘmpɑz
жеңіскер	ʒeŋɘskʲer
жеңуші	ʒeŋʏwʃɘ
жер	dʒer
жер	ʑe̞r
жеті	ʒeti
жетібұрыш	ʒetɘbʊrʊʃ
жібек	ʒɘbʲek
жолаушы	ʒoɫɑwʃɯ
жолбарыс	ʒolbɑɾɯs
жолбасшы	ʒoɫbɑsʃə
жохан	ʒɔxan
журналистика	dʒʊrnɐlʲisʲtʲɪkə
жуырда	ʒʊwʊrdɑ
жүз	ʒʏz
жүн	ʒʏn
жұдырық	ʒʊdʊrɯq
жұлдыз	ʒʊɫdʊz
жұту	ʒʊtʊw
жылау	ʒɯɫɑw
жылдық	ʒɯɫdɯq
жыныс	ʒɯnɯs
заңгер	zɑŋgʲer
заңнама	zaŋnəma
заңсыз	zɑŋsɯz
заңсыздық	zɑŋsɯzdɯq
запас	zɐpas
зауыт	zɑwɯt
зейнетақы	zʲejnʲetɑqɯ
зейнеткер	zʲejnʲetkʲer
зергер	zʲergʲer
зерттеуші	zʲertːewʃɘ
зертхана	zʲertxɑnɑ
зертханалық	zʲertxɑnɑɫɯq
зертханашы	zʲertxɑnɑʃɯ
зиверт	zʲivʲɪrt
зимбабве	zʲɪmbabvɛ
зор	zor
идеал	ɪdʲɪaɫ
идеология	ɪdʲɪɐɫogʲɪjə
идиллия	ɪdʲilʲɪjə
изоморфизм	ɪzəmɐrfʲizm
иммунитет	ɪmʊnʲɪtʲet
импеданс	ɪmpʲɪdans
император	ɪmpʲɪratər
империализм	ɪmpʲɪrʲɪɐlʲizm
импрессионизм	ɪmprʲɪsʲɪɐnʲizm
импульс	impʊlʲs
индоссамент	ɪndəsɐmʲent
инженер	ɪnʒɨnʲer
инновация	ɪnːɐvatsɨjə
интеграл	ɪntɨgral
интеллигенция	ɪnʲtʲɪlʲɪgʲentsɨjə
интернационализм	ɪntɨrnətsɨənɐlʲizm
интерполяция	ɪntɛrpɐlʲatsɨɪ̯ə
интерфейс	ɪntɨrfʲejs
интерферон	ɪntɨrfʲɪron
инфляция	ɪnflʲatsɨjə
иншалла	ɪnʃaɫa
ипотека	ɪpɐtʲekə
ислам	ɪslam
исландия	ɪslanʲdʲɪjə
испания	ɪspanʲɪjə
итбалық	ɘjtbɑɫɯq
із	ɘz
ішкі	ɘʃkɘ
кабак	kɐbak
кабинет	kabʲinʲet
калька	kalʲkə
кальмар	kɑlmɑr
кальцит	kɐlʲtsɨt
камфара	kəmfɐra
камфора	kamfərə
канада	kɐnadə
кандела	kɐndɛlə
каноэ	kɐnoɛ
капитал	kəpʲɪtal
капитализм	kəpʲɪtɐlʲizm
карамель	kərɐmʲelʲ
карнавал	kərnɐvaɫ
карта	kartə
картель	kɐrtɛlʲ
картечь	kɐrtʲetɕ
картография	kərtɐgrafʲɪjə
картоп	kɑrtop
катал	kɐtal
католик	kɐtolʲɪk
кахексия	kəxʲɪksʲiɪ̯ə
каюта	kɐjutə
кәмпит	kæmpɘjt
квадрант	kvɐdrant
кедейлік	kʲedejlɘk
кейін	kʲejɘn
кек	kʲek
келісім	kʲelɘsɘm
келу	kʰʲelʉw
келуші	kʰʲelʉwʂɘ
кельвин	kʲelʲvʲɪn
кеміру	kʲemɘrʏw
кентау	kʲentɑw
кең	kʲeŋ
кесене	kʲesʲenʲe
кету	kʰʲetʉw
кешіру	kʲeʃɘrʏw
кибернетик	kʲɪbʲɪrnɛtʲɪk
киім	kɪjɪm
кинематография	kʲɪnʲɪmətɐgrafʲɪjə
кинетика	kʲɪnɛtʲɪkə
кинокартина	kʲɪnəkɐrtʲinə
кинорежиссёр	kʲɪnərʲɪdʒɨsʲɵr
кинотеатр	kʲɪnətʲɪatr
кинофестиваль	kʲɪnəfʲɪsʲtʲɪvalʲ
кинофильм	kʲɪnɐfʲilʲm
кисель	kʲɪsʲelʲ
кию	kʰijʉw
кір	kɘr
кісі	kʰɘsɘ
кітап	kɘ̥̆tæp
кітап	kɘ̥̆tɑ̝p
кітапнама	kɘtɑpnɑmɑ
кітапхана	kʰtɑpχɑnɑ
кішкентай	kɘʃkʲentɑj
классика	klasʲɪkə
классицизм	kɫəsʲɪtsɨzm
клерк	klʲerk
климатология	klʲɪmətɐlogʲɪjə
кодекс	kodɨks
комбайн	kɐmbaɪ̯n
комедия	kɐmʲedʲɪjə
комиссар	kəmʲɪsar
комитет	kəmʲɪtʲet
коммунизм	kəmʊnʲizm
коммунист	kəmʊnʲist
коммутатор	kəmʊtatər
компьютер	kɐmpjutɨr
конвейер	kɐnvʲeɪr
конверсия	kɐnvʲersʲɪɪ̯ə
конгломерат	kəngɫəmʲɪrat
конденсат	kəndɛnsat
конкур	kɐnkur
консалтинг	kɐnsaɫtʲɪnk
консорциум	kɐnsortsɨʊm
конституция	kənsʲtʲɪtutsɨjə
конституциялық	kənsʲtʲɪtutsɨɪ̯əɫəq
конструктивизм	kənstrʊktʲɪvʲizm
контейнер	kɐntɛjnʲɪr
континуум	kɐnʲtʲinʊʊm
контрреволюционер	kontrʲːɪvəlʲʊtsɨɐnʲer
конференция	kənfʲɪrʲentsɨɪ̯ə
конфигурация	kənfʲɪgʊratsɨjə
конформация	kənfɐrmatsɨɪ̯ə
копенгаген	kəpʲɪngagʲɪn
корея	kɐrʲejə
косеканс	kɐsɛkəns
косинус	kosʲinʊs
космополитизм	kəsməpəlʲɪtʲizm
котангенс	kɐtangʲɪns
коэффициент	kəɪfʲɪtsɨɛnt
көйлек	køjløk
көк	køk
көкек	køkøk
көкекшөп	køkøkʃøp
көктем	køktøm
көкшетау	kɵkʂʲetɑw
көмек	kømøk
көмекші	kømøkʃɘ
көрме	kørmø
көтеріліс	køtʲerɪlɪs
көтерілісші	køtʲerɪlɪsʃɪ
көтеру	køterʏw
кредит	krʲedʲɪt
кремний	krʲemnʲɪj
креп	krʲep
криминалистика	krʲɪmʲɪnɐlʲisʲtʲɪkə
криптовалюта	krʲiptəvɐlʲutə
криптон	krʲɪpton
кристаллография	krʲɪstəɫɐgrafʲɪɪ̯ə
круиз	krʊiz
ксенофобия	ksʲɪnɐfobʲɪjə
ксилофон	ksʲɪlɐfon
куба	kubə
кувейт	kʊvʲejt
культуризм	kʊlʲtʊrʲizm
купон	kʊpon
күйсандық	kʏjsɑndɯq
күкірт	kʉkirt
күмбез	gʉ̞mbø̞z
күмбез	kʰʉ̞mbø̞z
күн	gʉ̞n
күн	kʰʉ̞n
күнәкар	kynækɑr
күнәһар	kynæhɑr
күнбағыс	kʏnbɑɣɯs
күнделік	kʏndelɘk
күшән	kʉʃæn
қабір	qɑbɘɾ
қағаз	qɑɣɑz
қазақ	qʰɑ̝zɑ̝qʰ
Қазақстан	qʰɑ̝zɑ̝qstɑ̝n
қазіргі	qɑzɘrgɘ
қайық	qɑjɯq
қала	qɑɫɑ
қалайсың	qɑɫɑjsɪŋ
қалампыр	qɑɫɑmpɯr
қалмақ	qʰɑ̝ɫmɑ̝qʰ
қалу	qɑlʊw
қамыс	qɑmɯs
қанқұмар	qɑnqʊmɑr
қаңтар	qaŋtar
қап	qɑp
Қарағанды	qɑɾɑɣɑndɯ
қараша	qaraʃa
қарбыз	qɑrbɯz
қарлығаш	qɑrɫɯɣɑʃ
қатесіз	qɑtʲesɪz
қауын	qɑwɯn
қоғамдастық	qoɣɑmdɑstɯq
қойшы	qojʃɯ
қолтырауын	qoltɯrɑwɯn
қоңыз	qoŋʊz
қорғаушы	qorɣɑwʃɯ
қоспа	qospɑ
Қостанай	qostanaj
қоюландырғыш	qojʊwɫɑndɯrɣɯʃ
құдай	qʊdaj
құдайсыз	qʊdɑjsɯz
құдайсыздық	qʊdɑjsɯzdɯq
құдайтанушы	qʊdajtanʊwʃɯ
құжаттама	qʊʒɑtːɑmɑ
құзғын	qʊzɣʊn
құйрық	qʊjrəq
құқық	qʊqʊq
құқықсыз	qʊqʊqsɯz
құқықтану	qʊqʊqtɑnʊw
құмайт	qʊmɑjt
құрал	qurɑɫ
құрам	qʊrɑm
құрама	qʊrɑmɑ
құрылым	qʊrʊɫɯm
құрылыс	qʊrʊlɯs
қызығушылық	qɯzɯɣʊwʃɯɫɯq
қыл	qɯɫ
қылмыс	qɯɫmɯs
қылмыскер	qɯɫmɯskʲer
қылмыстық	qɯɫmɯstɯq
қылмыстылық	qɯɫmɯstɯlɯq
қымбат	qɯmbɑt
қыпшақ	qɯpʃɑq
қырғауыл	qɯrɣɑwɯɫ
Қырғызстан	qəɾʁəzstɑn
Қырғызстан	qɯrʁɯzstɑn
қыркүйек	qɯrkʏjjøk
қырыққабат	qɯrɯqːɑbɑt
Қытай	qʰə̠tɑj
қытай	qʰə̠tɑj
қышқыл	qɯʃqɯɫ
лагуна	ɫɐgunə
ландшафт	lɐnʃaft
лексикография	lʲɪksʲɪkɐgrafʲɪjə
лемниската	lʲɪmnʲɪskatə
лемур	lʲɪmur
либерал	lʲɪbʲɪraɫ
либерализм	lʲɪbʲɪrɐlʲizm
ливерморий	lʲɪvʲɪrmorʲɪj
ликёр	lʲɪkʲɵr
лимон	lʲɪmon
лимонен	lʲɪmɐnɛn
лимфоцит	lʲɪmfɐtsɨt
лингвистика	lʲɪngvʲisʲtʲɪkə
линолеум	lʲɪnolʲɪʊm
литосфера	lʲɪtɐsfʲerə
лихтенштейн	lʲɪxtɨnʃtɛjn
лицензия	lʲɪtsɛnʲzʲɪjə
логика	ɫogʲɪkə
логистика	ɫɐgʲisʲtʲɪkə
логос	ɫogəs
лори	ɫorʲɪ
лоуренсий	ləʊrʲensʲɪj
люкс	lʲuks
люксембург	lʲʊksʲɪmburg
люмен	lʲʉmʲɪn
лютеций	lʲʊtɛtsɨj
лютня	lʲʉtʲnʲə
мавритания	məvrʲɪtanʲɪjə
магма	magmə
магний	magnʲɪj
мағына	mɑʁənɑ
мадагаскар	mədəgɐskar
май	maj
маймыл	mɑjmɯɫ
майонез	mɐjɔnɛz
макака	mɐkakə
макияж	məkʲɪjaʒ
малшы	mɑɫʃɯ
мамыр	mamɯr
маңызды	mɑŋɯzdɯ
марафон	mərɐfon
маржан	mɑrʒɑn
марихуана	mərʲɪxʊanə
мармелад	mərmʲɪɫad
маршал	marʃəɫ
маскарад	məskɐrad
мата	mɑtɑ
матай	mataj
матбуғат	mɑtbuʁɑt
математик	mətʲɪmatʲɪk
математика	mətʲɪmatʲɪkə
материализм	mətʲɪrʲɪɐlʲizm
мә	mæ
мәгәзін	mægæzin
мәдениетсіз	mædenɪjːetsɪz
мәдениетсіздік	mædenɘjːetsɘzdɘk
мәдениеттану	mædenɘjːetːɑnʊw
мәлдивтер	mæɫdʲɪvtʲer
мәртебе	mærtʲebe
мәселе	mæsʲele
мәскеу	mæskʲew
медаль	mʲɪdalʲ
медицина	mʲɪdʲɪtsɨnə
мезон	mʲɪzon
мейоз	mʲɪjɵs
мейрамхана	mʲejrɑmxɑnɑ
мейтнерий	mʲɪjtʲnʲerʲɪj
меланезия	mʲɪɫɐnʲezʲɪjə
меңгеруші	mʲeŋgʲerʏwʃɘ
метастаз	mʲɪtɐstaz
метафизика	mʲɪtɐfʲizʲɪkə
метафраза	mʲetɐfrazə
метеорология	mʲɪtʲɪərɐlogʲɪjə
метрдотель	mɛtrdotɛlʲ
метро	mʲɪtro
метрополитен	mʲɪtrəpəlʲɪtɛn
микроавтобус	mʲikrɐɐftobʊs
микроскоп	mʲɪkrɐskop
микрофон	mʲɪkrɐfon
милиционер	mʲɪlʲɪtsɨɐnʲer
миллион	mʲɪlʲɪon
минералокортикоид	mʲɪnʲɪraɫəkərtʲɪkoɪd
минимализм	mʲɪnʲɪmɐlʲizm
министр	mʲɪnʲistr
минут	minʊt
миокардит	mʲɪəkɐrdʲit
мирас	mɯjrɑs
мистицизм	mʲɪsʲtʲɪtsɨzm
митохондрия	mʲɪtɐxondrʲɪjə
мнемоника	mnʲɪmonʲɪkə
модернизм	mədʲɪrnʲizm
модуль	modʊlʲ
молдова	mɐldovə
молекула	mɐlʲekʊlə
мольберт	mɐlʲbʲert
монархия	mɐnarxʲɪɪ̯ə
монизм	mɐnʲizm
моногамия	mənɐgamʲɪjə
монография	mənɐgrafʲɪjə
мономер	mənɐmʲer
морфология	mərfɐɫogʲɪɪ̯ə
мөр	mør
музыка	muzɨkə
мультимедиа	mʊlʲtʲɪmʲedʲɪə
мультипликация	mʊlʲtʲɪplʲɪkatsɨɪ̯ə
мультфильм	mʊlʲtfʲilʲm
муниципалитет	mʊnʲɪtsɨpəlʲɪtʲet
мутант	mʊtant
мүлік	mʏlʏk
мүмкіндік	mʏmkʏndɘk
мүрде	mʉrdʲe
мүрдеші	mʉrdʲeʃɘ
мұз	mʊz
мұздатқыш	mʊzdɑtqɯʃ
мұздық	mʊzdʊq
мұздықаралық	mʊzdʊqɑrɑɫɯq
мұқтаж	mʊqtɑʒ
мұрағат	mʊrɑɣɑt
мұрағатшы	mʊrɑɣɑtʃɯ
мұражай	mʊrɑʒɑj
мұсылман	mʊsʊɫmɑn
мұхит	mʊxɯjt
мылтық	mɯɫtɯq
мюзикл	mʲʉzʲɪkɫ
найза	nɑjzɑ
намаз	nɑ̝mɑ̝z
нарциссизм	nərtsɨsʲizm
натрий	natrʲɪj
натюрморт	nətʲʊrmort
науру	nɐurʊ
наурыз	nawrɯz
наутилус	nəʊtʲiɫʊs
нафталин	nəftɐlʲin
наша	nɑʃɑ
нашар	nɑʃɑr
нәсілшіл	næsɘlʃɘl
нәсілшілдік	næsɘlʃɘldɘk
нәтижелі	nætɘjʒelɘ
нәтижелілік	nætɘjʒelɘlɘk
нәтижесіз	nætɘjʒesɘz
нейтрон	nʲɪjtron
ноктюрн	nɐktʲurn
норвегия	nɐrvʲegʲɪjə
норматив	nərmɐtʲif
ноутбук	noʊdbʊk
нөл	nɵl
нумизматика	nʊmʲɪzmatʲɪkə
нутация	nʊtatsɨɪ̯ə
нұр	nur
ньютон	nʲjʊton
облигация	ɐblʲɪgatsɨjə
облыс	wo̞bləs
объект	ɐbjekt
оганесон	ɐgənʲɪson
одақ	wodɑq
одиссея	ɐdʲɪsʲeɪ̯ə
одометр	ɐdomʲɪtr
ойнап	wojnɑp
ойыншы	wojʊnʃɯ
океания	ɐkʲɪanʲɪjə
округ	okrʊg
оқиға	woqɯjɣɑ
оқулық	woqʊwɫʊq
олигархия	ɐlʲɪgarxʲɪjə
олигомер	wolʲɪgɐmʲer
олиготроф	wolʲɪgɐtrof
ом	om
омбы	wombɯ
омоним	ɐmonʲɪm
оникс	onʲɪks
онлайн	onlajn
ономастика	ɤnɐmastʲɪkə
оңтүстік	woŋtstʉ̞k
операция	ɐpʲɪratsɨɪ̯ə
опоссум	ɐposʊm
оппортунизм	ɐpərtʊnʲizm
орал	worɑɫ
оратория	ɐrɐtorʲɪɪ̯ə
орман	wormɑn
орфография	ɐrfɐgrafʲɪɪ̯ə
орфографиялық	ɐrfɐgrafʲɪɪ̯ələq
орынбасар	worʊnbɑsɑr
орыс	wo̙rʊs
от	wot
отан	wo̞tɑn
отбасы	wotbɑsɯ
отын	wotən
өзара	øzɑrɑ
Өзбекстан	œzbʲekstɑn
Өзбекстан	œzbʲɪkstɑn
өзбекстандық	wøzbekstɑndəq
өйткені	ʏ̯œjtkenɘ
өлі	wøly
өлім	wølʏm
өлтіру	wøltʏrʏw
өмірбаян	yømyrbɑjɑn
өнім	wønʏm
өсиет	wøsɘjjet
өсиетші	yøsyjːetʃɪ
өсімдік	wøsʏmdɘk
өсу	wøsʏw
өтем	wøtøm
өтініш	wøtʏnɘʃ
павлодар	pɑvɫədɑr
пайғамбар	pajɣambar
палата	pɐɫatə
палеобиология	palʲɪəbʲɪɐɫogʲɪɪ̯ə
палеография	pəlʲɪɐgrafʲɪɪ̯ə
палеоклиматология	palʲɪəklʲɪmətɐɫogʲɪɪ̯ə
панк	pank
панорама	pənɐramə
папирос	pəpʲɪros
парагвай	pərɐgvaj
парадигма	pərɐdʲigmə
парадокс	pərɐdoks
паразит	pərɐzʲit
парақор	pɑrɑqor
парақорлық	pɑrɑqorɫɯq
параллакс	pərɐɫaks
параллелограмм	pərəlʲɪɫɐgram
параметр	pɐramʲɪtr
паранойя	pərɐnoɪ̯ːə
парламент	pɐrɫamʲɪnt
партизан	pərtʲɪzan
партизандық	pərtʲɪzandəq
партия	partʲɪjə
парфюмерия	pərfʲʉmʲerʲɪɪ̯ə
пастор	pastər
патент	pɐtʲent
патоген	pətɐgʲen
патогенез	patəgʲɪnɛs
патриарх	pətrʲɪarx
пацифизм	pətsɨfʲizm
паштет	pɐʃtʲet
пәкістан	pækɘstɑn
пәкістан	pækistan
пәкістан	pækistɑn
пәкістан	pækɪstɑn
пәлсапа	pæɫsɑpɑ
педагог	pʲɪdɐgog
пептид	pʲɪptʲid
перғауын	pʲerɣɑwɯn
пері	pʲerɘ
періште	pʲerɘʃte
петиция	pʲɪtʲitsɨjə
пиксель	pʲiksʲɪlʲ
пилотка	pʲɪɫotkə
пирамида	pʲɪrɐmʲidə
пиримидин	pʲɪrʲɪmʲɪdʲin
плазмид	pɫɐzmʲid
плазмида	pɫɐzmʲidə
пластик	pɫasʲtʲɪk
пленум	plʲenʊm
позитивизм	pəzʲɪtʲɪvʲizm
позитрон	pəzʲɪtron
полимер	pəlʲɪmʲer
полиомиелит	polʲɪəmʲɪɪ̯ɪlʲit
полонез	pəɫɐnɛz
порнография	pərnɐgrafʲɪɪ̯ə
порт	port
постмодернизм	postmədɛrnʲizm
пошта	poʃta
пошталық	poʃtaɫɯq
пошташы	poʃtaʃɯ
поэзия	pɐɛzʲɪjə
поэтика	pɐɛtʲɪkə
преамбула	prʲɪambwʊɫə
предикат	prʲɪdʲɪkat
предикатив	prʲɪdʲɪkɐtʲif
президент	prʲɪzʲɪdʲent
призма	prʲizmə
примат	prʲɪmat
принтер	prʲintɛr
провинция	prɐvʲintsɨɪ̯ə
прогестерон	prəgʲɪstɛron
прокуратура	prəkʊrɐturə
прокурор	prəkʊror
протекционизм	prətʲɪktsɨɐnʲizm
прототип	prətɐtʲip
профиль	profʲɪlʲ
психиатрия	psʲɪxʲɪɐtrʲijə
психоз	psʲɪxoz
психология	psʲɪxɐlogʲɪjə
публицистика	pʊblʲɪtsɨsʲtʲɪkə
пульмонология	pʊlʲmənɐɫogʲɪɪ̯ə
пьеса	pjesə
раввин	rɐvʲin
радиан	rədʲɪan
радиозонд	radʲɪozond
радиостанция	rədʲɪɐstantsɨjə
раритет	rərʲɪtʲet
рахмет	ɾæχmje̘t
рәміз	ræmɘz
реализм	rʲɪɐlʲizm
ревматизм	rʲɪvmɐtʲizm
регрессия	rʲɪgrɛsʲɪjə
редакция	rʲɪdaktsɨjə
режим	reʒɪm
резерват	rʲɪzʲɪrvat
резерфордий	rʲɪzʲɪrfordʲɪj
резистор	rʲɪzʲistər
рейтинг	rɛjtʲɪnk
ректор	rʲektor
ресми	resmɘj
реституция	rʲɪsʲtʲɪtutsɨɪ̯ə
референдум	rʲɪfʲɪrʲendʊm
реформа	rʲɪformə
реформатор	rʲɪfɐrmatər
реформизм	rʲɪfɐrmʲizm
рецептор	rʲɪtsɛptər
риддер	ɾɪddɛɾ
робототехника	rəbətɐtʲexnʲɪkə
романтизм	rəmɐnʲtʲizm
романтикалық	rɐmantʲɪkəɫɯq
россия	rɐsʲijə
рота	rotə
руанда	rʊandə
рұқсат	rʊqsɑt
рұқсатнама	rʊqsɑtnɑmɑ
сабыр	sɑbɯr
сага	sagə
сағатшы	sɑɣɑtʃɯ
садақ	sɑdɑq
сазгер	sɑzgʲer
сайлаушы	sɑjɫɑwʃɯ
сақал	sɑqɑɫ
сақтандырғыш	sɑqtɑndɯrɣɯʃ
сала	saɫa
саламандра	səɫɐmandrə
салат	sɐɫat
салауат	sɑɫɑwɑt
салт	sɑɫt
салық	sɑɫɯq
салым	sɑɫɯm
сальвадор	səlʲvɐdor
самоа	sɐmoə
сандуғаш	sanduwʁaʃ
сандық	sɑndɯq
санкция	sanktsɨjə
саңырауқұлақ	sɑŋɯrɑwɣʊɫɑq
саран	sɑɾɑn
сарғылт	sɑrɣɯɫt
саркома	sɐrkomə
сая	sɑ̝̙jɑ̝̙
саяжол	sɑjɑʒoɫ
саясат	sɑjɑsɑt
саясаткер	sɑjɑsɑtkʲer
саясаттанушы	sɑjɑsɑtɑnʊwʃɯ
саясатшы	sɑjɑsɑtʃɯ
саяхатшы	sɑjɑxɑtʃɯ
сәбихана	sæbɪjxɑnɑ
сәлем	sælje̘m
сәтбаев	sætpɑjef
сәуле	sæwlʲe
сәулет	sæwlet
сегіз	sʲegiz
сейсмограф	sʲɪjsmogrəf
секанс	sɛkəns
секстант	sʲɪkstant
секстет	sɛksʲtʲet
секунд	sʲekʊnd
селен	sʲɪlʲen
селенит	sʲɪlʲɪnʲit
семантика	sʲɪmanʲtʲɪkə
семей	sʲemʲej
семинар	sʲɪmʲɪnar
семиотика	sʲɪmʲɪotʲɪkə
сенат	sʲɪnat
сепсис	sɛpsʲɪs
сербия	sʲerbʲɪjə
серпентинит	sʲɪrpʲɪnʲtʲɪnʲit
сертификат	sʲɪrtʲɪfʲɪkat
сессия	sɛsʲɪɪ̯ə
сигнал	sʲɪgnaɫ
силикоз	sʲɪlʲɪkoz
символизм	sʲɪmvɐlʲizm
сименс	sʲimʲɪns
синагога	sʲɪnɐgogə
сингапур	sʲɪngɐpur
синдикализм	sʲɪnʲdʲɪkɐlʲizm
синдикат	sʲɪnʲdʲɪkat
синдром	sʲɪndrom
синкретизм	sʲɪnkrʲɪtʲizm
синоним	sʲɪnonʲɪm
синтезатор	sʲɪntɨzatər
синус	sʲinʊs
сілеусін	sɪlewsɪn
сіріңке	sɘrɘŋkʲe
скейтбординг	skʲɪɪ̯dbordʲɪnk
скипидар	skʲɪpʲɪdar
словения	slɐvʲenʲɪjə
соғысу	soɣʊsʊw
содан	sodɑn
солитон	səlʲɪton
соло	soɫo
сомали	səmɐlʲi
сору	sorʊw
сот	sot
софтбол	sɐftboɫ
социализм	sətsɨɐlʲizm
социалистік	sətsɨəlʲɪstɘk
сөздік	søzdʏk
сөздікжасам	søzdʏkʒɑsɑm
спам	spam
спектроскопия	spʲɪktrəskɐpʲijə
спидометр	spʲɪdomʲɪtr
спорт	sport
стақан	stɐqan
стандартты	stɐndartɯ
стандарттық	stɐndartɯq
статика	statʲɪkə
стационар	stətsɨɐnar
степлер	stɛplʲɪr
степногорск	stʲepnɐgɔɾsk
стерадиан	stɛrədʲɪan
стероид	stʲɪroɪd
стратиграфия	strətʲɪgrafʲɪjə
студент	stʊdʲent
су	suw
субъект	sʊbjekt
сулы	suwlˠə
сумо	sʊmo
супермаркет	sʊpʲɪrmarkʲɪt
сурет	sʉwrʲet
суретші	sʉwrʲetʃɘ
суринам	sʊrʲɪnam
суфле	sʊflʲe
суық	sʊwʊq
сүйек	sʏjø̞k
сүйіс	sʉjɘs
сұрақ	sʊrɑq
сылақшы	sɯlɑqʃɯ
сыра	sɯrɑ
сыртқы	sɯrtqɯ
сюрреализм	sʲʉrʲɪɐlʲizm
сюрреалистік	sʲʉrʲɪəlʲɪsʲtik
таба	tɑbɑ
табан	tɑbɑn
табиғат	tɑbɯjɣɑt
табыс	tɑbɯs
таға	tɑɣɑ
тағдыр	tɑɣdɯr
таж	tɑʒ
тайфун	tɐjfun
тақта	tɑqtɑ
талап	tɑɫɑp
талдықорған	tɑɫdɯqɔɾɣɑn
тамақ	tɑmɑq
тамам	tɑmɑm
тамарин	təmɐrʲin
тамаринд	təmɐrʲind
тамыз	tamɯz
тамыр	tɑmɯr
танау	tɑnɑw
тангенс	tangʲɪns
танк	tank
тану	tɑnʊw
таңертең	tɑŋerteŋ
таңқурай	tɑŋqʊwrɑj
тапанша	tɑpɑnʃɑ
тараз	taɾaz
таразы	tɑrɑzɯ
тарих	tɑrɪx
тарихшы	tɑrɯjxʃɯ
тау	tʰɑw
таулық	tɑwɫɯq
тауық	tɑwʊq
тахометр	tɐxomʲɪtr
таяқ	tɑjɑq
тәжірибе	tæʒɘrɘjbʲe
тәсбих	tæsbʲix
тәсіл	tæsɪl
тезис	tɛzʲɪs
тек	tek
телевидение	tʲɪlʲɪvʲidʲɪnʲɪje
телеграф	tʲɪlʲɪgraf
телескоп	tʲɛlʲɛskop
телефон	tʲilʲifon
теміртау	tʲemɘɾtɑw
температура	tʲɪmpʲɪrɐturə
теңдік	teŋdɘk
теңізші	teŋɘʃʃɘ
теңсіздік	teŋsɘzdɘk
теократия	tʲɪɐkratʲɪjə
теорема	tʲɪɐrʲemə
теория	tʲɪorʲɪjə
терең	tereŋ
термин	tʲermʲɪn
терминология	tʲɪrmʲɪnɐɫogʲɪjə
термодинамика	tʲermədʲɪnamʲɪkə
термометр	tʲɪrmomʲɪtr
террариум	tɛrarʲɪʊm
территория	tʲɪrʲɪtorʲɪjə
терроризм	tʲɪrɐrʲizm
тесік	tesɘk
тетраэдр	tʲɪtraɪdr
техник	tʲexnʲɪk
техникум	tʲexnʲɪkʊm
технология	tʲɪxnɐɫogʲɪɪ̯ə
тибеттану	tʲɪbʲetanʊw
типология	tʲɪpɐɫogʲɪjə
тікбұрыш	tɘkbʊrʊʃ
тілмаш	tɘlmɑʃ
тоғай	toɣɑj
токсикология	təksʲɪkɐɫogʲɪɪ̯ə
тоқсан	tʰoqsɑn
тоқылдақ	toqʊɫdɑq
толқын	toɫqən
толы	toɫə
толықтауыш	toɫɯqtɑwɯʃ
тоңазытқыш	toŋɑzɯtqɯʃ
топ	top
топырақ	topɯrɑq
төбе	tøbø
төбелес	tøbøles
төгу	tøgʏw
төлеу	tøløw
төлеуші	tøløwʃɘ
төраға	tørɑɣɑ
төсек	tøsøk
трагедия	trɐgʲedʲɪjə
трактор	traktor
транзистор	trɐnzʲistər
транскрипция	trɐnskrʲiptsɨjə
трансұлттық	transʊɫttʊq
трапеция	trɐpʲetsɨjə
трахома	trɐxomə
триангуляция	trʲɪəngʊlʲatsɨɪ̯ə
триатлон	trʲɪɐtlon
триод	trʲɪod
тромбон	trɐmbon
тротуар	trətʊar
ту	tʊw
туба	tubə
турбина	tʊrbʲinə
туризм	tʊrʲizm
турист	tʊrʲist
туу	tʰuwuw
туф	tuf
туыстық	tʊwəstəq
түйме	tʏjmø
түнек	tʏnøk
түркістан	tʏɾkɘstɑn
түркітану	tyrkɪtɑnʊw
түркітанушы	tyrkɪtɑnʊwʃɯ
түрме	tʏrmø
түс	tʏs
тұл	tʊɫ
тұман	tʊmɑn
тұрғын	turɣɨn
тұрғын	tʊrɣɨn
тұту	tʰʊtuw
тұяқты	tʊjɑqtɯ
тыл	tɯl
тың	tɯŋ
тырнақ	tɯrnɑq
уганда	ʊgandə
улы	ʊwɫʊ
ультрамикроскоп	ulʲtrəmʲɪkrɐskop
университет	ʊnʲɪvʲɪrsʲɪtʲet
униформа	ʊnʲɪformə
уругвай	ʊrʊgvaj
утилитаризм	ʊtʲɪlʲɪtɐrʲizm
учаске	ʊtɕaskʲe
үйрету	ʏjrøtʏw
үйретуші	ʏjrøtʏwʃɘ
үкі	ʏkʏ
үкімет	ʉ̞kmet
үкіметаралық	ʏkʏmʲetɑrɑɫɯq
үлкен	ʏlkøn
үміт	ʏmʏt
үмітсіздік	ʏmʏtsɘzdɘk
үндемеу	ʏndømʲew
үст	ʏst
ұғым	ʊɣʊm
ұжым	ʊʒʊm
ұзындық	ʊzʊndɯq
ұйғыр	joʁor
ұйғыр	ojʁor
ұйықтапты	ŏ̙jo̙qtɑ̝̙ptə̝̙
ұйықтау	ʊjʊqtɑw
ұл	ʊɫ
ұлттық	ʊɫttʊq
ұлтшылдық	ʊɫtʃʊɫdɯq
ұрпақ	ʊrpɑq
ұшақ	ʊʃɑq
ұя	ʊjɑ
ұят	ʊjɑt
ұятсыздық	ʊjɑtsɯzdɯq
фагот	fɐgot
факт	fakt
фактор	faktər
факториал	fəktərʲɪal
факультет	fəkʊlʲtʲet
фантастика	fɐntasʲtʲɪkə
фарад	fɐrad
фармацевт	fərmɐtsɛft
фастфуд	fɐstfud
фәлсапа	fæɫsɑpɑ
фәлсафа	fæɫsɑfɑ
федерация	fʲɪdʲɪratsɨjə
феминизм	fʲɪmʲɪnʲizm
феноменология	fʲɪnəmʲɪnɐɫogʲɪjə
фенотип	fʲɪnɐtʲip
феодализм	fʲɪədɐlʲizm
фетиш	fɛtʲiʃ
фибриноген	fʲɪbrʲɪnɐgʲen
физиология	fʲɪzʲɪɐlogʲɪjə
филиппиндер	fʲɪlʲɪpʲindʲer
филология	fʲɪɫɐɫogʲɪjə
философия	fʲɪɫɐsofʲɪɪ̯ə
финляндия	fʲɪnlʲænʲdʲɪjə
фобия	fobʲɪɪ̯ə
фовизм	fɐvʲizm
фонема	fɐnɛmə
фонетика	fɐnɛtʲɪkə
фонон	fɐnon
формализм	fərmɐlʲizm
формула	formʊɫə
форум	forʊm
фосфор	fosfər
фуга	fugə
фундаментализм	fʊndəmʲɪntɐlʲizm
функционал	fʊnktsɨɐnaɫ
функционализм	fʊnktsɨənɐlʲizm
функция	funktsɨɪ̯ə
футуризм	fʊtʊrʲizm
фюзеляж	fʲʊzelʲɑʒ
халық	χɑɫəq
хан	χɑ̝n
хаос	xɐos
хассий	xasʲɪj
хатшы	xɑtʃɯ
химия	xʲimʲɪjə
хирург	xʲɪrurg
хирургия	xʲɪrʊrgʲiɪ̯ə
хлор	xlor
хлоропласт	xlərɐplast
хлороформ	xlərɐform
холестерин	xəlʲɪstɨrʲin
хорватия	xɐrvatʲɪjə
храм	xram
христиан	xrʲɪsʲtʲɪan
хроматин	xrəmɐtʲin
хромосома	xrəmɐsomə
хронология	xrənɐɫogʲɪɪ̯ə
чемпионат	tɕɪmpʲɪɐnat
шабдалы	ʃɐbdɑlə
шағыр	ʃɑɣɯr
шай	ʃæj
шай	ʃɑ̝j
шақыру	ʃɑqɯrʊw
шалғам	ʃɑɫɣɑm
шам	ʃam
шаң	ʃɑŋ
шаңхай	ʃaŋxaj
шара	ʃara
шарманка	ʃɐrmankə
шаршы	ʃɑrʃɯ
шахтинск	ʂɑχtʲɪnsk
шаштараз	ʃɑʃtɑrɑz
швеция	ʃvʲetsɨjə
шекарашы	ʃeqɑrɑʃɯ
шие	ʃɘjje
шизофрения	ʃɨzəfrʲɪnʲijə
шимпанзе	ʃɨmpɐnzɛ
шина	ʃina
шифр	ʃɨfr
шоколад	ʃɔkəlad
шөл	ʃøl
шүбә	ʃʏbæ
шығанақ	ʃɯɣɑnɑq
шығыстану	ʃɯɣɯstɑnʊw
шығыстанушы	ʃɯɣɯstɑnʊwʃɯ
шымкент	ʃɯmkʲɪnt
щучинск	ɕutʃɪnsk
ықпал	ɯqpɑɫ
ылғал	ɯɫɣɑɫ
ылғалды	ɯɫɣɑɫdɯ
ым	ɯm
ыңғайлы	ɯŋɣɑjɫɯ
ырым	ɯrɯm
ыстық	ɯstɯq
эвакуация	ɛvəkʊatsɨɪ̯ə
эволюция	ɪvɐlʲutsɨjə
экзистенциализм	ɛgzʲɪstɛntsɨɐlʲizm
эклектизм	ɛklʲɪktʲizm
экология	ɪkɐlogʲɪjə
экосфера	ɛkɐsfʲerə
экотоксикология	ɛkətəksʲɪkɐɫogʲɪɪ̯ə
экскаватор	ɛkskɐvatər
экскурсия	ɪkskursʲɪjə
экспансия	ɛkspansʲɪɪ̯ə
экспрессионизм	ɪksprʲɪsʲɪɐnʲizm
экстремизм	ɛkstrʲɪmʲizm
экстремум	ɛkstrʲemʊm
электрокардиография	ɛlʲektrəkərdʲɪɐgrafʲɪɪ̯ə
электролиз	ɪlʲɪktrolʲɪs
электролит	ɛlʲɪktrɐlʲit
электрон	ɪlʲɪktron
электроника	ɪlʲɪktronʲɪkə
электроскоп	ɛlʲɪktrɐskop
элемент	ɪlʲɪmʲent
эллипс	ɛlʲɪps
эллипсоид	ɛlʲɪpsoɪd
эмансипация	ɛmənsʲɪpatsɨɪ̯ə
эмблема	ɛmblʲemə
эмбриология	ɛmbrʲɪɐlogʲɪɪ̯ə
эмигрант	ɛmʲɪgrant
эмиссия	ɛmʲisʲɪɪ̯ə
энтальпия	ɛntɐlʲpʲiɪ̯ə
энтропия	ɪntrɐpʲijə
энциклопедия	ɪntsɨklɐpʲedʲɪjə
эпиграф	ɪpʲigrəf
эпистемология	ɪpʲɪsʲtʲɪmɐɫogʲɪjə
эрозия	ɛrozʲɪɪ̯ə
эстетизм	ɛstɛtʲizm
эстетика	ɪstɛtʲɪkə
этика	ɛtʲɪkə
этиология	ɪtʲɪɐlogʲɪjə
этноним	ɛtnonʲɪm
этюд	ɛtʲud
эфиопия	ɪfʲɪopʲɪjə
яхта	jaxtə
абайлашы	ɑbɑjlɑʃɯ
автобус	ɑfˈtobʊs
автрия	ɑftˈrijɑ
агент	ɑgʲent
агенті	ɑgʲɪntɪ
агентім	ɑgʲɛnˈtɪm
агентімін	ɑgʲɛntɪˈmɪn
агентін	ɑgʲɪtɪn
агентінің	ɑgʲɛtnʲɪˈnʲɪ
агентіңіздің	ɑgʲɛntɪŋɪzˈdɪŋ
агентпен	ɑgʲentˈpen
агентте	ɑgʲentˈte
агентті	ɑgʲentˈti
агенттің	ɑgʲentˈtɪŋ
ағашқа	ɑɣɑʃqɑ
ағылшын	ɑɣɯɫʃɯn
ағылшындарды	ɑɣɯɫʃɯndɑɾdɯ
ағылшынша	ɑɣɯɫʃɯnʃɑ
ад	ɑd
адал	ɑˈdɑɫ
адам	ɑˈdɑm
адамадары	ɑdɑmɑˈdɯrɯ
адамбыз	ɑdɑmˈbɯz
адамға	ɑdɑmʁɑ
адамда	ɑdɑmdɑ
адамдар	ɑdɑmdɑr
адамдарға	ɑdɑmdɑrɣɑ
адамдарды	ɑdɑmdɑɾdɑ
адамдармен	ɑdɑmdɑrmʲɪn
адамдары	ɑdɑmdɑrɯ
адамдарым	ɑdɑmdɑˈrɯm
адамдарымның	ɑdɑmdɑrɯmɯnɯ
адамдарыңа	ɑdɑmdɑɾɯŋɑ
адамдарыңды	ɑdɑmdɑɾɯŋdɯ
адаммен	ɑdɑmˈmɛn
адаммын	ɑdɑmˈmɯn
адамнан	ɑdɑmnɑn
адамның	ɑdɑmˈnɯŋ
адамсың	ɑdɑmsɯŋ
адамсыңдар	ɑdɑmsɯŋdɑr
адаса	ɑdɑsɑ
ажыраталмай	ɑʒɯɾɑtɑɫmɑj
аз	ɑz
азабын	ɑzɑbɯn
азамат	ɑzɑˈmɑt
азаматпын	ɑzɑmɑtˈpɯn
азаматтық	ɑzɑmɑtɯq
азап	ɑzɑp
азаттық	ɑzɑtˈtɯq
азғана	ɑzɣɑnɑ
аздап	ɑzˈdɑp
азиаттарға	ɑziɑtːɑrɑ
азиаттарды	ɑzʲiɑtːɑɾdɯ
азып	ɑzɯp
ай	aj
айда	ajdɑ
айдағаныңды	ajdɑɣɑŋɯndɯ
айдайсың	ajdajsɯŋ
айдалуда	ajdɑɫʊdɑ
айдап	ajdap
айдаһар	ajdɑˈhɑr
айдаһарға	ajdɑhɑrɣɑ
айдаһарды	ajdɑhɑrdɯ
айдаһардың	ajdɑhɑrdɯŋ
айди	ajdi
айқайлама	ajqajlɑmɑ
айландырып	ajlɑndɯˈrɯp
айлар	ajˈlɑr
айларда	ajlɑrdɑ
аймағы	ajmɑɣɯ
аймақта	ajmaχtə
аймақтың	ajmɑqˈtɯŋ
айналада	ajnalɑdɑ
айналайын	ajnalajɯn
айналамның	ajnalɑmˈnɯŋ
айналасың	ajnɑlɑˈsɯŋ
айналатын	ajnalɑtɯn
айналдырайын	ajnaldɯrajɯn
айналдырам	ajnaldɯɾam
айналдыратын	ajnalˈdɯrɑtɯn
айналдырды	ajnaldɯrdɯ
айналдырып	ajnalˈdɯrɯp
айналмайсың	ajnalmajˈsɯŋ
айналып	ajnɑɫɯp
айналысатынымды	ajnalɯsɑtɯmˈdɯ
айналысқанмын	ajnalɯsqanmɯn
айналыспаймын	ajnalɯspajmɯn
айналысуым	ajnalɯsujm
айнер	ajˈner
айныдық	ajnɯðɯq
айт	ajt
айта	ajˈtɑ
айтады	ajtɑdɯ
айтайын	ajtaˈjɯn
айтам	ajˈtɑm
айтамыз	ajtɑmɯz
айтамын	ajtɑmɯn
айтамың	ajtɑˈmɯŋ
айтарым	ajtɑrɯm
айтарымды	ajtɑrɯmdɯ
айтарыңыз	ajtɑɾɯŋɯz
айтасыз	ajtɑsɯz
айтасың	ajtɑˈsɯŋ
айтатындығымды	ajtɑjndɯɣɯmdɯ
айтқан	ajtqɑn
айтқанда	ajtqɑnˈdɑ
айтқандай	ajtqɑnˈdaj
айтқанмын	ajtqɑnˈmɯn
айтқаны	ajtqɑnɯ
айтқанымдай	ajtqanɯmdaj
айтқанымды	ajtqɑnɯmdɯ
айтқанын	ajtqɑnɯn
айтқым	ajtqɯm
айтқыңыз	ajtqɯŋɯz
айтқысы	ajtqɯsɯ
айтпа	ajtpa
айтпадың	ajtpaˈðɯŋ
айтпай	ajtpaɪ
айтпаймын	ajtpajmɯn
айтпайсың	ajtpaɪsɯŋ
айтпақшы	ajtpaqʃɯ
айтпақшымын	ajtpaqʃɯmɯn
айтпасқа	ajtpaʃqɑ
айтсам	ajtsam
айтты	ajtɯ
айттың	ajtɯŋ
айттыңыз	ajtɯŋɯz
айтуға	ajtuʁa
айтудан	ajtʊdɑn
айтуым	ajtujm
айтуынша	ajtujenʃɑ
айтуың	ajtuɯŋ
айтшы	ajtʃɯ
айтылған	ajtɯɫɣɑn
айтыңыз	ajtɯŋɯz
айтыңызшы	ajtɯŋɯʃ
айтып	ajˈtɯp
айыптағың	ajɯptɑˈʁɯŋ
айыптап	ajɯptɑp
айырылдым	ajɯrɯɫdɯm
аколи	ɑqɑˈlɯ
ақ	ɑq
ақкөңіл	ɑqkøŋɪl
ақпарат	ɑqpɑˈrɑt
ақтау	ɑqˈtɑw
ақша	ɑqˈʃɑ
ақшаны	ɑqʃɑnɯ
ақылдастым	ɑqɯɫdɑstɯm
ақылдым	ɑqɯɫdɯm
ақылсыз	ɑqɯlsɯz
ақылы	ɑqɯˈlɯ
ақымақ	ɑqɯˈmɑq
ақымақтық	ɑqɯmɑqɯtqɯ
ақыры	ɑqɯˈrɯ
ақысына	ɑqɯsɯnɑ
ақыт	ɑqɯt
ақытты	ɑqɯtˈtɯ
ақытым	ɑqɯtɯm
ақытыңызды	ɑqɯtɯŋɯzdɯ
ал	ɑɫ
ала	ɑˈɫɑ
алады	ɑlɑdɯ
алайда	ɑlɑjˈdɑ
алайын	ɑɫɑjɯn
алақай	ɑlɑqɑj
алам	ɑˈlɑm
аламыз	ɑlɑmɯz
аламын	ɑlɑmɯn
алаңдата	ɑlɑŋdɑtɑ
алар	ɑˈɫɑr
аларсың	ɑlɑrsɯŋ
аласыз	ɑlɑsɯz
аласың	ɑɫɑˈsɯŋ
алатын	ɑlɑˈtɯn
алатыныңды	ɑɫɑtɯŋɯdɯ
алға	ɑɫˈʁɑ
алған	ɑɫˈʁɑn
алғанда	ɑɫˈʁɑndɑ
алғаш	ɑɫˈʁɑʃ
алғашқы	ɑɫˈʁɑʃqɯ
алғыр	ɑlɣɯr
алғырдай	ɑlɣɯɾdɑj
алғыс	ɑɫˈʁɯs
алғысым	ɑɫɣɯˈsɯm
алғысымды	ɑɫɣɯsɯmˈdɯ
алдағы	ɑɫˈdɑɣɯ
алдақашан	ɑɫdɑqɑʃɑn
алдамасаңшы	ɑɫdɑmɑsɑŋʃɯ
алдап	ɑɫˈdɑp
алды	ɑɫˈdɯ
алдыға	ɑɫdɯɣɑ
алдық	ɑɫˈdɯq
алдым	ɑɫˈdɯm
алдымен	ɑɫdɯˈmʲɪn
алдымызға	ɑɫdɯmɯzɣɑ
алдында	ɑɫdɯnˈdɑ
алдың	ɑɫˈdɯŋ
алдыңғы	ɑɫdɯŋɣɯ
алдыңда	ɑɫdɯŋdɑ
алдыңыз	ɑɫˈdɯŋɯz
алдыртты	ɑɫdɯrtˈtɯ
алла	ɑɫː
алло	ɑlːo
алма	ɑlmɑ
алмадым	ɑlmɑˈdɯm
алмадың	ɑlmɑˈdɯŋ
алмай	ɑɫˈmɑj
алмайды	ɑɫmɑjˈdɯ
алмаймыз	ɑɫmɑjˈmɯz
алмаймын	ɑɫmɑjˈmɯn
алмайсың	ɑɫmɑjsɯŋ
алмайсыңдар	ɑɫmɑjsɯŋdɑr
алмайтын	ɑɫmɑjtɯn
алмақшы	ɑlmɑqʃɯ
алмаңдар	ɑlmɑŋdɑr
алмаңыз	ɑlmɑɲɯz
алмас	ɑlmɑs
алмасам	ɑlmɑsɑm
алмастыртпақшы	ɑlmɑstɯrtpɑqʃɯ
алмасуы	ɑlmɑsʉwɯ
алсам	ɑɫˈsɑm
алсын	ɑɫˈsɯn
алты	ɑɫˈtə
алтын	ɑlˈtɯn
алтынмен	ɑɫtɯmʲɪn
алтыншы	ɑɫˈtɯnʃɯ
алтынын	ɑɫtəˈnɯn
алу	ɑˈɫʊ
алуға	ɑɫʊʁɑ
алуда	ɑɫʊdɑ
алушы	ɑɫʊʃɯ
алуыңда	ɑɫʊɯŋdɑ
алуыңыз	ɑɫʊɯŋɯz
алшы	ɑɫˈʃɯ
алыған	ɑɫɯˈʁɑn
алынған	ɑɫɯŋˈɣɑn
алынды	ɑɫɯndɯ
алыңдар	ɑɫɯŋdɑr
алыңыз	ɑɫɯŋɯz
алыңызшы	ɑɫɯŋɯʃɯ
алып	ɑɫɯp
алыпсың	ɑlɯpˈsɯŋ
алыпты	ɑɫɯptɯ
алыс	ɑɫɯs
амал	ɑmɑɫ
амалы	ɑmɑˈɫɯ
амалым	ɑmɑˈɫɯm
амалын	ɑmɑˈlɯn
аман	ɑmɑn
амансыз	ɑmɑnsɯz
амансызба	ɑmɑnsɯzbɑ
аманыз	ɑmɑnɯz
аманымда	ɑmɑnɯmˈdɑ
американдық	ɑmʲɪkɑnɯtɯk
амин	ɑmɪn
аминге	amiŋe
аминнің	ɑmɪnˈnʲeɪ
ана	ɑnɑ
анализ	ɑnɑˈlʏs
анам	ɑnɑm
анаң	ɑnɑŋ
анаңды	ɑnɑŋdɯ
анасымысыз	ɑnɑsɯmɯsɯz
анасын	ɑnɑˈsɯn
анасынан	ɑnɑsɯnɑn
анау	ɑnɑw
англиядағы	æŋglijɑɣɑɣɑ
анда	ɑnˈdɑ
андағы	ɑnˈdɑxɯ
анжелла	ɑnʒɪlˈlɑ
ансплантанты	ɑnspɫɑntɑntɯ
ант	ɑnt
анты	ɑnˈtɯ
антым	ɑntɯm
анық	ɑnɯq
анықтайсың	ɑnɯqtɑjsɯŋ
анықталған	ɑnɯqtɑɫˈɣɑn
анықтама	ɑnʏqˈtɑmɑ
анықтамалар	ɑnʏqˈtɑmɑˌɫɑr
анықтамаларыңды	ɑnɯqtɑmɑɫɯɾɯŋdɯ
анықтап	ɑnʏqˈtɑp
аңға	ɑŋˈɣɑ
аңшылауға	ɑŋʃɯɫɑwɑ
аңшылауғы	ɑŋʃɯɫɑwɯ
ап	ɑp
апа	ɑpɑ
апам	ɑpɑm
апамды	ɑpɑmdɯ
апаңды	ɑpɑŋdɯ
апар	ɑpɑr
апарамыз	ɑpɑrɑmɯz
апарамын	ɑpɑrɑmɯn
апарасың	ɑpɑrɑsɯŋ
апарсын	ɑpɑrsɯn
апару	ɑpɑrʊ
апаруға	ɑpɑɾʊʁɑ
апарып	ɑpɑrɯp
апасын	ɑpɑˈsɯn
апта	ɑpˈtɑ
аптада	ɑptɑdɑ
ара	ɑrɑ
арабтар	ɑrɑβtɑr
аравияда	ɑrɑviʲɑdɑ
арада	ɑrɑdɑ
араласпай	ɑrɑlɑspɑj
араластырмаңыз	ɑrɑɫɑstɯrmɑŋɯz
аралығында	ɑrɑɫɯʁɯnˈdɑ
аралық	ɑrɑɫɯq
арамтамақтар	ɑrɑmtɑmɑqˈtɑr
арамызда	ɑrɑmɯsˈdɑ
арасынада	ɑrɑsɯnɑdɑ
арасынан	ɑrɑsɯˈnɑn
аргентина	ɑrgʲɪntʰɪnɑ
арзан	ɑrˈzɑn
арқан	ɑrˈqɑn
арқанды	ɑrqɑnˈdɯ
арқасында	ɑrqɑsɯnˈdɑ
арқылы	ɑrqɯˈlə
армандап	ɑrmɑndɑp
армандар	ɑrmɑndɑr
арнайы	ɑrnɑjɯ
арналады	ɑrnɑˈɫɯdɯ
арналған	ɑrnɑɫˈʁɑn
артқа	ɑrtqɑ
артқы	ɑrtqɯ
артта	ɑrtˈtɑ
артық	ɑrˈtɯq
артымда	ɑrtɯmˈdɑ
артымнан	ɑrtɯmˈnɑn
артымыздан	ɑrtɯmɯzdɑn
артын	ɑrˈtɯn
артыңа	ɑrtəŋɑ
артыңда	ɑrɯtɯŋdɑ
архитектор	ɑrçɪtɛktɘr
ары	ɑrɯ
арылу	ɑrɯˈɫʊ
ас	ɑs
аса	ɑˈsɑ
асады	ɑsɑdɯ
асқа	ɑsˈqɑ
аспиринді	ɑspiɾinˈdi
астам	ɑstɑm
асты	ɑstɯ
астына	ɑstɯnɑ
астында	ɑstɯndɑ
астың	ɑstɯŋ
асығуым	ɑsɯɣʊm
асығыспын	ɑsɯɣɯsɯpɯn
асықпаңдар	ɑsɯqpɑŋdɑr
асылмашы	ɑsɯlmɑʃɯ
ата	ɑtɑ
атаға	ɑtɑɣɑ
атадан	ɑtɑdɑn
атайды	ɑtɑjˈdɯ
атайтын	ɑtɑjˈtɯn
атайтынын	ɑtɑjtɯnɯn
атаққа	ɑtɑqˈqɑ
аталатын	ɑtɑɫɑtɯn
аталғанын	ɑtɑɫɣɑˈnɯn
атамын	ɑtɑmɯn
атанды	ɑtɑndɯ
атап	ɑtɑp
атасымын	ɑtɑsɯˈmɯn
атқарады	ɑtqɑrɑdɯ
аттас	ɑtːɑs
аттракцион	ɑtːrɑkˈsɪɔn
атттарыңды	ɑtːtɑrɯŋdɯ
атты	ɑtːɯ
аты	ɑtɯ
атым	ɑtɯm
атымды	ɑtɯmˈdɯ
атымыз	ɑtɯmɯz
атың	ɑˈtɯŋ
атып	ɑtɯp
ауа	ɑwɑ
аударған	ɑwdɑrˈʁɑn
аударуда	ɑwdɑɾʊdɑ
аузын	ɑwˈzɯn
аузың	ɑwˈzɯŋ
аузыңды	ɑwzɯŋdɯ
аулайды	ɑwɫɑjˈdɯ
аумайсың	ɑwˈmɑjsɯŋ
ауру	ɑwˈɾʊ
ауруды	ɑwɯɾɯ
аурумен	ɑwɾumen
аурухалар	ɑwɾuhɑɫɑɾ
аурухана	ɑwɾʊχɑnɑ
ауруханаға	ɑwɾʊχɑnɑɣɑ
ауруханада	ɑwɾʊχɑnɑdɑ
ауруханасы	ɑwɾuhɑnɑsɯ
ауруханасына	ɑwɾuhɑnɑsɯnɑ
ауруы	ɑwɾʊw
ауруымен	ɑwɾʉjˈmʲɪn
ауруына	ɑwɾyˈjɑ
ауруының	ɑwɾʊwˈnɯŋ
ауф	ɑwf
ауыз	ɑwɯz
ауыл	ɑwɯɫ
ауылға	ɑwɯɫə
ауылдағы	ɑwɯɫdɑɣɯ
ауылымда	ɑwɯləmdɑ
ауыр	ɑwɯr
ауырады	ɑwɯˈrɑdɯ
ауырам	ɑwɯˈrɑm
ауырасың	ɑwɯrɑsɯŋ
ауырды	ɑwɯɾdɯ
ауырттың	ɑwɯrtɯtɯŋ
ауыру	ɑwɯˈru
ауыруы	ɑwɯɾʊwɯ
ауыруына	ɑwɯɾɯjˈnɑ
ауыруың	ɑwɯɾʊɯŋ
ауырып	ɑwɯˈrɯp
ауысамыз	ɑwɯsɑmɯz
ауыстыру	ɑwɯstɯɾʊ
ауыстыруға	ɑwɯstɯɾʊʁɑ
ауытқушылықтардың	ɑwɯtqʊʃɯɫɯqtaɾɯŋ
африка	ɑfɾɪkɑ
африкаға	ɑfɾɯkɑɣɑ
африкада	ɑfɾɪkɑdɑ
африкан	ɑfɾɪˈkɑn
африкандықтар	ɑfɾɪkɑndɯqtɑɾ
аха	ɑˈχɑ
ацепромазин	ɑtsɪprɑmɑzɪn
аш	ɑʃ
ашайық	ɑʃɑjɯq
ашқан	ɑʃqɑn
ашпын	ɑʃˈpɯn
аштық	ɑʃˈtɯq
аштым	ɑʃˈtɯm
ашығып	ɑʃɯɣɯp
ашық	ɑʃɯq
ашына	ɑʃɯˈnɑ
ашыңдар	ɑʃɯŋdɑr
ашыңыз	ɑʃɯŋɯz
ащы	ɑɕɯ
аяқ	ɑjɑq
аяққа	ɑjɑqˈqɑ
аяқта	ɑjɑqˈtɑ
аяқтарыңның	ɑjɑqtaɾɯŋŋɯ
аялдама	ɑjɑɫdɑmɑ
аялдаманы	ɑjɑldɑˈmɑnɯ
аялдамасына	ɑjɑɫdɑmɯsɯ
аямайды	ɑjɑmajˈdɯ
аян	ɑjɑn
аянышты	ɑjɑnɯʃtɯ
аяудың	ɑjɑwdɯŋ
әбден	æbˈdɛn
әбігерленіп	æβiɣæɾlæniːp
әдайым	ædɑjɯm
әдейі	ædɪji
әдемі	ædemi
әдемісің	ædæmiˈsiŋ
әдепсіздік	ædepsɪzˈdɪk
әдетте	ædɛt̪t̪e
әдеттегі	ædɛttɛɣi
әділ	æˈdɪl
әділдік	æˈdɪɫdɪk
әділдікке	ædɪldɪkke
әелдеріңе	æjldæɾɪŋæ
әже	ɑˈʒe
әжей	æˈʒej
әжептеуір	æʒɪptɘwɪr
әзілдеп	æziɫdep
әзір	æziːr
әзірше	æziɾʃe
әй	æj
әйгілі	æjɣɯˈli
әйел	æjɪl
әйелдер	æjɪlˈdɛr
әйелдерімен	æjɪlˈdærimɪn
әйелдеріммен	æjɪlˈdærimˈmen
әйелді	æjɪldɪ
әйелдің	æjɪlˈdɪŋ
әйелі	æjɪˈlɪ
әйелім	æjɪˈlɪm
әйеліне	æjɪlɪnæ
әйелмен	æjælˈmen
әйнек	æjˈnɛk
әйтеуір	æjtɘwɘr
әйтпесе	æjtpʲesɪ
әке	ækʲe
әкей	ækʲej
әкейге	ækʲejge
әкейдің	ækʲejˈdiŋ
әкеймен	ækʲejmen
әкел	ækæl
әкелген	ækæɫgen
әкелгені	ækælgæni
әкелді	ækældɪ
әкелдім	ækældɪm
әкелдіңдер	ækældɪŋdɪr
әкеле	ækælæ
әкеледі	ækɪlædi
әкелемін	ækælæmiːn
әкеліңдер	ækæˈlʲɪŋdɪr
әкем	ækæm
әкеммен	ækæmmen
әкең	ækeŋ
әкеңмен	ækæŋˈmen
әкеңнің	ækæŋˈnʉ
әкеп	ækɪp
әкесі	ækɪsɪ
әкесімен	ækesiˈmen
әкімшілігі	ækɪmʃɪlɪʁɪ
әкімшілікке	ækɪmʃɪlɪkˈkʲe
әкімшілікпен	ækɪmʃɪlɪkˈpɛn
әктастар	æktɑstɑr
әлгі	ælgi
әлде	ældɘ
әлдеқандай	ældʑɑnˈdɑj
әлем	æˈlæm
әлемге	ælʲemˈge
әлемдік	ælæmdɪk
әлемі	ælemi
әлеміне	ælemine
әлемнің	ælɪmˈnʲɪŋ
әлі	æli
әліде	ælide
әлсіз	ælˈsiʃ
әлсіретеді	ælsiretedi
әмиәні	æmʏæˈni
әміршісі	æmɪrʃɪsɪ
ән	æ̃
әне	æne
әңгіме	æŋgɪmɛ
әңгімелерді	æŋgɪmɛlɪɾdɪ
әңгімеміз	æŋgɪmɪˈmɪz
әңгіменің	æŋgimeˈniŋ
әпкем	æpˈkæm
әпкемнің	æpkʲemˈnʲi
әпкесіне	æpkesine
әпкесінен	æpkɘsiˈnɘn
әр	æɾ
әрбіреуі	æɾbɪrɪwɪ
әрекет	æɾekjet
әрекетін	æɾeketʰin
әрең	æɾeŋ
әрине	ærine
әрі	æri
әріптесі	æriptɘsi
әріптестерімізбен	æriptesterimizβen
әрқашан	ɑrqɑʃɑn
әртүрлі	ɑrtʏrˈli
әсер	æsɘr
әсері	æsɪɾi
әсерін	æsæɾin
әсіресе	æsiɾese
әскер	æskɪr
әскері	æskæri
әскерім	æskɪˈrɪm
әскерінен	æskɪrɪnɪn
әскерлер	æskɪrˈlɪr
әскерлердің	æskɪrleɾɪŋ
әскерлерім	æskɪrleɾɪm
әскерлерімді	æskɪrleɾɪmˈdi
әуе	æwjɪ
әуежайға	æwjæjɑɣɑ
әулет	æʊˈlɛt
әулетін	æʊlɪtɪn
әулие	æwˈlie
әшейін	æʃejin
ба	ɑ
баға	baˈɣa
бағаламаппын	baɣɑlɑmɑpɯn
бағалы	baɣɑɫɯ
бағана	baɣɑnɑ
бағындыру	baɣɯndɯrʊ
бағыңды	baˈɣɯŋdɯ
бағыт	baɣɯt
бадди	badi
базарлық	bazɑrˈɫɯq
байғұс	baɯˈʁʊs
байқамай	baɯqɑmɑj
байқамаппын	baɯqɑmɑpˈpɯn
байқап	baɯˈqɑp
байқаусызда	baɯqɑwsɯzˈdɑ
байладым	baɯɫɯˈdɯm
байланыс	baɯlɑnɯs
байланысты	baɪlaˈnɯstɯ
байланыстырасыз	baɯɫɑnɯstɯɾɑsɯz
байлауышты	baɪɫɑwɯʃˈtɯ
байлығын	baɯɫɯjɯqɯn
байлық	baɪˈɫɯq
бактерия	ˈbɑktɪrʲɪjə
бактериялар	ˌbɑktʲerʲiˈjɑɫɑr
бақалардың	baqɑɫɯɾɯŋ
бақсыға	baqsɯʁɑ
бақырайтып	baqɯraɯˈtɯp
бақытты	baqɯtˈtɯ
бақыттымын	baqɯtːɯmɯn
бала	baɫɑ
балаға	baɫɑʁɑ
баладан	baɫɑˈdɑn
балақай	balaqaɪ
балақайлар	baɫɑqɑjˈlɑr
балалар	baɫɑɫɑr
балаларға	baɫɑɫɑrɣɑ
балаларына	baɫɑɫɑɾɯˈnɑ
балам	baˈɫɑm
балама	baɫɑmɑ
баламды	baɫɑmdɯ
баламен	baɫɑˈmɛn
баланы	baˈlɑnɯ
баланының	baɫɑnɯˈnɯ
баланың	balaˈnɯŋ
балаң	baˈɫɑŋ
балаңыз	baɫɑˈnɯz
балаңызда	baɫɑŋɯzˈdɑ
балапаным	baɫɑpɑˈnɯm
баласы	baɫɑsɯ
баласың	baɫɑˈsɯŋ
балшық	baɫˈʃɯq
банк	baŋk
банкрот	baŋkroːt
бар	baɾ
бара	bara
барады	baraːdɯ
барайықшы	baɾajɯqʃɯ
барайын	baɾajˈjɪn
барам	baˈram
барамыз	baɾamɯz
барамын	baramɯn
барар	baɾɑr
барасың	baɾasɯŋ
барасыңдар	baɾasɯŋˈdɑr
баратын	baratɯn
барған	baɾˈʁɑn
барғанды	baɾˈʁɑnˈdɯ
барғаным	baɾʁɑnɯm
барғың	baɾɣɯŋ
барда	baɾˈda
барды	baɾˈdɯ
бардың	baɾˈdɯŋ
барлап	baɾˈlɑp
барлығы	baɾɫəˈjɯ
барлығын	baɾɫəˈʁɯn
барлығың	baɾɫəjəŋ
барлығыңа	baɾɫəɣəˈnə
барлық	baɾˈɫɯq
барлықтарыңыз	baɾɯqtaɾɯŋɯz
барма	baɾˈmɑ
бармағаның	baɾmaɣaˈnɯŋ
бармағыңызды	baɾmɑɣɯŋɯzdɯ
бармадың	baɾmɑˈðɯŋ
бармайды	baɾmaɪˈdɯ
бармаймын	baɾmaɯmɯn
бармайсың	baɾmajsɯŋ
барсін	baɾˈsɪn
барсын	baɾˈsɯn
барсың	baɾˈsɯŋ
бару	baru
баруға	baruɣa
баруыма	baɾujma
баруыңыз	barujɯŋ̊
баршы	baɾˈʃɯ
барын	baˈrɯn
барыңдар	baɾəŋdɑr
барып	baɾɯp
бас	ˈbɑs
басқа	ˈbɑsqɑ
басқалар	baʃqɑˈɫɑr
басқалары	baʃqɑlɑˈrɯ
басқаларын	baʃqɑɫɑˈrɯn
басқармақшы	baʃqɑrmɑqʃɯ
басқармасы	baʃqɑrmɑsɯ
басқару	baʃqɑrʊ
басқарып	baʃqɑˈrɯp
басқасына	baʃqɑˈsɯnɑ
басқаша	baʃqɑʃɑ
баспасөзі	ˈbɑspɑsøˈzɪ
бассаңдар	ˈbɑsːɑɴdɑr
бассейн	ˈbɑsːɪn
бассейнге	ˈbɑsːejŋe
бассейні	ˈbɑsːejni
бассейнінде	ˈbɑsːejniːnˈde
бастағанда	ˈbɑstɑʁɑnˈdɑ
бастады	ˈbɑstɑdɯ
бастадың	ˈbɑstɑˈdɯŋ
бастадыңдар	ˈbɑstɑjɯŋdɑr
бастайды	ˈbɑstɑjˈdɯ
бастаймыз	ˈbɑstɑjmɯz
басталған	baˈstaɫqɑn
басталсын	baˈtɑɫsɯn
бастап	baˈstɑp
бастау	ˈbɑstɑw
бастауға	ˈbɑstɑwɑ
басты	ˈbɑstɯ
бастықпен	ˈbɑstɯqpɛn
бастықты	ˈbɑstɯqtɯ
бастысы	ˈbɑstɯsɯ
басшыңыз	ˈbɑsʃɯŋɯz
басшысының	baʃˈʃɯnɯŋɯ
басы	ˈbɑsɯ
басым	baˈsɯm
басымды	basɯmˈdɯ
басын	baˈsɯn
басына	baˈsɯnə
басынан	basɯnan
басында	baˈsɯnˈdɑ
басып	baˈsɯp
батарея	batɛˈrijə
батпақ	batpaq
баттың	ˈbɑtːɯŋ
батыл	baˈtɯɫ
батып	baˈtɯp
батыс	baˈtɯs
бауыр	baʊɯr
бауырын	baʊɯˈrɯn
бауырыңа	baʊɯˈrɯŋa
баяғыда	bajɑɣɯda
бәз	βæz
бәлесің	be̞lesiŋ
бәліш	beˈlɪʃ
бәлішті	be̞lɪʃtɪ
бәр	ber
бәрі	βæri
бәрібір	βæɾiˈbiɾ
бәріміз	βæɾɪˈmɪz
бәрін	berin
бәріне	beɾine
бәрінен	beriˈnɪn
бәрің	βæɾɪŋ
бәріңе	βæɾɪŋ
ббарлығы	ββɑrɫɯɣɯ
бе	be
беделіңе	bedelɪŋe
безгек	be̞sˈgek
безгің	be̞zgɯ̞ŋ
бейбақ	bejˈbɑq
бейнемізді	bejnenimɪzdɪ
бейнеттенем	bejnettenem
бейшара	bejʃɑrɑ
бекер	beˈkɘr
бел	βɘɫ
белгіленген	beɫɣileŋe
белгілі	beɫɣɯˈli
белгісіз	beɫɣɯˈsɯz
беліңді	beˈlɪŋdɪ
беллфлауэр	βɘɫfɫɑwɘr
бен	ben
бензин	benˈzɪn
бер	ber
бергем	beɾˈgem
берген	beɾˈgen
бергенді	beɾgenˈdɯ
бергенің	be̞ɾge̞ˈniŋ
бергеніңізді	be̞ɾge̞niŋɨzˈdɨ
бергенсіз	beɾge̞nsɯ
бергенсің	beɾge̞nsɪ̞ŋ
бергім	beɾgɪm
берді	berˈdi
бердің	beriŋ
бере	beˈre
береді	beredi
берейін	beɾejin
берем	berem
береміз	beɾemiz
беремін	beremɪn
бересіз	be̞ɾe̞sɪ̞s
бересің	be̞ɾe̞ˈsiŋ
бері	beri
берілетін	beriletin
берілме	beɾɪlˈme
беріңіз	beɾiŋɪz
беріңізші	beɾiŋɨʃi
беріп	beˈrip
беріпті	beˈripti
бермей	beɾˈmej
бермейді	bermɛjˈdi
берсеңші	beɾsɪŋʃɪ
берсін	βɘrˈsɘn
беруге	beˈruɣe
берудеміз	beɾʉdeˈmɪz
беруді	berʊˈdi
беруің	beɾuj
берші	berʃi
бес	bes
бетін	beˈtin
бетінше	βetɪnʃe
бетон	beˈton
бетпақ	βetˈpɑq
беттимен	βetːiˈmen
билет	biˈlet
билеттері	biletteri
биші	biʃi
биыл	biˈjɑl
біз	βɯz
бізбен	biβbæn
бізге	biːzge
бізде	βɯzˈdæ
бізді	biˈzdi
біздің	biˈzɪŋ
бізідң	biˈzɪŋ
білген	biɫˈgen
білгенге	biɫgeŋe
білгің	biɫɣɯŋ
білдің	biɫˈdɪŋ
білдіреді	biɫdiɾeɾi
білдіремін	biɫdiredimɪn
білдірмей	biɫdɪrmɛj
білдіруді	biɫdiɾuɾi
біледі	biˈledʲi
білем	biˈlem
білемін	bilemin
білесіз	bilesiːz
білесің	bilesiŋ
білесіңбе	bileˈsiŋbe
білесіңдер	bileˈsiŋdɘr
білетін	biletin
білетіндеймін	biletʲindejˈmin
білетінім	biletinim
біліктілігім	biˈlɪktɪlɪʁɪm
біліктілігіңізге	biɫɪkˈtɪlɪɣe
білімді	biˈlimdi
білімімді	bilimimdi
білімің	biˈlimɪŋ
біліп	biˈlɪp
білмегенсіп	biɫmege̞nsip
білмей	biɫˈmej
білмейді	biɫmejˈdi
білмейм	biɫmej
білмейміз	biɫmæjˈmɪz
білмеймін	biɫmejˈmɪn
білмейсіз	biɫmejˈsɯz
білмейсің	biɫmejˈsiŋ
білмеппіз	biɫmæpˈpɪs
білсе	biɫse
білсем	biɫsæm
білу	biˈɫu
білуім	biluːm
білуіңіз	biɫʉiŋɨz
бір	biɾ
біраз	biˈrɑz
біраздан	biˈɾɑzˈdɑn
бірақ	biˈrɑq
біратала	biɾɑtɑɫɑ
бірге	biɾgɛ
біргемін	biɾɣeˈmin
бірде	biɾde
бірдей	biɾˈdej
бірдеме	biɾdeˈme
бірден	biɾˈdɪn
бірдеңе	biɾdeŋe
біреу	biˈrew
біреудің	biɾewˈdiŋ
біреуі	biɾewi
біржаққа	biɾʒɑqˈqɑ
бірі	biri
бірін	biˈrɪn
бірінші	biˈrɪnʃi
біріншіден	biˈrɪnʃɪˌdɛn
бірлескен	biɾlesqen
бірнәрсе	biɾnæɾsɛ
бірнеше	biɾneʃe
біртүрлі	biɾtyɾˈli
бітетін	bitetin
бітіруге	biˈtiruɣe
біткен	bitken
бітті	biti
бітуде	bitʊde
бо	bo
боггз	boɣːz
бозарып	bozɑrɯp
бойы	bojɯ
бойымен	bojɯˈmen
бойынша	bojɯnʃa
боқ	boq
бол	bol
бола	bola
болағн	bolaʁn
болады	bolɑdɯ
болам	bolɑm
боламын	boɫɑˈmɯn
болар	boˈɫɑr
боларсың	bolaɾsəŋ
боласыздар	bolɑsɯzdɑr
боласың	bolɑˈsɯŋ
болатын	bolaːˈtɯn
болатынмын	bolɑtɯmɯn
болатынын	bolɑtɯnɯn
болашағының	boɫɑʃɑɣɯˈnɯ
болашақ	bolaʃaq
болашақта	bolɑʃɑqˈtɑ
болған	bolɣan
болғанда	bolɣɑndɑ
болғанды	bolɣɑndɯ
болғандықтан	bolɣɑnˈdɯqˈtɑn
болғансың	bolɣɑnsɯŋ
болғанша	boɫɣaɲʃa
болғаны	bolʁɑnɯ
болғаным	bolɣanɯm
болғанымыз	bolɣanɯmɯz
болғанына	bolɣanɯna
болғыларың	bolɣɯlaˈrɯŋ
болғым	bolɣɯm
болғың	bolɣɯŋ
болғыңыз	boɫɣəŋɯz
болғысы	bolɣɯsɯ
болды	boldɯ
болдық	bolɯt
болдым	boldɯm
болдың	bolˈdɯŋ
болжау	bolʒɑw
болма	bolmɑ
болмаған	bolmɑˈʁɑn
болмағанда	bolmɑˈɣɑndɑ
болмағанымда	bolmɑɣɑnɯmda
болмады	bolmɑdɯ
болмай	bolˈmaj
болмайды	bolmɑjdɯ
болмайтын	bolmajˈtɯn
болмақ	bolˈmɑq
болмаңыз	bolmɑŋɯz
болмаса	bolˈmɑsɑ
болмасын	bolmɑsɯn
болмауым	bolmɑjym
болмысы	bolmɯsɯ
болса	bolsɑ
болсақ	bolsɑq
болсам	bolsam
болсаң	bolˈsaŋ
болсаңыз	bolsɑŋɯz
болсын	bolsɯn
болу	boˈɫu
болуды	bolʊdɯ
болуы	boɫoˈwɯ
болуым	bolojum
болшы	bolʃɯ
болыңдар	boləŋdɑr
болыңыз	boɫəŋɯz
болып	boˈlɯp
болыппа	boɫɯpˈpɑ
болыпты	boləptɯ
бонни	boni
боны	boˈnɯ
боп	βop
бопты	boptɯ
бос	βoʃ
босатты	bo̞sɑtːɯ
босатылды	bo̞sɑtɯɫdɯ
босатылып	bo̞sătɯ̆lɯ̆p
босатыңдар	bo̞sátɯŋdɑr
босқа	boʃqɑ
боссыңдар	boˈsɯŋdɑr
бостандығы	boʃtandɯɣɯ
бояп	bojæp
бөксесін	ˈbøksɪsɪn
бөксесінен	ˈbøksæsinɪn
бөлгеніме	bolgɛniˈmɛ
бөлекпіз	bolʲekpiz
бөлесіз	bolɪˈsɪz
бөлігі	boːˈlɪʁɪ
бөлім	bolɪm
бөліміміздің	boliːmimɪzɪŋ
бөліп	bolɪp
бөлісуіңізді	boliˈsuɪŋɪzdi
бөлме	bolˈmɘ
бөлмеге	bolmɛge
бөлмелеріңізге	bolmelerinizɣe
бөлмесі	bolmɛsi
бөлмесіне	bolmɛsɪnɛ
бөлшектері	bolʃekeˈteɾi
бөлшектерін	bolʃekteˈrin
бөтен	βøˈtɛn
бракман	brɑkmɑn
браслет	brɑsˈlʲet
брдеңе	brdeŋe
британ	brʲitɑn
британдықсыз	brʲitɑnˈdɯqˈsɯz
британдықтар	brʲitɑnˈdɯqˈtɑr
британдықтармен	brʲitɑnˈdɯqˈtɑrmʲɪn
британия	brʲitɑnʲiʝɑ
брунер	brʊˈnɛr
будым	buˈdɯm
букет	boˈkʲet
бутербродты	butɪrbrodtɨ
бүгін	byˈgin
бүгінгі	byˈgiŋi
бүгіннен	byˈgɪnen
бүгіп	byˈgɪp
бүіг	byj
бүкіл	bykiɫ
бүлдірген	buldirgen
бүлдірдің	buɫdɪrɪŋ
бүтін	bytin
бұған	boɣɑn
бұдан	boˈdɑn
бұзады	buzɑdɯ
бұзақылық	buzɑqɯˈlɯq
бұзды	buzdɯ
бұзушылықтар	buzuʃɯɫɯqtaɾ
бұзылып	buzɯˈlɯp
бұйрығы	bujɯˈrɯqɯ
бұйрықтарыңда	bujɯɾəqtaɾɯŋda
бұл	buɫ
бұлай	buˈɫaj
бұлар	buˈɫɑr
бұлардың	buɫɯɾɯŋ
бұнда	bo̙nˈdɑ
бұндай	bo̙nˈdɑj
бұны	boˈnɯ
бұнымен	boˈnɯmen
бұның	buˈnɯŋ
бұрылма	buˈrəlmɑ
бұрылыңыз	buˈrɯləˈɯz
бұрылыс	buˈrəlɯs
бұрын	buˈrɯn
бұрынғы	buˈrɯŋɯ
бұрынғысы	buˈrɯŋɯsɯ
бұрында	buɯrˈɯndɑ
бұрындары	buɯrɯndɑrɯ
бұрыннан	buˈrɯnːan
бұрыңғы	buˈrɯŋɣɯ
бұрып	buˈrɯp
бұрыс	buˈrɯs
былай	ɯɫɑj
былық	byˈlɯq
былықтарды	byˈlɯqtarˈdɯ
бэннан	benan
бэннандікі	benːandɪki
бэннанды	benːɑnːdɯ
бэннанмен	benanmen
бэннанның	benːanːɯ
вальтер	ʋɑɫˈtʲɪr
ванна	ʋɑnːə
ваннаны	ʋɑnːɑnɯ
васва	ʋɑsˈβɑ
васваны	ʋɑsˈwɑnə
васваның	ʋɑsˈwɑnɯŋ
ватиканға	ʋɑtɪkɑŋɑ
вашингтон	ʋɑʃɪŋˈtɑn
вашингтоннан	ʋɑʃɪŋˈtɑnːɑn
веленанге	βelɪnɑŋge
велосипед	βɘlɑsɘpʲɘd
вилда	ʋildɑ
вирджиния	ʋɪrdʒɪnʲiʌ
виски	ʋiskʲɪ
возьмите	ʋɔɪsʲˈmʲɪtʲe
газеттер	gɑˈzetər
газеттері	gɑzʲɪtˈtæri
гаражы	gɑrɑʃɯ
гариган	gɑrɪˈɣɑn
гариганмен	ɣɑrɯɣɑnˈmɛn
гариганмын	gɑrɯɣɑnˈmɯn
гексозаминдас	gɛksozɑmɪndɑs
генерал	gʲenʲerɑɫ
генералсың	gʲenʲerɑɫsɯŋ
гибли	gɪbˈlɪ
госпиталі	ɣospitɑlʏ
госпиталіміз	ɣo̞spɑ̆tɑ̆lɯ̞ˈmɯ̞z
госпитальға	go̞spʰi̞tɑ̞lɑ̞
госпитальда	ɣo̞spʲi̞tɑ̆ɫdɑ
гректер	grekˈtɛr
грин	grɪn
гугл	guɣl
гүл	gʏl
гүлдер	ɣʏldɘr
ға	ɣa
ғажап	ɣɑˈʐɑp
ғана	ɣɑnɑ
ғанибетпен	ɣɑnɯβetˈpɘn
ғафу	ɣɑfu
ғашық	ɣaʃɯq
ғимарат	ɣɪmɑˈrɑt
ғимаратына	ɣɯmɑrɑtɯnɑ
ғой	ɣɔj
ғылым	ɣɯˈlɯm
да	da
дайын	dajɯn
дайынбысың	dajɯnbɯsɯŋ
дайындайын	daɯ̃ɯ̃dɑjɯn
дайындалыңыздар	daɪɯ̽ndɑɯ̽ɫɯŋɯzɯɾ
дайындаңдар	daɯ̙nɯ̙ˈdɑ̙ŋdɑ̙r
дайынсыз	dajɯnsɯz
дакота	dakotə
далбаса	daɫbɑsɑ
дамыту	damɯtʊ
дана	dana
дастархан	ˈdɑstɑrxɑn
дауыс	daʊɯs
дауысқа	daʊɯsqɑ
дауысын	daʊsɯn
даярмысыз	dajaɾmɯsɯz
даярмысың	dajɑrmɯsɯŋ
дәйексөз	ˈdæjɪkˈsøz
дәл	ɘl
дәлел	ˈdæleɫ
дәлелдеймін	ðælældæjmɪn
дәлелдемесі	ˈdæleːldæmɘsi
дәлелдеп	ˈdælældæp
дәлеліміз	ðæleːlɯmɯz
дәлірек	ˈdælirɪk
дәмді	daːmˈdi
дәмдіге	daemdiɣe
дәніне	danine
дәргерісің	ðæɾgɪˈɾɪsɪŋ
дәреже	ˈdæɾeʒe
дәрежелі	ˈdæɾeʒeli
дәретхана	ˈdæɾetχɑnɑ
дәрі	ˈdæɾi
дәрігер	ˈdæɾiɣer
дәрігерге	ˈdæɾiɣɛɾɣe
дәрігердің	ˈdæɾiɣeɾiŋ
дәрігері	ˈdæɾigeɾi
дәрігерімді	ðæɾiɣeɾimˈdi
дәрігерімін	ˈdæɾiɣeɾimɪn
дәрігеріңіз	ðæɾiɣeɾiŋiz
дәрігерісіз	ˈdæɾiɣeɾɪsɪz
дәрігерлердің	ˈdæɾiɣerleɾiŋ
дәрігерлік	ˈdæɾiɣeɾɯk
дәрігермін	ˈdæɾiɣɘrmɘn
дәрігерсіз	ˈdæɾiɣɘɾsɘz
дәрігерсің	ˈdæɾiɣɘɾsɘŋ
дәрілерін	ˈdæɾilæɾɪn
дәріні	ˈdæɾini
дәрінің	ðæriˈnʲiŋ
дәрісі	ˈdæɾɪsɪ
дәрісін	ˈdæɾɪsɪn
дәртің	ðærtɯŋ
дәтің	ˈdæteɪŋ
двидке	ɯβɯtˈkæ
де	ðe
деген	ˈdegen
дегенге	denˈgeŋe
дегенде	ˈdegendɘ
дегендей	ˈdegendɛj
дегенді	denˈgɪngɪ
дегені	deni
дегенім	deniːm
дегенің	deniŋ
дегеніңіз	deniŋiz
дегенмен	denʲemʲen
дегеннің	deniɲi
дегің	ˈdeɣɪŋ
деді	ˈdʲedi
дедім	ˈdɛdɪm
дедіңіз	ˈdejdiŋiz
дей	ˈdej
дейді	ˈdɛjdi
дейін	ˈdejɪn
деймін	dejˈmin
деймісің	dejmiˈsiŋ
дейсіз	ˈdɛjsɪz
дейсің	dejsɪŋ
дейсіңдер	dejˈsiŋdɪr
дейтін	dejˈtin
делік	ˈdʲelɪk
дем	ðæm
демалуға	ˈdʲemɑɫʊʁə
демалыста	demɑlɯstɑ
демеймін	ˈdʲemʲejmʲin
демейсіз	ˈdʲemʲesɪs
демі	ˈdemi
деміңді	ˈdemiŋdi
ден	den
дене	dene
денеге	denege
денелерін	deneleriɳ
денең	deneŋ
денесіне	denjesine
денсаулығы	densɑwɫɯɣɯ
денсаулық	densɑwɯɫɯq
деңгей	denˈgej
деңгейін	dengejɪn
деңіз	denʲɪs
деңізші	deniʃʃi
деп	ˈdɛp
деппедің	ˈdɛpːɘtɘŋ
дер	der
дереу	derɘw
десе	desʲe
деседі	desiːdɪ
десейші	desejʃi
десең	desɪŋ
десіп	desip
деші	ˈdeʃi
джанджу	dʒɑnˈdʒu
джеральд	dʒeɾɑɫd
джо	dʒo
джозеф	dʒoˈzʲef
джой	dʒɔj
джолли	dʒɔlɯ
джона	dʒɔnɑ
джонада	dʒɔnɑdɑ
джонас	dʒɔnɑs
джонастың	dʒɔnɑsˈtɯŋ
джунджу	dʒundʒu
дзэниба	ʒæniˈβɑ
дзэнибаның	ʐænibɑˈnɯŋ
диагноз	daɪɑgˈnɔs
дизель	ˈdizʲɪlʲ
дізесін	ˈdɪzɪsɪn
діл	ɖɪl
діни	ˈdɪnɪ
дірілдейсің	gɪrɪɫdʲeˈsɪŋ
дірілдеп	ɖɪrɪlˈdæp
доғар	doʁɑr
доғарыңдар	doʁɑrɯŋdɑr
доғарыңыз	doʁɑrɯŋɯz
доктор	doˈktoɾ
доктормын	doqtoɾmɯn
докторына	doqtoɾɯˈnə
долырып	doloɾɯp
донор	doˈnor
достар	doˈstɑr
достарым	doˈstɑrɯm
достарымызға	dostaɾɯmɯzɣɑ
достарыңның	doʃtɑrɯŋˈnɯŋ
достым	doʃˈtɯm
досы	doˈsɯ
досым	doˈsɯm
досымсың	doˈsɯmsɯŋ
досың	doˈsɯŋ
досыңды	doˈsɯŋdɯ
дөрекілік	dōrekílik
драмми	drɑmɪ
дуа	duɑ
дуаладым	duɑlɑdɯm
дуаны	duɑnɯ
дуаның	duɑˈnɯŋ
дүние	ˈdynje
дүршіккеннен	ɯɾʃɪkʲːe̞nːe̞n
дұрын	duˈrɯn
дұрыс	doˈrɯs
дұрыспысың	duˈrɯspɯsɯŋ
дыбыс	ɯβɯs
дыбысын	ɯβɯsɯn
дым	ɯm
дэвид	ˈdæβɪt
дэвидтің	ˈdæβɪtɪŋ
ебедейсізсің	jebɪɟesiˈsɪʃ
ева	jeˈβɑ
егер	jeger
егіз	jegɪz
еді	jedʲi
едік	jedɪk
едім	jedim
едің	jeːtiŋ
едіңіз	jedinɪz
едіңіздер	jedʲiŋɪzˈdɪr
ей	ej
ек	ɛk
екен	ɪkʲɪn
екенбіз	ɛkʲenˈbɪs
екендігі	ɪkʲɪndɪɣɪ
екендігін	ɪkʲɪndɪˈɣɪn
екендігіңді	ɪkʲɪndɪɣɪŋdɪ
екені	ɪkæˈni
екенімді	ɛkɪˈnɪmˈdi
екенімізді	ɪkæniˈmɪzdɪ
екенін	ɪkɪˈnɪn
екенің	ɪkæˈnɪŋ
екеніңді	ɪkæˈnɪŋdɪ
екеніңіді	ɪkæniŋɪdɪ
екеніңіз	ɪkæˈnʏŋɪz
екеніңізді	ɪkæˈnʏŋɪzˈdɪ
екенмін	ɪkʲɪnˈmɪn
екенсің	ɪkʲɪnˈsɪŋ
екеуі	jekewi
екеуіміз	jɪkɪwɪˈmɪz
екеуін	jekewɪn
екеуінде	jekewinde
екеуің	jɪkøwɪŋ
екеуміз	jekewimɪs
екеумізге	jekeumiɣe
екеуміздің	jɪkɪwmiˈðɪŋ
екі	jeki
екінші	jeˈkɪnʃi
екіншісі	jeˈkɪnʃɪsɪ
ел	jɪl
елде	jelde
елдегі	jeldʒi
елден	jɪldɪn
елді	ɪlˈdɪ
елдік	jelˈdɪk
елдің	jɪlˈdɪŋ
еледің	jɪlɪˈdiŋ
елемей	jelemej
елес	jeˈles
елестер	jelésɪr
еліме	jelime
елінің	jɪlɪˈnʲi
елшісі	jæɫʃɪsɪ
ем	ɘm
емдеген	emdegen
емдеу	emdew
емдеуге	emdewge
емдеуден	jɪmdɘwdɘn
емдеуін	emdewiːn
емді	emdi
емес	emes
емеспе	ɘmɘspɘ
емеспіз	ɪmʲɪsˈpɪs
емеспін	emɪspɪn
емессіз	emɪsːɪz
емессің	emɪsɪŋ
еместей	emɪstej
емі	jɪmɪ
емнің	emˈnʏj
емспін	jɪmspɪn
емхана	emχɑnɑ
емханаға	jæmχɑnɑɣɑ
енген	jɪŋɪn
ендеше	endeʃe
енді	ɘndʲi
ендігәрі	endʲiɣæri
ендігі	ɘndɪɣɯ
ентебиге	jɛntɛbigɛ
ең	jeŋ
еңбегіммен	jeŋbeɣimmen
епсізсің	jɘpˈsɘsɘjŋ
ер	jɪr
ердім	jɪrdɪm
ереже	ereʒe
ережелер	ereʒeˈler
ережені	ereʒeɲi
ерекше	erekʃe
еріп	erɪp
еркек	ɪɾkɪk
еркімен	jɜrkɪˈmɛn
еркін	ɘɾˈkɘn
еркіндікке	jɘrqɘndɘkʲe
ерте	jɪrtɪ
ертемен	jɪrtɪˈmɪn
ертең	jɘrtɘŋ
ертеңмен	jɘrtɘŋmɘn
ерткен	ɘrtˈkʲen
есебі	jɪsɪbi
есебімнен	jɪsɪbɪmˈnʲe
есебін	jɪsɪˈbɪn
есептер	jɪsɪpˈtɪr
есептері	jɪsɪpˈtɪrɪ
есептесем	jɪsɪpˈtɪsɪm
есіктеріңді	je̞ˈsɪkˈtæɾɪŋˈdɪ
есікті	jɪˈsɪktɪ
есім	jɪˈsɪm
есімде	jɪˈsɪmˌdæ
есіме	jesime
есімі	jesimi
есімім	je̞si̞mi̞m
есімімді	jɪsɪmɪmˈdɪ
есімің	jɪˈsɪmɪŋ
есіміңді	je̞simɪŋˈdi
есімнен	jɪˈsɪmˌnʲɪn
есіңде	jeˈsɪŋdɛ
есіңізде	jɪsɪŋɪzde
есітіп	jɪsɪtɪp
еске	jɪsˈkɘ
ескерем	jɪskɪˈrɪm
ескермес	jɪskɪrmɪs
ескі	jɪsˈki
есте	jestɪ
естен	jestɪn
естерінде	jestɪrindɛ
ести	jestʲi
естиді	jɪstɪdi
естимісің	jɪstɪmisɪŋ
естисің	jɪsˈtɪsɪŋ
естіген	jestʲiˈgen
естігіміз	jestʰiɣimiʑ
естідік	jestɪdɪk
естідім	jɪsteˈdim
естідіңдер	jestideːŋder
естілетін	jestiletʰin
естімей	jestimɛj
естімеймін	jɪstimɪmɪn
естімесе	jestimeˈse
естіп	jestip
естуімше	jestuimʃe
ет	et
ете	jɪtɪ
етем	jetem
етеміз	jetemɪz
етесің	jetɪˈsɪŋ
ететін	jetetɪn
еті	etɪ
етіңіз	etɪŋɪz
етіңізші	jetɪŋɪʃːɪ
етіп	etɪp
еткім	etˈkim
еткіңіз	etkiŋɨz
етпейді	etpejdi
етпеймін	etpejˈmɪn
етпексіз	etpɛkˈsɯz
етпес	etpes
еттім	etˈtim
еттің	etːiŋ
етуіміз	etʊɪˈmɪz
етуіңе	etujɪŋe
еш	jɪʃ
ешкі	jɪʃˈkɪ
ешкім	jeʃkim
ешкімге	jɪʃkɪmge
ешкіммен	jɪʃkɪmˈmen
ешкімнің	jeʃkimˈniŋ
ешқандай	jeʃqɑndɑj
ешқашан	jɪʃqɑʃɑn
ештеме	jɪʃtɪˈmɛ
ештеңе	jɘʃteŋjɘ
ештеңеге	jeʃteŋege
ештеңеміз	jeʃteŋemiːz
жабатын	dʒɑbɑtɯn
жабуға	ʒɑβʊʁɑ
жабық	dʒɑβɯq
жабылмақ	ʒɑβɯɫˈmɑq
жабыңдар	dʒɑβɯŋdɑɾ
жабысқақ	ʒɑβɯsqɑq
жағаға	ʒɑˈɣɑʁ
жағалауда	ʒɑɣɑɫɑwˈdɑ
жағдай	ʒɑɣdɑj
жағдайға	ʒɑɣdɑjɑ
жағдайда	dʒɑɣdɑjˈdɑ
жағдайдасыз	ʒɑɣdɑjdɑsɯz
жағдайдасың	ʒɑɣdɑjdɑsɯŋ
жағдайды	ʒɑɣdɑjˈdɯ
жағдаймен	dʒɑɣdɑjmen
жағдайы	ʒɑɣdɑjɯ
жағдайым	ʒɑɣdɑjɯm
жағдайымды	ʒɑɣdɑjɯmˈdɯ
жағдайын	ʒɑɣdɑjɯn
жағдайына	ʒɑɣdɑjɯnɑ
жағдайың	ʒɑɣdɑjɯŋ
жағдайыңды	ʒɑɣdɑjɯŋdɯ
жағы	ʒɑˈɣɯ
жағымды	ʒɑˈɣɯmˈdɯ
жағымсыз	ʒɑˈʁɯmsɯz
жағында	ʒɑˈʁɯnˈdɑ
жағыңдар	dʒɑˈʁɯŋdɑr
жағып	dʒɑˈʁɯp
жадты	dʒɑt
жаз	dʒɑz
жаза	dʒɑzɑ
жазам	ʒɑˈzɑm
жазбаған	dʒɑzβɑɣɑn
жазған	dʒɑzˈɣɑn
жаздағам	ʒɑzˈdɑɣɑm
жаздадым	dʒɑzˈdɑdɯm
жаздаппыз	ʒɑzdɑpˈpɯz
жаздаппын	ʒɑzˈdɑpɯn
жаздым	ʒɑzˈdɯm
жаздың	ʒɑzˈdɯŋ
жазылған	dʒɑzɯɫɣɑn
жазылды	dʒɑzɯɫdɯ
жазылыпты	ʒɑzɯɫɯptɯ
жазым	dʒɑˈzɯm
жазып	ʒɑˈzɯp
жазыпсың	ʒɑˈzɯpsɯŋ
жай	ʒaj
жайға	ʒajˈʁɑ
жайғас	ʒajˈʁɑs
жайғастырады	ʒajɣɑstɯrɑdɯ
жайлы	ʒɑɫɯ
жаймен	ʒajˈmen
жайында	ʒajɯnˈdɑ
жайып	ʒɑjɯp
жаққа	ʒɑqˈqɑ
жақпайды	ʒɑqpɑjˈdɯ
жақсарды	dʒɑqˈsɑrdɯ
жақсартамыз	ʒɑqˈsɑrtɑˈmɯz
жақсы	ʒɑqˈsɯ
жақсылап	ʒɑqsɯlɑp
жақсымын	ʒɑqsɯmɯn
жақта	ʒɑqˈtɑ
жақтан	dʒɑqˈtɑn
жақты	ʒɑqˈtɯ
жақтың	ʒɑqˈtɯŋ
жақтырмайды	dʒɑqˈtɯrmɑjˈdɯ
жақын	ʒɑqɯn
жақындамаңдар	ʒɑqɯndɑmɑŋdɑr
жақындап	dʒɑqɯndɑp
жалақы	ʒɑɫɑqɯ
жалаңаш	ʒɑɫɑɲɑʃ
жалған	ʒɑɫˈʁɑn
жалғастырмайды	ʒɑɫɣɑstɯrmɑj
жалғыз	ʒɑlɣɯz
жалпы	ʒɑlˈpɯ
жалынды	ʒɑɫɯndɯ
жаман	ʒɑˈmɑn
жаманы	ʒɑmɑnɯ
жамшит	ʒɑmˈʃɯt
жан	ʒɑn
жанның	ʒɑnˈnɯŋ
жануар	ʒɑnuɑr
жануарға	ʒɑnuɑɾə
жануда	ʒɑnʊˈdɑ
жаншып	ʒɑnʃɯp
жаным	ʒɑˈnɯm
жанымда	ʒɑˈnɯmˈdɑ
жанына	ʒɑnɯnɑ
жанында	ʒɑnɯnˈdɑ
жанындағы	ʒɑnɯndɑɣɯ
жанындасың	ʒɑnɯndɑsɯŋ
жаныңда	ʒɑˈnɯŋdɑ
жанып	ʒɑnɯp
жаңа	ʒɑŋ
жаңағы	ʒɑŋɑɣɯ
жаңадан	ʒɑɲɑdɑn
жаңалық	ʒɑŋɑɫɯq
жаңалықтардан	ʒɑŋɑɫɯqˈtɑrɑn
жап	ʒɑp
жара	ʒɑrɑ
жарады	ʒɑrɑdɯ
жарадың	ʒɑrɑˈdɯŋ
жарай	ʒɑˈrɑj
жарайды	ʒɑˈrɑjdɯ
жарайсың	ʒɑrɑjsɯŋ
жарайсыңдар	ʒɑrɑjsɯŋdɑr
жараласың	ʒɑrɑlɑsɯŋ
жаралы	ʒɑrɑˈɫɯ
жараң	ʒɑˈrɑŋ
жарға	ʒɑrˈɣɑ
жарық	ʒɑɾɯq
жарықты	ʒɑrɯqˈtɯ
жас	ʒɑs
жасаған	ʒɑsɑˈɣɑn
жасағансыңдар	dʒɑsɑɣɑnsɯŋdɑr
жасағым	ʒɑsɑɣɯm
жасады	ʒɑsɑdɯ
жасадың	dʒɑsɑdɯŋ
жасай	ʒɑsɑj
жасаймыз	dʒɑsɑjmɯz
жасаймын	ʒɑsɑjmɯn
жасайсың	dʒɑsɑjsɯŋ
жасайтын	ʒɑsɑjtɯn
жасайық	dʒɑsɑjɯq
жасалған	ʒɑsɑɫˈʁɑn
жасамақшы	ʒɑsɑmɑqʃɯ
жасанды	ʒɑsɑndɯ
жасаңыз	ʒɑsɑŋɯz
жасап	ʒɑsɑp
жасар	dʒɑsɑr
жасасам	ʒɑsɑsɑm
жасасын	dʒɑsɑsɯn
жасатам	dʒɑsɑtɑm
жасау	ʒɑsɑw
жасауың	dʒɑsɑwɯŋ
жасашы	ʒɑsɑʃɯ
жасқанбайды	ʒɑsqɑnbɑjˈdɯ
жаста	ʒɑsˈtɑ
жастар	ʒɑsˈtɑr
жастары	ʒɑstɑrɯ
жастарын	ʒɑstɑrɯn
жасы	ʒɑsɯ
жасымда	dʒɑsɯmˈdɑ
жасырмақшы	dʒɑsɯrmɑqʃɯ
жасырып	ʒɑsɯɾɯp
жатақхана	dʒɑtɑqχɑnɑ
жатқан	ʒɑtˈqɑn
жатқанда	ʒɑtˈqɑnˈdɑ
жатқандай	ʒɑtqɑnˈdɑj
жатқаны	ʒɑθqɑnɯ
жатқыным	ʒɑθqɯˈnɯm
жатпайды	ʒɑtˈpɑjˈdɯ
жатсың	ʒɑtsɯŋ
жатсыңдар	dʒɑtsɯŋdɑr
жатыңдар	ʒɑˈtɯŋdɑr
жатыңыз	ʒɑˈtɯŋɯz
жатып	dʒɑtɯp
жатыпішер	dʒɑtɯpɯʃer
жатыр	dʒɑtɯɾ
жатырмыз	dʒɑtɯrmɯz
жатырмын	dʒɑtɯrmɯn
жатырсыз	ʒɑtɯrsɯz
жатырсың	dʒɑtɯrsɯŋ
жатысым	ʒɑtɯsɯm
жауабыңды	dʒɑwɑbɯŋdɯ
жауап	ʒɑwɑp
жауапты	ʒɑwɑptɯ
жауаптысың	ʒɑwɑptɯsɯŋ
жауған	ʒɑwˈʁɑn
жауыз	ʒɑwɯz
жауынды	ʒɑwɯnˈdɯ
жауыннан	ʒɑwɯnˈnɑn
жауып	dʒɑwɯp
жаһандық	ʒɑhɑndɯq
жаяу	ʒɑjɑw
жәй	ʒæj
және	ʒæne
жәрдем	ʒæɾˈdæm
же	ʒe
жегенін	ʒegeniːn
жегенің	dʒegeˈniŋ
жегім	dʒeɣim
жегіп	ʒeɣɪp
жегісі	ʒeɣɪsɪ
жедел	ʒeˈdel
жезөкше	dʒeˈzøkʃe
жезөкшеден	ʒezoʃeˈden
жейдемді	dʒejdemˈdi
жейсіз	dʒejˈsɯz
жейсің	dʒejˈsiŋ
жейтін	ʒejˈtin
жек	dʒɛk
жеке	ʒeˈke
жеккөрініштен	dʒɛkːøˈɾønɪʃtæn
жеккөрінішті	dʒɛkːøˈrønɪʃtɪ
жексенбі	ʒɛkˈsɛnbi
жексұрындар	ʒɛksuˈrɯndɑr
жел	ʒɪl
желкөз	ʒɪlˈkøz
жемекпісің	ʒɪmɪkpɪˈsɪŋ
жемеңіз	dʒemeˈnɪz
жеңгенімді	ʒeŋgɪnimˈdi
жеңдім	ʒeɳˈdim
жеңдің	ʒeŋˈdɪŋ
жеңемін	ʒeɲeˈmɪn
жеңілдейсің	ʒeɳildejsɪŋ
жеңілдеп	ʒeɲildʲep
жеңіле	ʒeɲɪˈle
жеңілтек	ʒeɲilˈtek
жеңіп	ʒeɲɪp
жеп	ʒɛp
жер	ʒɪr
жерге	ʒɛrˈge
жергілікті	ʒɪrɣɪlɪkˈtɪ
жерде	ʒɪrˈdɪ
жерден	ʒɪrˈdɪn
жерді	ʒɪrˈdi
жердің	ʒɪrɪŋ
жерім	ʒeˈrim
жеріңе	ʒeˈriŋe
жертөледе	ʒɪrtøˈlɘdæ
жесең	ʒeˈseŋ
жете	ʒeˈte
жетеді	ʒetɛdi
жетеміз	dʒetemiʑ
жетерлік	ʒetɪɾɫɪk
жетерсің	dʒetɪrˈsiŋ
жеті	ʒeˈti
жетіңдер	dʒeˈtɪŋdɪr
жетіп	ʒeˈtʰɪp
жетістіктерге	ʒetɪsˈtɪkʰtɪrɣe
жеткізгеніңе	ʒetkiˈzʁeŋi
жеткізгім	dʒetkiˈzɯm
жеткіздім	ʒetkiˈzdɪm
жеткізе	ʒetˈkɯzɘ
жеткізем	ʒetkiˈzæm
жеткіземін	ʒetkiˈzemin
жеткізілген	ʒetkiˈzɪɫgen
жеткізу	ʒetˈkɯzʊ
жеткізуіңіз	ʒetkiˈzuɪŋɪz
жетпейді	dʒetpejdi
жеттіңіз	ʒetːiŋɪz
жетуіне	ʒɪtʉɪˈnæ
жеудің	ʒewˈdiŋ
жеуің	ʒɘwɘŋ
жиіркеніш	ʒiirkeniʃ
жиіркенішті	ʒiːrkʲenɪʃti
жина	ʒɪˈnɑ
жинағанға	ʒɪnɑːɣɑːn
жинадық	ʒɪnɑɯq
жинай	ʒɨˈnɑj
жиналу	ʒɪnɑˈɫʊ
жиналыс	ʒɪnɑˈlɯs
жинаңдар	ʒɪˈnaŋdɑr
жирен	ʒɪˈrɪn
жиырма	ʒɪwɾmɑ
жібер	ʒɪˈbʲɪr
жіберген	dʒɪbɪrɪgʲɪn
жібергенде	ʒɪbeɾgʲeɳde
жібергенің	dʒibergeniŋ
жіберді	ʒiberdi
жібердің	ʒiberiŋ
жібереді	ʒɪbɪrɪˈdæ
жіберем	ʒɪbɪˈrɪm
жібереміз	ʒɪbɪrɪˈmɪz
жіберемін	ʒɪbʲerɪˈmɪn
жіберерміз	ʒɪbɪrɪrmɪz
жіберілді	ʒɪbɪrɪldɪ
жіберіңдер	dʒɪbɪˈrɪŋdɪr
жіберіңдерші	dʒɪbɪrɪŋdɪrʃɪ
жіберіңіз	dʒɪbɪrɪŋɪz
жіберіппін	ʒɪbɪrɪpˈpɪn
жіберіпсің	ʒɪbɪrɪpˈsɪŋ
жібермейік	ʒɪbɪrˈmɛjɪk
жіберсең	dʒiberseŋ
жіберуді	dʒɪbɪrʊdɪ
жіберуім	ʒɪbʲɪˈrʉm
жіберші	dʒɪbɪrʃɪ
жігерлендірілген	ʒɪgʲɪɾlʲɪndɪɾɪɫgʲɪn
жігіт	dʒɪˈgɪt
жігітің	ʒɪɣɪˈtɪŋ
жігіттер	ʒɪgɪtˈtɪr
жоғалған	ʒoʁɑɫˈɣɑn
жоғалғаннан	ʒoʁɑɫˈɣɑnˈnɑn
жоғалғаныңа	ʒoʁɑɫɣɑnɯŋ
жоғалт	ʒoʁɑlt
жоғалтқан	ʒoʁɑltqɑn
жоғалтпа	ʒoʁɑltpɑ
жоғалып	ʒoɣɑləp
жоғарғы	ʒoʁaɾɣɯ
жоғары	ʒoʁɑrɯ
жоғарыға	ʒoʁɑrɯɣɑ
жоғарының	ʒoʁɑɾɯˈnɯŋ
жойылған	ʒojɯɫɣɑn
жойылғаны	ʒojɯɫˈqɑnɯ
жойыңдар	ʒojɯŋdɑr
жойып	ʒojɯp
жоқ	ʒoq
жоққа	ʒoqˈqɑ
жоқпын	ʒoqpɯn
жоқсыз	ʒoqˈsɯz
жоқсың	ʒoqˈsɯŋ
жоқтан	ʒoʁˈtɑn
жол	ʒɔɫ
жолаушы	ʒɔɫɑwˈʃɯ
жолда	ʒɔɫdɑ
жолдан	ʒɔɫdɑn
жолдар	ʒɔɫˈdɑr
жолды	ʒɔɫdɯ
жолмен	ʒɔlmɛn
жолы	ʒoˈɫə
жолығайын	ʒoˈɫɯɣajɯn
жолығыңыз	ʒoˈɫəɣəˈɲɯz
жолығып	ʒoˈɫɯʁɯp
жолықтырыңыз	ʒoɫɯqtɯɾeŋɯz
жолың	ʒɔˈɫɯŋ
жомарт	ʒoˈmɑrt
жориды	ʒɔɾɯˈdɯ
жоспары	ʒoˈsparɯ
жоспарым	ʒoˈspɑrɯm
жөнінде	ʒoˈnɘnde
жуасың	ʒʊɑˈsɯŋ
жуасыңдар	ʒʋɑsɯŋdɑɾ
жудым	dʐʊˈdɯm
жумаған	ʒumɑɣɑn
журнал	ʒurnɑɫ
журналистерді	ʒʊrnɑlʲɪstɪɾˈdɪ
жусан	ʒʊˈsɑn
жуынды	dʐʊɯnˈdɯ
жуындырасың	ʒowɯndɯɾɑsɯŋ
жуыңдар	ʒʊwɯŋdɑr
жүгір	ʒʏˈɣɪr
жүз	ʒʏz
жүздеген	ʒʏzdegen
жүзі	ʒʉˈzɪ
жүзіп	ʒʉzɪp
жүйе	ʒyje
жүйесі	ʒʉjɪsɪ
жүйесінде	ʒʉjɪsɪndɘ
жүк	ʒʏk
жүккөлік	ʒʏkːœlɪk
жүр	ʒʏr
жүргем	ʒʉrɣem
жүрген	ʒɯɾˈgʲen
жүргенімізді	ʒɯɾɣeˈniˈmɯzdɯ
жүргеніңіз	ʒɯɾɣeˈniŋɯz
жүргіземін	ʒɯɾɣiʒeˈmin
жүргізесіз	ʒɯɾɣɪˈzɪsɪz
жүргізуге	ʒɯɾɣɨzuɣe
жүрді	ʒɯɾˈdɯ
жүрегі	ʒʉrɘɣi
жүрегіне	ʒʉrɘgʲiˈnɘ
жүреді	ʒʉˈrɘdɘ
жүрейік	ʒʉrɛjɪk
жүрейін	ʒʉrɪjɪn
жүрек	ʒʉˈræk
жүрер	ʒʉˈrɘr
жүретін	ʒʉrɛtɪŋ
жүріңдер	ʒʉɾɪŋdɪr
жүріңіз	ʒʉɾiŋɨz
жүріп	ʒʉˈrip
жүрмекпісің	ʒɯɾmɛkpɪˈsɪŋ
жүрмін	ʒʉrmʏn
жүрсе	ʒɯrˈsɛ
жүрсің	ʒʏrˈsiŋ
жүрсіңдер	ʒʏrɕɪŋdɛr
жүру	ʒʉˈɾʉ
жүруім	ʒʉrʉm
жүруіңе	ʒʉɾʉiŋe
жұбайы	ʒʊβaɪɯ
жұқтыру	ʒoqtɯɾu
жұлынған	ʒʉlɯŋɑn
жұлынып	ʒʉlənɯp
жұлып	ʒɯˈlɯp
жұма	ʒoʋmɑ
жұмды	ʒumˈdɯ
жұмсақ	ʒʊmsɑq
жұмыс	ʒoʊˈmɯs
жұмысберушісі	ʒʊmɯsbeɾuʃɯsɯ
жұмысқа	ʒʊmɯsqa
жұмыспен	ʒʊmɯsˈpʲen
жұмыстан	ʒʊmɯsˈtɑn
жұмыстары	ʒʊmɯsˈtɑɾɯ
жұмыстарым	ʒʊmɯstaˈrɯm
жұмысты	ʒʊmɯsˈtɯ
жұмысшы	ʒoʋɯʃɯ
жұмысшылармен	ʒoʊmɯʃʃɯlaɾmɛn
жұмысшысы	ʒʊmɯʃɯʃɯ
жұмысы	ʒoʏˈmɯsɯ
жұмысым	ʒʊmɯsɯm
жұмысымды	ʒʊmɯsɯmdɯ
жұмысын	ʒoʋɯsɯn
жұмысына	ʒʊmɯsɯnɑ
жұмысың	ʒʊmɯsɯŋ
жұмысыңыз	ʒʊmɯsɯŋɯz
жұрт	ʒʊrt
жұт	ʒʊt
жыйналысқа	ʒɯjnɑlɯsqɑ
жықтырамын	ʒɯqtɯɾɑmɯn
жыл	ʒɯɫ
жылаймын	ʒɯɫajˈmɯn
жылама	ʒɯɫɑmɑ
жылауық	ʒɯɫɑwɯq
жылдағы	ʒɯɫɑɣɯ
жылдам	ʒɯɫˈdɑm
жылдамдық	ʒɯɫdɑmq
жылдан	ʒɯɫd̪an
жылдар	ʒɯɫˈdɑr
жылжып	ʒɯɫˈʐɯp
жылу	ʒɯˈɫʊ
жылы	ʒɯˈɫɯ
жынданып	ʒɯndanɯp
жынды	ʒɯnˈdɯ
жынысы	ʒɯˈnɯsɯ
зақым	ʁɑqɯm
зақымдалған	ʁɑqɯmdɑɫˈʁɑn
заңсыз	ʒɑŋˈsɯz
заңы	ʒɑˈnɯ
зат	ʐɑt
затқа	ʐɑtˈqɑ
заттар	ʐɑtːɑr
заттардың	ʐɑtːɑɾˈdɯŋ
заттармен	ʐɑtːɑrmʲɪn
затты	ʐɑtːɯ
зауыттарда	zawɯtˈtɑrˈdɑ
звонда	zvondɑ
звондағаныма	zvondɑɣɑnɯmɑ
звондаңыз	zvondɑŋɯz
зейінсіз	zejinsɯz
зерттедіңіз	ʐɪrt̪t̪e̞ˈdiŋɪz
зерттеуінде	ʐɪrttɘwˈiŋdɘ
зия	zijɑ
зиян	ʑiˈjɑn
зиянды	ʑijɑnˈdɯ
зомбылыққа	ˈzomβɯɫəqːə
зомбылықпен	ˈzombɯɫɯqpen
зоодүкен	zoːdʏˈkʲɪn
зызбен	zɯzˈbɘn
зым	zɯm
зыя	zɯjɑ
иә	iə
ибарра	ɪbɑrɑ
ие	je
иеленбе	jeleŋbe
иелері	jɪlæˈrɪ
иемденіп	ijemdenip
иемдену	ijemdenu
иесі	jesi
израил	ɪzrɑɪl
израилдықтар	izrɑjɯɯtqɯtɑr
израилмен	ɪzrɑɪlˈmen
израиль	ɪzrɑjɪl
иісі	iːsɪ
иісін	iːsɪn
иісіне	iɪsɪne
иісті	iːsʲtɪ
иллардтың	ɯɫɑɾdɯtɯŋ
иллоу	ɪlːoʊ
ильямнан	iɫjəman
иммигрант	immigrɑnt
импрессариом	ɪmprɪsɑrɪˈw
ингрид	ɪŋˈgrɪd
инға	iŋɣɑ
инда	indɑ
ине	iːnɛ
инженер	ɪnʲɪˈgʲɛr
институтынан	ɪnstʲɪtʉtɯˈnɑn
интернеттен	ɪntɛrnɛtˈtɛn
исак	ɪsɑq
исакпен	ɪsɑqˈpɛn
исакты	ɪsɑqtɯ
исактың	ɯsɑqˈtɯŋ
испан	ɪsˈpɑn
ит	iːt
итере	ɪtɪˈrɪ
итни	itni
итнимен	itnimen
итнимін	itnimeen
иттер	ɪtːɪr
иттерге	itːerge
иттердің	itːerˈdiŋ
иығыма	iɯɣɯma
із	ɘs
ізгі	ɘzˈɣɘ
ізде	ɘzˈdɘ
іздеген	ɪzdegen
іздегендей	ɘzdegendɘj
іздей	ɘzˈdɛj
іздеңдер	ɪzdeŋdeɾ
іздеп	ɘzˈdɘp
іздері	ɘzdæɾɘ
іздерін	ɘzdæɾɘn
іздеу	ɘzˈdɘw
іздеумен	ɪzdewmen
ізі	ɯˈzɯ
ізіне	ɘzɘnɘ
ілінісіп	ilɪnisip
іліп	ɪlɪp
ілмекті	ɯlmɘktʃi
іргетасы	ɯɾgʲɪtɑsɯ
іргетасын	irgetɑsɯn
ірі	ɪˈri
іс	ɪs
ісі	ɪˈsɪ
ісігінен	ɯsiɣinɘn
ісік	ɯˈsɯq
ісім	ɪˈsɪm
ісімен	ɪsɪˈmɪn
ісін	ɪˈsɪn
ісінде	iɕɪndɘ
ісіне	ɪsɪne
іске	ɪske
істе	istɘ
істегендеріңді	istɪge̞ndɪrɪŋdɪ
істегені	istɪgɪni
істегенімді	istegeŋimdi
істегім	istɪˈɣɪm
істедік	istɪˈdɪk
істедіңіз	istɪˈdɪŋɪz
істей	iˈstej
істейді	istejdi
істейміз	iˈstejˈmɪz
істеймін	istʲejˈmin
істейсіз	iˈstejsɯz
істейсің	iˈstejsiŋ
істейсіңдер	istejsiŋdɘr
істейтін	istʲejˈtin
істейтініңді	istʲejˈtinɪŋdi
істемейді	istɪmɛjˈdɪ
істемеймін	istɪmɪjˈmɪn
істемейсің	istɪmejˈsiŋ
істемейтін	istɪmɛjˈtɪŋ
істемек	istɪˈmɛk
істемесе	istɪmɪsɪ
істемеші	istɪmeʃɪ
істеңдер	istɘŋdɘr
істеңдерші	istɘŋdɘɾʃi
істеп	istɪp
істер	ɪsˈtɜr
істерде	ɯsteɾde
істесек	istɪsɛk
істесем	istɪsɛm
істесең	isteseŋ
істетеді	istetedi
істеу	istɘw
істеуге	istɘwɘ
істеуде	ɪsteʊdɪ
істеуім	istɘwɘm
істі	istɪ
істуім	ɯstʉm
ішеміз	ɪʃeˈmɪz
ішерлер	ɪʃɪɾˈlɪr
ішімдік	ɘʃɘmdɘk
ішімізде	iʃimɪzde
ішінде	ɪʃɪndɛ
ішінен	ɯʃɯˈnɪn
ішіңдегі	ɪʃɪŋdægɪ
ішіңізді	iʃɪŋɪzdi
ішіңіздің	iʃiŋizdiŋ
ішіп	ɪʃɪp
ішке	ɪʃkʲe
ішкі	ɯʃki
ішпедің	ɯʃpeˈtɯŋ
іште	ɪʃtɛ
іштегі	ɪʃtegi
іштім	ɪʃtɪm
камералары	ˈkɑmʲerɑˌɫɑrɯ
кампалада	ˈkɑmpɑˌɫɑdɑ
кампаладамын	ˈkɑmpɑɫɑdɑmɯn
канада	qɑnɑdɑ
канибал	kanɪbɑɫ
канибалмын	kanɪbɑlˈmɯn
канингэм	kanɪŋɛm
капиталдық	kapʰɪtɑɫdɯq
капитан	kapʰi'tan
кар	kɑr
кард	kaɾd
картаны	ˈkɑrtɑnɯ
касетөм	qɑsɘtøm
католик	qɑtɑˈlɪq
кацурэ	katsure
кәдімгі	ˈkædɪmɣɪ
кәзір	ˈkæzɪr
кәне	qæne
кәріптасты	kerɪptɑstɯ
кәсіпкер	ˈkæsɪpkɪr
квантико	kwɑntʰɪkɔ
кедей	kedej
кедергі	kedeɾɣi
кез	ke̞z
кезде	ke̞zde
кездежүр	keʒdeʒʉr
кездесем	ˈkɛzdɛsɛm
кездесеміз	ke̞zdesemi̞z
кездесетін	kezd̪esetʰin
кездескен	ke̞z̪des̪q̟en
кездеспей	ke̞z̪d̪es̪pej
кездесу	ke̞z̪de̞s̪u
кездесулер	ke̞zdesʉ̞lʲɪ̞r
кезімде	keˈzɪmde
кезінде	keˈzʲinde
кезінен	keziˈnɪn
кей	kej
кейбір	kejˈbiɾ
кейде	kejde
кейін	keiin
кейіндеу	kejindew
кейінірекке	keiineˈrekke
кел	kel
келбетің	kelbɘtiŋ
келген	kelgen
келгенде	kelgenˈde
келгендерің	kelge̞ndɪ̞ˈrʲɪ̞ŋ
келгенім	kelgeˈnim
келгеніме	kelgeˈnime
келгенін	kelgɛniːn
келгеніне	kelgeˈnine
келгеніңе	kelgeˈniŋe
келгеніңізге	kelgəniŋizge
келгеніңізді	kelgəniŋizdi
келгенше	kelgenʃe
келгің	kelgɪŋ
келді	kelˈdi
келдік	kelˈdɪk
келдім	kelˈdim
келдің	kelˈdiŋ
келдіңіз	keldiŋiz
келе	kele
келеді	kelɪdi
келейін	kelejin
келек	keˈlek
келем	keˈlem
келеміз	kelɪˈmɪz
келемін	kelʲemin
келермін	kelɪrmɪn
келесі	kelɪˈsi
келесің	kelɪˈsiŋ
келіңдер	kelɪŋdɛr
келіңіз	kelɪŋɪz
келіп	kelip
келіпсіз	kelɪpˈsɪz
келіпті	kelɪptɪ
келісім	kɘˈlɘsɘm
келісімін	kelɪsɪmɪn
келісімшартқа	kelisɪmʃɑrtqɑ
келісіп	kelɪˈsɪp
келіскен	kelɪsˈken
келіскендей	kelɪskendɛj
келіспесеңіз	kelɪspeˈsɪŋɪz
келісті	kelɪsˈtɪ
келістік	kelɪsˈtɪk
келістім	kelistim
келмеген	kelmɛgen
келмеді	kelmɘdi
келмей	kelˈmej
келмейді	kelmɛjdi
келмеймін	kelmɛjˈmɪn
келмейтін	kelmɛjˈtin
келмес	kelˈmes
келмесін	kelmɘˈsɘn
келсе	kel'sɪ
келтірер	keltiˈrɪr
келу	kɘˈɫʉ
келуге	kelʊɣe
келуіне	kelʉiˈnæ
келуің	kelʉiŋ
келуіңізбен	keluɪŋɪzben
келші	kelʃi
кем	kem
кеміргіш	kemɪrɣɪʃ
кемпірлерді	kempirlɘɾˈdi
кенелген	kenelgen
кең	keŋ
кеңес	ˈkʲeŋɪs
кеңесшілерім	keŋesʃɪleɾɪm
кеңесшім	keŋeɕɪm
кеңесшімсің	ˈkʲeŋɪsʃɪmˈsɪŋ
кеп	kʲep
кепілгер	kepɪɫɣer
кептірілген	ˈkɛptɪrɪlgɛn
керегі	kerɪɣɪ
керегімізді	kerɪgimɪsdi
керегінің	kerɪginʲi
керек	kerɛk
керекпін	kerɪkˈpɪn
керексің	kerɪkʃiŋ
керекті	keretɕi
керектігін	keretkiˈtʰi
керемет	keremɪt
кереспе	kerespɘ
кері	keri
керуетте	kerʉjetʰ
кесел	kesɛl
кесетін	kʲesetʰin
кесіліп	kɘsɘlɘp
кесіп	ˈkɘsɘp
кесірінен	ˈkɛsɪrɪˌnɛn
кесіріңнен	ˈkɘsɪrɘŋnɘn
кесіртке	ˈkɘsɘrtkɘ
кет	ket
кете	ketɘ
кетеді	ketedi
кетейікші	ketejɪkʃi
кетейін	ketejiːn
кетемін	ketemin
кетесің	ketɪˈʃɪŋ
кететін	ketetin
кетіңдер	ketiŋdær
кетіңіз	ketiŋiz
кетіп	ketip
кетіппін	ketipˈpɪn
кетіпсің	ketipˈsiŋ
кетіресіңдер	ketiɾesiŋdɪr
кеткелі	ketkɛli
кеткен	ketken
кеткендеріңді	ketkendeəriŋdi
кеткені	ketkɛni
кеткенің	ketkɛniŋ
кеткеніңе	ketkɪˈniŋe
кеткенсің	ketkenˈsiŋ
кеткір	ketˈkɪr
кетпеді	ketpɘdi
кетпедің	ketpʲeˈdiŋ
кетпей	ketˈpej
кетпейміз	ketpejˈmɪz
кетпеймін	ketpæjˈmin
кетпекші	ketpɛkʃɪ
кетпесе	ketpese
кетпесін	ketpɪˈsɪn
кетсем	ketˈsem
кетсең	ketˈseŋ
кетсін	ketˈsɪn
кетсінші	ketˈsɪnʃi
кетті	keti
кеттік	ketˈtɪk
кеттім	ketem
кеттің	ketˈtɪŋ
кеттіңдер	ketˈtɪŋdɛr
кеттіңіздер	ketːiŋizdɛr
кету	ketu
кетуі	ketuɪ
кетуім	ketuim
кетші	ketʃi
кеудесіне	kwɘwˈdɘsɘnɘ
кеш	keʃ
кеше	keʃe
кешегі	keʃeɣi
кешір	ˈkæʃɪr
кешіреміз	kɛʃɪrɛˈmɪz
кешіремін	keʃiˈrɪmɪn
кешірер	keʃiˈrær
кешірілген	kɘʃɘɾɘlˈgʲɘn
кешірім	keʃiˈrim
кешіріңдер	keʃiˈrɪŋdɪr
кешіріңіз	keʃiˈrɪŋɪz
кешіріңізші	keʃiˈrɘŋɘʃi
кешірмеймін	kɛʃɪrmɛjmɪn
кешірмек	ˈkæʃɪrmæk
кешірші	keʃiɾʃi
кешке	kɘʃkɘ
кешкі	ˈkɛʃkɪ
кешкіріп	kɛʃkɪˈrip
кешріңіз	ˈkɘʃrɘˈnɘz
киім	kiːm
киімімді	kiːmɪmdɪ
киінесің	kiːnesiŋ
киінуім	kiːnuːm
киіп	kiɪp
кимегендіктен	kimʲegendɪktʲen
киндред	kin'drɛt
киуіме	kiwɪme
кілемімді	kilɪmɪmdɪ
кілең	kilæŋ
кілті	kilti
кілтті	kilttɪ
кім	kim
кімге	kimge
кімді	kimˈdi
кімдікі	kimˈdiqi
кіммен	kimˈmen
кімнен	kimˈnen
кімнің	kimˈnʲi
кімсіз	kimˈsiːs
кімсің	kimˈsiŋ
кімсіңдер	kimˈsɪŋdɪr
кінәлерді	kinælæɾˈdi
кінәлі	kinæli
кінәлісіз	kinælɪsɪz
кір	kir
кіргізгенімізді	kirgizʁeniˈmisdi
кіргізді	kirgɪsˈdi
кіргіңіз	kirgiŋiz
кірді	kirˈdi
кіре	kirɘ
кіретін	kiɾeˈtin
кіріңдер	kirɪŋdɪr
кіріңіз	kirəˈnɪz
кіріп	kirɪp
кіріпті	kirɪptɪ
кірісейік	kirisejɪk
кірісіңдер	kirisɪŋdɘr
кірме	kirme
кірпіктер	kirpɪkˈtɪr
кірсін	kirˈsɪn
кісі	kiˈsi
кісіге	kiˈsiɣe
кісіден	kiˈsɪdɪn
кісілер	kiˈsɪlæɾ
кісілерге	kiˈsɪlɪrge
кісіні	kiˈsini
кісінің	kiˈsɪniŋ
кітабы	kitɑbɯ
кітап	kitɑp
кітаптап	kitɑptɑp
кіш	kiʃ
кішкене	kiʃkɪnɛ
кішкенетайсың	kiʃkeneˈtajsɯŋ
кішкентай	kiʃkɘnˈtɑj
клайд	klɑj
клетка	klʲetkɑ
клеткаларды	klʲetqɑlɑɾdɯ
клеткалары	klʲetqɑˈɫɑɾɯ
клиникалық	klʲinʲɪkɑˈɫɯq
ковбойлар	koʊvbɔjˈlɑr
колумбия	koɫumˈbʲiə
комази	koˈmɑzɪ
команда	komɑˈmandɑ
комиссияға	komɪsɪjɑɣɑ
коммунистер	komʊnʲɪsʲtʲɪr
комплексті	komplʲekstʲi
конгресс	kɔŋˈgrɛs
конференцияда	kɔnferʲɛnsiʲə
концерті	kʰontsɛrˈtʲi
коридордың	koɾidoɾˈdɯŋ
кофе	kofe
кохаку	koχɑkʊ
кохакугава	koχɑkʊˈɣɑwɑ
коэль	kojɪl
көбеюде	kobejude
көбіне	kobine
көбірек	kobiˈrek
көз	koz
көзге	koʒge
көздерді	koːzdɘrˈdiː
көздері	koːzderi
көздерім	koːzdeˈrim
көзімді	koˈzɯmdɯ
көзімізді	koˈzɯmɯzdɯ
көзін	koˈzɪn
көзің	koˈziŋ
көзіңді	koziŋdi
көзіңізді	koziŋizˈdi
көк	koq
көкірек	kokiˈrek
көкөніс	koˈkøˈnɪs
көлігім	koːliɣim
көлігіне	koːlɪgɪne
көлігіңде	koːlɪɣeːŋde
көлігіңді	koːliɣiŋdi
көлік	koːˈlɪk
көлікте	koˈlɯktɛ
көліктегі	koliqteɣi
көлікті	koˈlɪkti
көмегімді	komɛɣɪmdi
көмегің	koˈmæʁɪŋ
көмегіңе	komeɣiŋe
көмегіңіз	komeɣiˈŋiz
көмегіңізге	komɛʁiŋizge
көмегіңмен	komæɣiŋˈmen
көмек	koˈmɛk
көмектес	koˈmɛktɪs
көмектесе	koˈmektʲesæ
көмектеседі	komɛktɛsɛdi
көмектесемін	komɛktɛsɛmin
көмектесер	komɛktɛsɛr
көмектесесің	komɛktɛsɛˈsɪŋ
көмектесесіңдер	komɛktɛsɪˈsɪŋdɛr
көмектесіңдер	komɛktɛˈsɪŋdɛr
көмектесіңізші	komɛktɛsiŋɯʃ
көмектескен	komɛktɛskʲɪn
көмектеспекшісің	komɛktɛspɛkʃiˈsɪŋ
көмектессең	komɛktɛsɛŋ
көмектесуі	komɛktɛsʉj
көмекші	koˈmekʃi
көмекшісі	koˈmekʃiˈsi
көмірге	komirɣe
көн	køn
көндірді	koːndirɪr
көндіре	koːndiɾe
көндіру	ˈkøndiɾu
көнсең	koːnseŋ
көңіл	koŋɯl
көңілдеріңді	koŋɯldɪrɪŋdɪ
көңілді	koŋɯldɯ
көңілдігіңді	koŋɯldɯʁɯŋdɯ
көңілі	koŋɯˈli
көңілімді	koŋiɫimdi
көңілін	koŋɯˈlɯn
көңілінен	koŋilɪnen
көңілің	koŋiˈliŋ
көңіліңді	koŋiɫiŋdi
көңіліңіз	koŋiˈlɪŋɪz
көп	kop
көпірге	kopirɣe
көптеген	koˈptechæŋ
көптеп	koˈptep
көпшілік	koepʃiˈlɪk
көр	koer
көргем	gøɾˈgem
көрген	gørˈgen
көргенімді	gørgeɲimˈdi
көргенің	gœrgɛniŋ
көргім	kʏrˈɣɪm
көргісі	koerɣiˈsi
көрді	gørˈdi
көрдім	gørˈdɪm
көрдің	koerˈdiŋ
көрдіңіз	koerˈdiŋiz
көрдіңізбе	gøɾdiŋɪzˈbɪ
көре	koˈre
көреді	koˈrɪdi
көрейік	koɾejik
көрейін	koɾejˈin
көреміз	koɾemiz
көрерміз	koˈrɪrmɪz
көресіз	ko̙ˈresɪz
көресің	koɾesiŋ
көресіңдер	koɾesɪŋdɛr
көрінбеген	koˈrɪnbegen
көрінбейді	koˈrinbɛjdi
көрінген	koˈrɪŋɪn
көрінді	koˈrɪndɪ
көрінеді	koɾinedi
көрінетін	ko̞rinetʰin
көріністен	koɾiniˈstʰen
көріңіз	koɾiŋiz
көріп	koˈrip
көріпкелдігі	koˈripkeldɪˌgɪ
көрісеміз	koˈɾisemiz
көріскеніме	koɾiskæniˈmæ
көркемдеуші	gøɾkɘmdɘwʃɘ
көрмеген	gøɾmɛgøn
көрмегені	ˈkørmɛgæni
көрмегенсің	koːrmɪge̞nsɪŋ
көрмедім	koːrmɘdiːm
көрмеймін	gørmɛjmin
көрмейсің	koɾmejˈsiŋ
көрсем	kórsem
көрсет	koɾˈsɛt
көрсете	koɾsɛtɛ
көрсетеді	ˈkørsɘtɘdɘ
көрсетемін	koɾseˈtemʏn
көрсететінімді	ko̞ɾsetetimˈdi
көрсетіңіз	koersɛtiŋiz
көрсетіп	koerˈsetip
көрсеткен	koɾsetˈken
көрсеткім	koɾˈsetkim
көрсетпедің	koɾsetpeˈdiŋ
көрсетпейін	koɾsetpeˈjin
көрсетсек	kʏrsɘtˈsɘk
көрсетуге	koɾsɛtʊɣe
көрсін	koɾˈsɪn
көру	koru
көруге	koruɣe
көруім	koruːm
көрші	koɾʃi
көршісімен	koɾʃiˈsimen
көтер	koˈtʲer
көтерем	kotɛˈrɛm
көтерілген	koteriɫgen
көтерілістер	koteɾiɫistər
көтеріңдер	koteriŋder
көтеріп	kotɛˈɾip
көтерме	køtɛrmɛ
көтерсеңіздер	kotɘrsɘŋɯzdɘr
көтеру	kø'tɛrʊ
көшеге	koʃege
көшесінде	koʃesinde
көшірме	koʃɪrˈmɘ
крис	krɪs
криспін	krɪsˈpɪn
криссман	krɯsˈman
кристиан	krɪstʲi̞ɑn
кристианға	krɯstʲiɑŋɑ
кристі	krɪsˈtɪ
крокодилдерге	ˈkɾokodɯldɪrɣe
крон	krɔn
куәлікті	kuælikti
курста	kurˈsta
күдік	gʉˈdɯq
күдіктенсең	gydɪktʲenˈseŋ
күдікті	gydɪtʃi
күдіктіге	gydɪtʃi
күдіктімін	gydɪktɪˈmɪn
күдіктінің	gydɯtɯˈnɯ
күзетшілік	ˈkʏzɪtʃɪlɪk
күзетшілікке	ˈkʏzɪtʃɪlɪkːe
күйде	kujˈde
күйе	kujɪe
күйеді	kujɪˈdɪ
күйеуі	kujɘwɘ
күйеуім	kujewim
күйеуңіз	kujewŋiz
күйзелісті	kujzɪlɪsˈtɪ
күкіртті	kuːkɪrtːi
күлдің	gʏlˈdiŋ
күліп	gʉˈlɪp
күлкілі	gʏlgɪlɪ
күн	kʰyn
күнәңды	qynæŋdɯ
күнәсінен	qynæsinɘn
күнге	gʏŋgɛ
күнде	qynde
күндегідей	qynd̪eɣidej
күндей	qynˈdej
күнді	qynˈdi
күні	kuni
күніңдегі	kuˈnɯndeɣi
күннен	qynˈnɛn
күректер	kuˈrɛktɛr
күресіп	ku̞ɾe̞ˈsip
күрескем	kuɾesqem
күресуде	kyresuˈde
күт	kuːt
күте	gʉˈtɘ
күтем	kuˈtem
күтіп	kuˈtɪp
күтпеген	ˈkʏtpɘgɘn
күтте	kuˈtːe
күттім	kwətˈtɪm
күтуге	kutuɣe
күш	kuʃ
күшейтеміз	kuʃejteˈmiz
күші	kuʃi
күшпен	kuʃˈpɛn
күштері	kuʃteˈri
күшті	kuʃti
кэмпбел	ˈkæmpbɛl
кэмпбелге	ˈkæmpbɛlɣe
кэмпбелдің	ˈkæmpbɛlˌdɪŋ
қабатта	qɑbɑtˈtɑ
қабатты	qɑbɑtːɯ
қабыл	qaˈbəl
қабылдайсың	qɑbɯɫdɑjsɯŋ
қабылданды	qabɯɫdɑnˈdɯ
қабылдап	qaβɯɫdɑp
қабылдауға	qɑbɯɫdɑwɑ
қабылдауымыз	qɑbɯɫdɑwɯˈmɯz
қабылдауын	qɑbɯɫdɑwɯn
қабырға	qabɯrɣɑ
қабырғадан	qabɯrʁɑˈdɑn
қабырғаны	qabɯrʁaˈnɯ
қағаз	qaˈɣɑz
қағаздарға	qaˈɣɑzˈdɑrɑ
қағазы	qaˈɣɑzy
қағып	qaˈɣɯp
қажет	qaˈʒet
қажеті	qɑˈʐɪtɪ
қажытпайды	qɑʒɯtpaɯdɯ
қаз	qɑz
қаза	qaˈzɑ
қазандарды	qɑzɑndɑrdɯ
қазандыққа	qɑzɑnˈdɯqqɑ
қазандықта	qazɑndɯqtɑ
қазғанды	qaʐɣɑnˈdɯ
қазір	ˈqɑziːr
қазынаңыз	qazinaˈɯz
қай	qɑj
қайғы	qaɪˈʁɯ
қайғылы	qɑjɣɯˈɫɯ
қайғырма	qaɪɣɯrmɑ
қайда	qaɯˈdɑ
қайдағы	qajɑˈdɑɣɯ
қайдамыз	qɑjdɑmɯz
қайдан	qɑjˈdɑn
қайдасыз	qaɪdɑsɯz
қайдасың	qaɯdasɯŋ
қайрылы	qɑjrɯˈɫɯ
қайсарлығың	qaɪsɑɾɫəɣɯ
қайсы	ˈqɑjsɯ
қайт	qɑjt
қайта	qaɪˈtɑ
қайтадан	qaɪtɑdɑn
қайтайық	qɑjtɑjɯq
қайтайықшы	qaɯtaɯjɯʃ
қайталауды	qaɪtɑɫɑwˈdɯ
қайтам	ˈqɑjtɑm
қайтамыз	qaɯtɑˈmɯz
қайтара	qaɪtɑrɑ
қайтарамын	qaɪtɑɾɑmɯn
қайтарасыз	qɑjˈtɑrɑˈsɯz
қайтаратын	qaɯtaɾɑtɯn
қайтарда	qaɪtɑɾdɑ
қайтардым	qaɪtɑɾdɯm
қайтармақ	qaɪtɑɾˈmɑq
қайтару	ˈqɑjtɑɾʊ
қайтаруға	qaɪtɑɾuʁɑ
қайтарыңдар	qɑjɑtəɾɯŋdɑɾ
қайтарыңыз	qajatəɾəˈjɯz
қайтарып	qɑjɑtɑˈɾɯp
қайтататын	qɑjtɑtɑjˈtɯn
қайтатын	qaɪtɑːtɯn
қайтер	qaɪtɘr
қайтіп	qɑjtʏp
қайтқым	qaɪtqɯm
қайту	ˈqɑjtʉ
қайтуды	qaɪtʉdɯ
қайтуым	qaɪtʉm
қайтыңыз	qaɪtɯŋɯz
қайтып	qɑjtɯp
қайырлы	qɑjɯɾˈɫɯ
қақиып	qaqijp
қақпаға	qaqpaʁa
қақпашадан	qaqpaʃaˈdɑn
қал	qɑl
қала	qɑˈlɑ
қалаға	qɑlɑɣɑ
қалады	qɑlɑdɯ
қалай	qɑlɑj
қалайды	qɑlɑjˈdɯ
қалаймыз	qalaɯmɯz
қалайсыз	qɑlɑjsɯz
қалайсыздар	qɑlɑjsɯzdɑr
қалайсың	qɑlɑjsɯŋ
қалам	qɑˈlɑm
қаламаймын	qɑlɑmɑjmɯn
қаламыз	qɑlɑˈmɯz
қалап	qaˈlap
қалар	qaˈɫɑr
қаларлық	qaɫɯɫɯq
қаласыз	qɑlɑˈsɯz
қаласыздар	qɑlɑsɯzˈdɑr
қаласың	qɑlɑsɯŋ
қалау	qɑˈɫɑw
қалауың	qalawɯŋ
қалған	qaɫˈɣɑn
қалғандары	qaɫɣɑnˈdɑrɯ
қалғаны	qaɫɣɑnɯ
қалғанын	qaɫɣaˈnɯn
қалғаның	qaɫɣaˈnɯŋ
қалғысы	qaɫɣɯsɯ
қалдары	qaɫdɑɾɯ
қалды	qaɫdɯ
қалдым	gɑɫˈdɯm
қалдырамын	qaɫdɯɾɑˈmɯn
қалдырған	gɑɫdɯɾˈʁɑn
қалдырдым	qɑɫdɯɾdɯm
қалдырдың	qɑɫdɯɾɯŋ
қалдырмайды	ˈqɑɫdɯrmɑjˈdɯ
қалдырсам	qɑɫdɯrsɑm
қалдырып	qɑɫdɯɾɯp
қалма	qɑlˈmɑ
қалмайды	qɑlˈmɑjdɯ
қалмайсыз	qɑlˈmɑjsɯz
қалмайын	qɑlˈmɑjɯn
қалмаш	qɑlˈmɑʃ
қалпын	qaɫpɯn
қалса	qɑlˈsɑ
қалсаңшы	qɑlˈsɑŋʃɯ
қалсын	qɑlˈsɯn
қалу	qaˈɫu
қалуға	qaɫuʁɑ
қалуың	qaloʊŋ
қалың	qaˈlɯŋ
қалып	qaˈlɯp
қалыптарыңа	qaɫɯpˈtɑɾɯˈŋɑ
қалыпты	qaɫɯpˈtɯ
қам	qɑm
қамап	qaˈmɑp
қамтып	qɑmˈtɯp
қамын	qɑˈmɯn
қан	qɑn
қана	qɑnɑ
қанға	qɑŋɑ
қандай	qɑnˈdɑj
қанды	qɑnˈdɯ
қане	qɑnɛ
қанмен	qɑnˈmen
қанша	qɑnʃɑ
қаншалықты	qɑnʃɑɫɯqtɯ
қаншауы	qɑnʃɑwɯ
қаны	qɑnɯ
қар	qɑr
қара	qɑrɑ
қарағаннан	qɑrɑʁɑnɑn
қарағаны	qɑrɑˈʁɑnɯ
қарағаным	qɑrɑʁɑnɯm
қарай	qɑrɑj
қарайлап	qɑrɑjˈlɑp
қараймын	qɑrɑjˈmɯn
қарайсың	qɑrɑjsɯŋ
қарайтын	qɑrɑjtɯn
қарайын	qɑrɑjɯn
қаралай	qɑrɑˈlɑj
қарама	qɑrɑmɑ
қараңғы	qɑrɑŋɣɯ
қараңғыдан	qɑrɑŋɣɯdɑn
қараңғылықтан	qɑrɑŋɣɯɫɯtɑn
қараңдар	qɑrɑŋdɑr
қараңқыға	qɑrɑŋqɯɣɑ
қараңқының	qɑrɑŋqɯˈnɯŋ
қараңыз	qɑrɑŋɯz
қарап	qɑrɑp
қарапайым	qɑrɑpɑjɯm
қарармын	qɑrɑɾmɯn
қарас	qɑrɑs
қарашы	qɑrɑʃɯ
қарғай	qɑrʁɑj
қарған	qɑrˈʁɑn
қарда	qɑrˈdɑ
қаржы	qɑrˈʐɯ
қаржылайды	qɑrʒɯɫɑjˈdɯ
қаржысын	qɑrˈʐɯsɯn
қарсы	qɑrsɯ
қарсымын	qɑrsɯˈmɯn
қаруымды	qaɾujɯmˈdɯ
қарым	qɑˈrɯm
қарындасым	qɑrɯndɑsɯm
қарындасыңды	qɑrɯndɑsɯŋdɯ
қарындасыңызды	qɑrɯndɑsɯŋɯzˈdɯ
қасында	qɑsɯˈdɑ
қасыңда	qɑˈsɯŋdɑ
қатар	qaˈtɑr
қатардан	qaˈtɑɾdɑn
қатарды	qaˈtɑɾdɯ
қатарлы	qɑtɑɾˈɫɯ
қатарынан	qɑtɑrɯnɑn
қате	ˈqɑte
қатем	qaˈtem
қатты	qɑtːɯ
қаттылығы	ˈqɑtːɯɫɯ
қатынас	ˈqɑtɯnɑs
қатынаста	qɑtənɑstɑ
қатынасты	ˈqɑtənɑstɯ
қатынасым	qɑtənɑsɯm
қатып	qɑtɯp
қатырады	ˈqɑtɯrɑdɯ
қатырмайды	qɑtɯrmɑjˈdɯ
қатысамыз	qɑtɯsɑmɯz
қатысшы	qɑtɯʃɯ
қатысы	qɑtɯsɯ
қатысымыз	qɑtɯsɯmɯz
қауіп	qɑwɪp
қауіпсіздігім	qɑwɪpˈsɪzˈdɪɣɪm
қауіпсіздігіме	qɑwɯpsɯzdɯɣɯmɘ
қауіпті	qɑwɪptɪ
қаупі	qɑwˈpɪ
қаша	qɑˈʃɑ
қашан	qaʃɑn
қашаннан	qaʃɑnˈnɑn
қашқалақтаса	qaʃqɑlɑqˈtɑsɑ
қашқындарына	qaʃqɯndɑɾɯnɑ
қашпты	qaʃptɯ
қаштық	qaʃˈtɯq
қашып	qaʃɯp
қәне	qæˈnæ
қиқулаған	qiqwɑˈɫɑɣɑn
қимайсыз	qiˈmɑjsɯz
қимылда	qɯmɯɫdɑ
қимылдай	qimɯɫdaɯ
қимылдама	qimɯɫdama
қиналып	qɪnɑˈlɯp
қиратты	qiˈrɑtː
қиын	qiˈjn
қиынддап	qiˈjɯndɑp
қиындық	qiˈjɯnqɯq
қиыншылық	qiˈjɯnʃɯɫɯq
қиынырақ	qiːnɯraq
қию	qiˈju
қоғамдық	qoɣɑmˈdɯq
қоғамның	qɔɣɑmnɯŋ
қожайынына	qɔʒɑjɯnɯnɑ
қозғадық	qozɣɑɯdɯq
қозғалма	qozɣɑlmɑ
қозғалу	qozɣɑˈɫu
қой	qɔj
қойған	qojˈɣɑn
қойғандай	qojɣɑndɑj
қойғанын	qojɣaˈnɯn
қойғаның	qojɣɑnɯŋ
қойды	qojdɯ
қойдық	qojdɯq
қойдым	qojdɯm
қойдың	qojˈdɯŋ
қоймас	qojmɑs
қоймасы	qojmɑsɯ
қойса	qojsɑ
қойсаңыз	qojsɑŋɯz
қойсын	qojsɯn
қойшы	qojʃɯ
қойыңдар	qojɯŋdɑr
қойыңыз	qojɯŋɯz
қойыңыздар	qojɯŋɯzdɑr
қойыпты	qojɯptɯ
қол	qɔl
қолға	qɑɫɣɑ
қолда	ˈqɔɫdɑ
қолдаймыз	ˈqɔɫdajˈmɯz
қолдайтын	qɔɫdɑjˈtɯn
қолдана	qɔldɑnɑ
қолданам	qɔldɑnɑm
қолданбағанымыз	ˈqɑɫdɑnbɑɣɑˈnɯmɯz
қолданбақпын	ˈqɔɫdɑnβɑqpɯn
қолданбаңдар	ˈqɑɫdɑnβɑŋdɑr
қолдануға	ˈqɔɫd̪ɑnʊʁɑ
қолданып	ˈqɔɫdɑnɯp
қолдары	qɑɫdɑɾɯ
қолдарымен	qɔɫdɑɾɯmɛn
қолдарын	qɔldɑrɯn
қолдарыңды	ˈqɔɫdɯɾɯŋdɯ
қолдауға	qɔɫdɑwɑ
қолды	ˈqɔɫdɯ
қолмен	qɑlˈmen
қолтығы	qoltɯɣɯ
қолы	qɑˈlʊ
қолым	qɑˈlɯm
қолымнан	qɑlɯmˈnɑn
қолымыз	qɑˈlɯmɯz
қолын	qɑˈlɯn
қолынан	qɑlɯˈnɑn
қолында	qɑlɯnˈdɑ
қолыңды	qɑˈɫoŋdɯ
қолыңмен	qɑɫəŋˈmɛn
қолыңнан	qɑˈɫoŋnɑn
қолыңыз	qɑˈlɯŋɯz
қолыңызбен	qɑɫoɯŋɯzˈbɪn
қолыңызжан	qɑɫoɯ̞ŋɯʒɑn
қона	qɔnɑ
қонағымыз	qɔnɑɣɯmɯz
қонағыңызбын	qɔnɑɣɯŋɯzbɯn
қонақ	qɔnɑq
қонаққа	qɔnɑqˈqɑ
қонақтар	qɔnɑqˈtɑr
қонақтарға	qɔnɑqˈtɑrɑ
қонамыз	qɔnɑˈmɯz
қоныпты	qɔnɯptɯ
қорапта	qɔrɑptɑ
қорғанысың	qorɣanɯsɯŋ
қорғауың	qorɣawˈɯŋ
қоректенеміз	qorekˈtenemiz
қоректеніп	qɔɾɛktæˈnɪp
қоректену	qɔrɛktɛnʉ
қорқасыз	qorqɑsɯz
қорққанымнан	qorqɑnɯmˈnɑn
қорқпашы	qɔɾqpɑʃɯ
қорқыныш	qorqəˈnɯʃ
қорқынышты	qɔɾqənɯʃtɯ
қорқып	qorqɯp
қорыққандығыңыз	qɔrɯqqɑndɯɣɯŋɯz
қорықпа	qɔɾɯqˈpɑ
қорықпайсың	qɔrɯqpɑjsɯŋ
қорын	qɔˈrɯn
қоса	qoˈsɑ
қосады	qɔsɑdɯ
қосамын	qɔsɑmɯn
қосылам	qosɯləm
қосыларсың	qoˈsɯɫaɾsɯŋ
қосыласыз	qɔsɯlɑsɯz
қосылып	qosɯɫɯp
қосып	qɔsɯp
қош	qoʃ
қошемет	qoʃemet
қоштасарда	qoʃtɑsɑrdɑ
қоштасуға	qoʃtɑsuʁɑ
қою	qoˈjo
қоюыңа	qojoˈjə
қояды	qojɑdɯ
қояйын	qojajɯn
қоям	qoˈjæm
қояншық	qojaɲʃɯq
қуанған	qwanˈʁɑn
қуаныштымын	qʰwɑːnɯʃtɯmɯn
қуаныштысыңдар	qʰʊɑnɯʃtɯsɯŋdɑr
қуат	qʊɑt
қуаттап	qʊɑtːɑp
қуатты	kwɑtːɯ
қума	qʊmɑ
қусырып	qʊsɯˈrɯp
қуып	quɯp
қуырдақ	qujɯɾˈdɑq
қуырылған	qʊwɾɯɫɣɑn
қуырып	qʊwɾɯp
құбыжық	quβɯʒɯq
құбыжықтар	quβɯʒɯqtɑr
құбылай	qubɯˈlɑj
құбылтек	qubɯltɛk
құдай	quˈdɑj
құдайға	qudajɑ
құдайдан	qudɑjˈdɑn
құдайды	quˈdɑjˈdɯ
құдайдың	qʊdɑjˈdɯŋ
құдайлар	qʊdɑjˈlɑr
құдайым	qudajɯm
құйып	qujɯp
құқығым	qʊqɯˈɣɯm
құқығын	qʊqɯˈʁɯŋ
құқығыңды	qoqəɣəŋˈdɯ
құқымыз	qʊqɯmɯz
құлақ	quɫɑq
құлама	quɫɑmɑ
құлап	quɫɑp
құлаппын	qulɑpɯn
құлатып	qʊlɑtɯp
құлдырайды	ˈqʊɫdɯɾajˈdɯ
құлмен	ˈqʊɫmen
құмаршылығымыз	qumɑrʃɯɫɯˈmɯz
құмаршылық	qumɑrʃɯˈɫɯq
құп	qup
құпия	qupiˈja
құр	qʊr
құрал	quˈrɑɫ
құралдар	quɾɑɫdɑr
құралдарды	quːrɑɫdɑɹdɯ
құралдарында	quːrɑldɯrɯndɑ
құрбаны	quɾbɑnɯ
құрбыларыңды	qʊrbɯlaɾɯŋdɯ
құрмағанда	qʊrmɑɣɑnˈdɑ
құрмаса	qurmɑsɑ
құрмет	qʊrmɘt
құрметті	qʊrmɘtːi
құрметтілер	qʊrmɘtːɘlɘr
құрт	qʊrt
құрттарды	qʊrt̪t̪ɑrdɯ
құртыңдар	qʊrtɯŋdɑr
құры	quˈrɯ
құрығып	qʊɾɯjɯp
құрылыстар	quɾəlɯsˈtɑr
құрып	quˈrɯp
құрыпталды	qʊrɯptɑɫdɯ
құс	qus
құстар	qʊsˈtɑr
құтқарам	qʊtqɑrɑm
құтқарамын	qʊtqɑrɑˈmɯn
құтқаратын	qʊtqɑrɑtɯn
құтқарған	qʊtqɑrˈʁɑn
құтқару	qʊtqɑˈruː
құтқаруды	qʊtqɑruˈdɯ
құтқаруыңа	qʊtqɑrujə
құтқаруыңыз	qʊtqɑrujɯŋɯz
құтылғаныма	qʊtɯɬɑnɯmɑ
құтылғанына	qʊtɯɬɑnɯnɑ
құтылудың	qʊtɯɫoːðɯŋ
құтылуым	qʊtɯɫʊm
қыз	qɯz
қызға	qɯzˈʁɑ
қызғанады	qɯzɣɑnɑdɯ
қыздарды	qɯzdɑɾdɯ
қыздардың	qɯzdɑrɯŋ
қызды	qɯzdɯ
қыздың	qɯzˈdɯŋ
қызмет	qɯzmɘt
қызметі	qɯzmɘti
қызметін	qɯzmɘˈtin
қызу	qɯzʊ
қызумен	qɯzuˈmen
қызығатын	qɯzɯɣɑtɯn
қызық	qɯzɯq
қызықты	qɯzɯʃtɯ
қызықтысы	qɯzɯqɯtɯsɯ
қызықтысыз	qɯzɯqɯtɯsɯz
қылғанып	qɯɫʁɑnɯp
қылды	gɯɫdɯ
қылмыс	qɯɫˈmɯs
қылмыскерлерге	qɯɫmɯskɘɫɘɾge
қылмыскерлерді	qɯlmɯskɘrdɯ
қылмысқа	qɯɫmɯsqɑ
қылмыспен	qɯɫmɯsˈpɘn
қылмысын	qɯɫmɯsɯn
қылу	qɯɫʊ
қылып	qɯɫɯp
қымбат	qɯmˈbɑt
қымбатты	qɯmβɑtːɯ
қымбыт	qɯmˈbɯt
қынжылататыны	qɯnʒɯɫɑtɑtɯnɯ
қынжылып	qɯnʒɯɫɯp
қырагерсің	qɯrɑɣɘɾsɘŋ
қырларың	qɯrɯɫɯɾɯŋ
қырық	qɯˈrɯq
қырылмайды	qɯɾɯɫmɑjˈdɯ
қырып	qɯˈrɯp
қысымы	qɯsɯmɯ
қысып	qɯˈsɯp
қыша	qɯˈʃɑ
лабораторияда	ɫɑbɒrɑɾɪjɑdɑ
лабораториясы	ɫɑbɒrɑtɔrʲɪjɑsɯ
лайық	ɫɑjɯq
лайықты	ɫɑjɯqˈtɯ
лайықтысын	laɯjɯqstɯsɯn
лақтырып	ɫɑqtɯˈɾɯp
лаңи	ɫɑˈŋɪ
лас	ɫɑs
ласпын	ɫɑsˈpɯn
лауазымның	ɫɑwɑzɯmˈnɯŋ
лезде	leʐdɘ
ли	ɫi
либерализмге	ɫiβerɑlɪzmɣe
ливияға	ɫɯβiˈjɑɣɑ
ливияда	ɫɯβʲiˈjɑdɑ
лизосомды	ɫɪzɔsɔmdɯ
лизосомын	ɫɯzɯsɑmɯn
линцезияңызды	lɪntsʲɪzʲɪˈjɑŋɯzdɯ
липидті	ɫipɪtˈtɪ
лифт	lif
лифтпен	ɫift̪pen
лицензияны	ɫitsɛnzʲiˈjɑnɯ
лібә	ɫɪbæ
лондонға	ɫɔndɔŋɑ
лютер	ɫʏtɛr
ма	ma
маған	maɣan
мағынасын	maɣɯnasɯn
мадақтау	madaqˈtɑw
мазақ	maˈzɑq
мазалайтын	mazɑɫɑjˈtɯn
мазам	mazam
маймылға	majmɯɫʁɑ
маймылдар	majmɯɫdɑr
маймылдарға	majmɯɫdɑrʁɑ
маймылы	majmɯɫɯ
макерер	makeˈrɪr
макиндай	makɪndɑj
маккензи	ˈmɑkʲɪnzi
маккензиді	maˈkʲɛnzɪdɪ
макларен	maglɑˈrɛn
мақала	maqala
мақаланы	maqalani
мақсат	maqsɑt
мақсатымызға	maqsɑtɯmɯzɣɑ
мақтан	maʁˈtɑn
малдер	maɫdɪr
малдерге	maɫdɪrge
малдерді	maɫdɪrˈdi
малдермен	maɫdɪrˈmɪn
малдерсіз	maɫdɘrˈsɯz
малынған	maɯɫɯŋ
малып	maɫɯp
маляму	malamu
мама	mɑmɑ
мамандар	maːmɑnˈdɑr
маңда	maɲdɑ
маңызды	maŋɯzdɯ
мария	marijɑ
мас	maːs
масанга	masanɣa
масанганы	masaŋgaˈnɯ
масанганың	masaŋɣaˈnɯŋ
маскүнем	maʃkʉˈnæm
массачусетс	ˌmæsəˈtʃuːsɪts
материаландырған	mateɾialaːndɯɾʁɑn
материалдар	mateɾijɑɫˈdɑr
мау	maʊ
мауға	maʊɣə
махаббат	maχɑbɑt
махаббаттың	maχɑββɑtˈtɯŋ
машина	maʃɯˈnɑ
машинаға	maʃɯnaʁə
машинадан	maʃɯnaˈdɑn
машиналар	maʃɯnɑˈlɑr
машиналарыңды	maʃɯnɑɯɾɯŋdɯ
машинам	maʃɯˈnɑm
машинаны	maʃɯnaˈnɯ
машинаның	maʃɯnɑˈnɯŋ
машинасы	maʃɯnasɯ
мәжбүр	maʒˈbyr
мән	men
мәнісінде	mänɪsɪndɛ
мәртебелі	maɾtebeˈli
мәселе	ˈmæsælʲe
мәселеге	ˈmæsɛleɣæ
мәселесімен	ˈmæsælesimæn
мәссаған	ˈmæsːaɣɑn
ме	me
медецина	medetsɪnə
медииналық	mediːnalɯq
медиқалық	medʑɑˈɫɯq
медицина	medʲɪˈtsɯnə
медициналық	medʲitsɪnɑˈɫɯq
меірбике	miɪrbɪkʲe
мейірбике	majɪrbɪkɪ
мейірімді	majɪˈrɪmdi
мейман	majˈman
мейрімді	majˈrɪmˌdɪ
мектебің	ˈmɛktɘbiŋ
мектеп	ˈmɛktɛp
мектепке	ˈmɛktɛpkɛ
мектептен	ˈmɛktɛptɛn
мектептер	ˈmɛktɛptɛr
мектептеріңіз	ˈmɛktɛptæɾɪŋɪz
мектептің	ˈmɛktɛptɪŋ
мемелекеті	ˈmɛmɛlɪkʲɪtɪ
мемориал	ˌmʲɪmɔrʲɪˈɑɫ
мен	men
менде	mende
менен	menen
мені	menʲi
менікіндей	menikɪndɛj
менімен	menimɪn
менің	menʲiŋ
меніңше	meniŋʃe
менмін	menˈmin
меннен	menen
менсіз	menˈsɪz
менсінбеймін	mensɪnbejˈmɪn
мерит	merit
ми	mi
мидағы	miɑˈɣɯ
мидан	midɑn
мидың	miˈdɯŋ
миенга	miɪŋɑ
миллиондаған	milijɔndaˈɣɑn
министір	miniˈstɪr
министірді	miniˈstɪrdɪ
министірі	miniˈstiɾi
министірім	miniˈstiɾim
министірімін	miniˈstirimɪn
министірлік	ministɪrˈlɪk
минуспен	miˈnuspɛn
минут	miˈnut
минуттай	miˈnʊttɑj
міндетті	miːndɪtːi
міне	mine
мінедіңіз	mineˈdiŋiz
мінейтін	minejˈtɪn
мінекей	minekej
мінеки	mineki
могамбо	moɣɑmˈbo
могамбодағы	ˈmoɣɑmbodɑˈʁɯ
мойнын	mojnɯn
мойнына	moɯnɯnɑ
мойнынан	moɯnɯnɑn
мойын	mojɯn
мойында	mojɯnda
молаларды	ˈmɔɫɑɫɑɹdɯ
моника	ˈmɔnɪkə
мониканы	ˈmɔnɪkɑnɪ
мөрге	ˈmørgɛ
мөрде	ˈmørdɛ
мөрді	ˈmɵrdi
мөрі	ˈmɵɾi
мөрімді	ˈmøɾimdi
мугишаның	muɣɪʃɑnɯŋ
мулагоға	muɫɑɣoʁɑ
мулагода	mulaɣoda
мүгедектер	ˈmʏɣɪdɪkˌtɪr
мүлде	ɘlˈdʲe
мүлдем	ˈmyldæm
мүмкім	ˈmymkɪm
мүмкін	ˈmymkɪn
мүмкіндігі	ˈmymqɪndɪʁɪ
мүмкіндігінше	ˈmymqɪndɪɣeʃe
мүмкіндігің	ˈmymkɪndɪʁɪŋ
мүмкіндік	ˈmymqɪnˌdɪk
мүмкіндіктерге	ˈmymqɪndɪkˌtɪrʁe
мүмкіндікті	ˈmymkɪndɪktʰi
мүшелерін	ˈmʏʃelɪrɪn
мүшесі	ˈmʏʃɪsɪ
мүшесін	muʃesin
мұғалімді	muɣɑˈlimdi
мұз	muz
мұздағы	muːzˈdɑɣɯ
мұмкін	ˈmumqɪn
мұнда	ˈmʊndɑ
мұндағы	muˈnɑɣɯ
мұндай	ˈmʊndɑj
мұны	muˈnɯ
мұның	muˈnɯŋ
мұрның	ˈmʊrnɯŋ
мұрныңды	ˈmʊrnɯŋdɯ
мұсылмандар	musɯɫmɑndɑr
мұхит	ˈmʊxɪt
мықтап	ˈmɯqtɑp
мықты	ˈmɯqtɯ
мына	ˈmɯnɑ
мыналар	ˈmɯnɑɫɑr
мыналарды	ˈmɯnɑɫɑɾdɯ
мынаны	ˈmɯnɑnɯ
мынау	ˈmɯnɑw
мында	ɯmˈdɑ
мындағы	ˈmɯndɑɣɯ
мындамыз	ɯmɯndɯmɯz
мыннан	mɯnˈnɑn
мың	ˈmɯŋ
мыңдаған	ˈmɯŋdɑɣɑn
мырза	ˈmɯrzə
мырзаға	ˈmɯrzɑɣɑ
мырзалар	ɯɾzɑɫɑɾ
мырзам	ɯɾˈzɑm
мырзамен	ɯɾzɑˈmɪn
мырзамыз	ˈmɯrzɑmɯz
мыстандар	ˈmɯstɑndɑr
мысыққа	ˈmɯsɯqˈqɑ
нағыз	naɣɯz
назар	naˈzar
нақты	naχɯ
наразышылық	ˌnɑrɑzɯʃɯˈɫɯq
нау	nɑu
нашар	naʃɑr
нашарлағанша	naʃɑɾɫɑʁaʃ
нашарлап	naʃɑɾˈlɑp
нашарлатқан	naʃɑɫɑtqɑn
нәрестесі	næɾestɛsɪ
нәрсе	nerˈsɛ
нәрсеге	nersege
нәрселерді	nerseɫerdɪ
нәрселердің	nersɪlɪˈɾɪŋ
нәрсені	nersɪ
нәрсеңді	nerˈsɘŋdɘ
нәрсесі	nerˈsɛsɪ
нәсіпқұмарларға	nasɪpqʊmɑɫɑrɑ
нәскимен	ˈnæskɪˌmen
нәтижелерді	ˈnætiʒelɪrˈdi
нәтижелері	næˈtʑeʒæˈlæɾi
нәтижесін	næˈtʲiʒesɪn
нда	ndɑ
не	ne
неге	nege
негізі	nɛɣɪˈzɪ
негізін	neɣiˈzɪn
негізінде	negiˈzində
неғылған	neɣɯɫˈɣɑn
неғып	neɣɯp
недеген	nʲedʲegæn
неден	nedɪn
неліктен	nɛlɪktɛn
немен	nʲemʲen
немене	nemene
немерем	nemɪrɪm
немерең	nemereŋ
немесе	nʲemʲeˈsʲe
немістер	nemɪstɪr
нені	neni
ненің	neˈniŋ
неңе	neɣe
несі	nɪˈsɪ
неткен	neˈtken
неше	neʃe
нешеде	neʃede
нигихаями	niɣɯxɑjɯmɯ
ник	nik
ники	niˈkɪ
никовска	niˈkɑwskə
никола	nikɔˈɫɑ
николас	nikɑˈɫɑs
николасым	nikoɫɑsɯm
ноколас	ˈnɔkɔlɑs
нора	ˈnɔrɑ
нура	nuɾɑ
нурамын	nuɾamən
нуси	nuˈsi
о	ɔ
обалына	ɔbɑlɯnɑ
обот	ɔˈbot
оботқа	ɔbɔtqɑ
оботтың	ɔβotˈtɯŋ
оған	ɔˈɣɑn
одан	ɔˈdɑn
оданда	ɔdɑndɑ
оенжисіңдер	ɔjɪ́nʐɪsɪ́ŋdɪr
ой	ɔj
ойла	ɔjˈlɑ
ойлағам	ɔjlɑɣɑm
ойлағаның	ɔjlɑɣɑnɯŋ
ойладым	ɔjɑɫɯm
ойладыңыз	ɔjɯɫɯˈdɯŋɯz
ойлай	ɔjˈlɑj
ойлайды	ɔjlɑjdɯ
ойлаймыз	ɔjlɑjmɯz
ойлаймын	ɔjlajmɯn
ойлайсыз	ɔjlɑjsɯz
ойлайсың	ɔjlɑjsɯŋ
ойлайтын	ɔjlɑjtɯn
ойламаған	ɔjlɑmɑʁ
ойламайды	ɔjlɑmajˈdɯ
ойландым	ɔjlɑndɯm
ойландың	ɔjlɑndɯŋ
ойландырды	ojlɑndɯrdɯ
ойлап	ɔjˈlɑp
ойларың	ɔjɯɫɯɾɯŋ
ойлауың	ɔjlɑwɯŋ
ойна	ɔjˈnɑ
ойнағып	ɔjnɑɣɯp
ойнаймын	ɔjnɑjmɯn
ойым	ɔjɯm
ойымды	ojɯmˈdɯ
ойын	ɔjɯn
ойынан	ojɯnɑn
ойыншық	ɔjɯnʃɯq
ойыншықтарды	ojɯnʃɯqtaɾdɯ
ойыныңызды	ɔjɯnɯjɯzdɯ
ойыңа	ɔjɯˈŋɑ
ойыңда	ɔjɯŋdɑ
ойыңды	ɔjɯŋdɯ
ойыңыз	ɔjɯŋɯz
оқ	ɔq
оқасы	ɔqɑsɯ
оқиға	ɔqɯɣɑ
оқиғалар	ɔqɯɣɑɫɑɾ
оқиғаларға	ɔqɯɣɑɫɑɾɑ
оқиғаларды	ɔqɯɣɑɫɯɾdɯ
оқиғалармен	ɔqɯɣɑɫɯmɛn
оқисың	ɔqɪsɯŋ
оқисыңдар	ɔqɯsɯŋdɑr
оқудан	ɔqʊdɑn
оқушылар	ɔqʊʃɯɫɑɾ
оқушысы	ɔqʊʃɯsɯ
оқыдым	ɔqɯˈdɯm
оқыдың	ɔqɯˈdɯŋ
оқылған	ɔqɯɫɣɑn
оқып	ɔqɯp
ол	ɔɫ
олай	ɔˈlɑj
олар	ɑɫɑr
оларға	ɔɫɑrɣɑ
оларда	ɔɫɑɾdɑ
олардан	ɑɫɑɾˈdɑn
оларды	ɔɫɑɾdɯ
олардың	ɔɫɑɾˈdɯŋ
он	on
онда	ɔnˈdɑ
ондаған	ɔndɑɣɑn
ондай	onˈdɑj
онсыз	onˈsɯz
онша	onʃɑ
оны	ɔnɯ
оныда	ɔnɯdɑ
онымен	onɯˈmen
оның	ɔnɯɴ
оңай	ɔŋɑj
оңбаған	ɔŋbɑɣɑn
оңбайсың	ɔŋbɑjsɯŋ
оңға	ɔŋɣɑ
оңтүстік	ɔŋtʏsˈtɪk
ооған	ɔːˈɣɑn
операция	ɔpʲɪrɑˈtsɪjə
оппозицияны	ɔpɔsɪzʲɪˈonɯ
опреация	ɔprʲɛɑtsɪjɑ
опреацияны	ɔprʲɛɑtsʲɪɑnɯ
орал	ɔˈɾɑɫ
ораламын	ɔɾɑɫɑmɯn
оралма	ɔrɑlmɑ
оралмаған	ɔrɑlmɑˈʁɑn
оралуын	ɔrɑɫʊɯn
орап	ɔˈrɑp
ордеріміз	ɔrdɪˈrɪmɪz
орнатуға	ɔrnɑtʊʁɑ
орнатылған	ɔrnɑtɯɫɣɑn
орны	ɔrnɯ
орнықты	ɔrnɯqtɯ
орныма	ɔrnɯmɑ
орнын	ɔrnɯn
орнына	ɔrnɯnɑ
орнында	ɔrnɯnˈdɑ
орта	ɔrtɑ
ортада	ɔrtɑdɑ
орталығы	ɔrtɑˈɫɯ
орын	ɔˈrɯn
орынға	ɔrɯŋɑ
орында	ɔrɯnˈdɑ
орындалатын	ɔrɯndɑɫɯtɯn
орындалса	ɔrɯndɑɫsɑ
орындаңдар	ɔrɯnɑɯŋdɑr
орындап	ɔrɯndɑp
орындасаңдар	ɔɾɯndɑsɑŋdɑɾ
орыс	ɔrɯs
осы	ɔsɯ
осыған	ɔsɯˈʁɑn
осыдан	ɑsɯˈdɑn
осылай	ɔsɯˈlɑj
осылар	ɔsɯˈlɑr
осымен	ɔsɯˈmɛn
осында	ɔsɯnˈdɑ
осындағы	ɔsɯnɑˈɣɯ
осындай	ɔsɯnˈdɑj
осындайда	ɔsɯndɑjˈdɑ
осындамын	ɔsɯnɑmɯn
осындасың	ɔsɯndɑsɯŋ
осынша	ɔsɯnʃɑ
осыны	ɒsɯˈnɯ
от	ot
отбасынанмын	otbɑsɯnɑmɯn
отқа	otqɑ
отыр	ɔtɯr
отырады	ɔtɯrɑdɯ
отырған	otɯrˈʁɑn
отырғаным	ɔtɯɾʁɑnɯm
отырды	otɯrdɯ
отырдың	ɔtɯɾdɯŋ
отырмаймын	ɔtɯrmɑjmɯn
отырмасаң	ɔtɯrmɑsɑŋ
отырмын	ɔtɯɾmɯn
отырсаң	otɯrˈsɑŋ
отырсыз	otɯrˈsɯz
отырсың	ɔtɯrˈsɯŋ
отыру	otɯˈru
отыруымыз	ɔtɯɾʊymɯz
отыруыңа	otɯrujˈŋa
отырыңдар	ɔtɯɾəŋdɑɾ
отырыңыз	ɔtɯˈrɯŋɯz
отырыңызшы	otɯrɯŋɯʃ
отырып	otɯˈrɯp
офисті	ɔfʲɪsˈtʲɪ
офисын	ɔfisɯn
оын	ɔɯn
оян	ɔjɑn
ояндың	ɔjɑndɯŋ
оятқанды	ojɑtqɑnˈdɯ
ояттырады	ojɑtɯrɑdɯ
өз	øs
өзгелердің	øzgelæriŋ
өзгеріс	øsɣeˈɾɪs
өзгермегенге	øzɣɘrmɘɣɘŋɣɘ
өзгерте	øzɣertɛ
өзгертесің	øzɣertɪˈsiŋ
өзгертсем	øzgɘrtˈsɘm
өзгерттің	øzgɘrtːiŋ
өзгеше	øsgeʃe
өздері	øzdɪri
өздерін	øsdæˈrɪn
өздеріне	øsdæriˈnæ
өздерінің	øsdæriˈnʏ
өздеріңнің	øsdæriŋˈnɪ
өзен	øˈzɪn
өзенге	øˈzʲeŋe
өзеннің	øzenˈnɪŋ
өзі	øˈzi
өзім	øˈzɪm
өзімде	øziːmdɘ
өзімді	øzɪmˈdɪ
өзімен	øziˈmen
өзіміз	øziˈmɪz
өзімізбен	øziˈmɘzβɘn
өзімізді	øziˈmɪzdi
өзіміздің	øziˈmɪzdiŋ
өзімнің	øzʏmˈnʏŋ
өзімшіл	øziʃɯl
өзін	øˈzʏn
өзіне	øziˈnæ
өзінен	øzɪnɪn
өзінің	øzʏˈnʏŋ
өзің	øziŋ
өзіңді	øziŋdɪ
өзіңіз	øziŋiz
өзіңізбен	øzʏŋɨzˈbɪn
өзіңізге	øziŋizge
өзіңмен	øziŋmen
өзіңнен	øziŋnæn
өзсенімін	øssɪnimɪn
өкілі	økiˈli
өкінішті	økɪnɪʃtɪ
өкпе	økˈpɘ
өкпеқұртын	økpɘqʊrtɯn
өкпенің	økpɪˈnʲɪŋ
өлген	ɘlˈgʲɘn
өлді	ɘɫˈdɘ
өледі	øledi
өлең	øˈleŋ
өлетін	øletin
өлетінімді	øletimdɪ
өлі	øli
өліктерді	øligtɘɾˈdi
өлім	øˈlim
өлімге	ɵlɪmge
өлімін	ɵliˈmɪn
өлімің	øliˈmiŋ
өлімнен	ɵˈlimnʲen
өліп	ɵˈlɪp
өлмеймін	olmejmin
өлмейсің	ɘlmejˈsiŋ
өлтір	ɘltɘr
өлтірген	ɘltɪrgɘn
өлтіргілері	ɘltɘrɣɘlɘri
өлтіргілерің	ɘltɘrɣɘlɘrʲiŋ
өлтіргісі	ɘltɘrɣɘsɘ
өлтірді	ɘltɘrdɘ
өлтіре	ɘltɘrɘ
өлтіреді	ɘltiˈrɘdɘ
өлтірмекпісің	ɘltɘrmɘkpɘsiŋ
өлтірмексіңбе	ɘltɘrmɘkʃɘŋbɘ
өлтірмекші	ɘltɘrmɘkʃɘ
өлтірулер	ɘltɘrʉlɘr
өлу	ɵˈɫʊ
өлуден	ɵlʊˈd̪en
өмір	ømɪr
өмірге	ømɪrɣe
өмірі	ømiˈri
өмірім	ømiriːm
өмірімдегі	ømiriːmdegi
өмірімді	ømɪrimˈdi
өміріміздің	ømiɾimɪzˈdiŋ
өмірімнің	ømiriːmˈnɪŋ
өмірін	ømɪˈrɪn
өміріңіз	ømiˈrɪŋɪz
өміріңнің	ømiˈrɪŋnɪŋ
өмірміз	ømɪrˈmɪz
өндірілетін	øndiriletin
өңдегенін	øŋdegeniː
өңдемедім	øŋdemedim
өңсіз	øŋˈsɯz
өрескел	øɾeskɪl
өрт	ɵrt
өсекті	øˈsɛkti
өсиеті	øsijeti
өте	øte
өтеді	øtedi
өтетін	øteˈtin
өтінеді	øtinedi
өтінем	øˈtinæm
өтінемін	øtinemiːn
өтініш	øtiniʃ
өтінішім	øtiˈnɪʃɪm
өтірік	øˈtɪrɪk
өтіріктер	øˈtɪrɪkˈtɪr
өтірікші	øtɪɾɪkʃɪ
өткен	øtkʲen
өткенде	øtkʲenˈde
өткендегі	øtkʲeŋdegi
өткізгім	øtkɪzɣɪm
өткіздім	øtkɪzdɪm
өткізер	øtkʏzær
өткізілу	øtkɪˈzɪɫʊ
өткізіп	øtkɪˈzɪp
өтпейінше	øtpejɪ̃ʃe
өтті	øtti
өшетін	øʃetɪn
өшіремін	øʃɪˈrɪmɪn
өшіріңізші	øʃiˈrɪŋɪʃi
па	pɑ
пайда	pɑjˈdɑ
пайдаланамын	pɑjdɑlɑnɑmɯn
пайдаланып	pɑjdɑlɑnɯp
пайдаң	paɪˈdɑŋ
пайызы	pajɯzɯ
палатасында	palatɯstɑnda
папаны	pɑpɑnɯ
паранормалды	parɑnɔrmɑɫdɯ
париж	paɾɪʃ
парк	pɑrk
паспорттарын	paːspɑrtɑrɯn
паспортымды	paːspɔrtɯmˈdɯ
пасық	pɑˈsɯq
патологоанатом	patoloɣoanatom
патша	paʈʃɑ
патшалардың	paʰtʃɑɫɯɾɯŋ
патшасы	pɑtˈʃɑsɯ
пациент	patsiˈjɪnt
пациентім	patsijɪnˈtɪm
пациентті	patsʲiˈjɛntɪ
пациеті	pɑtsʲi̞jɘtɪ
пациетім	pɑtsʲjɪtɪm
пациетіміз	paʨijetimɨz
пациетіңіз	paʨijetɪŋɪz
пациетті	pɑtsʲjetɪ
пәк	pæk
пе	pʲe
педофил	pedɔfɪl
пен	pʲɪn
пеницилин	penʲɪtsɪlʲɪn
перкинс	pʲɪrkʲɪns
перудегі	perudegi
пікір	piˈkɪr
пікіріңді	pikiriŋˈdi
планетадағы	planʲetɑˈɣɑj
планеталықтар	planjetɑlətqɯtɑr
планка	planqɑ
плошка	ploʃkɑ
пойыз	pojɯz
полестиналықтар	pɔlʲesʲtʲɪnɫɯqˈtɑr
полицейлік	politsʲeˈlik
полицейліксіз	polʲitsɪjˈlɪksɪs
полиция	pɔlʲɪˈtsɪjə
полицияға	poliʦijəɣə
президент	prʲɪzʲɪˈdʲent
президентімін	prʲezʲɪdʲɪnˈtʲimʲin
президентінің	prʲezʲɪˈdʲɛtnʲɪˈnɨj
президентіңмін	prʲezʲɪdʲɪntɪŋmɪn
президентке	prʲezʲɪˈdʲentkʲe
президентпен	prʲezʲɪˈdʲentpʲɪn
президентті	prʲezʲɪˈdʲɛnʲtʲi
президенттің	prʲezʲɪˈdʲɛnʲtɪŋ
прес	prʲɪs
пресса	prʲɪˈsa
принстон	prʲɪnˈstɔn
принтер	prʲintɘr
проблеманы	pɾobɫemɑnɯ
прокуратурасына	prɑkʊrɑtʊrɑsɯnɑ
прокуратурасынанбын	prɑkʊrɑtʊrɑsɯnɑbɯn
процедуралар	prətsɪdʊrɑˈɫɑr
пуф	pʰuf
радиодан	radʲiɔˈdɑn
радиология	radʲɪoˈlogʲɪjə
радияциямен	radʲɪjɑtsʲɪɑˈmen
райы	rajɯ
рақмет	raqmet
рас	ras
расисті	ɾɑsɯˈsɯ
расымен	rasɯmen
расында	raʃɯˈdɑ
раушан	ɾɑwˈʃɑn
рахмет	ɾɑχˈmɛt
рәмізі	ræmiˈzi
ренжімессің	renʒimeˈsɪŋ
ренжітпеді	ɾeɲʐɪtˈpɪdʲi
ренжітсең	ɾeɲʐɪtˈseŋ
ресейде	ˈrʲesʲejdʲe
ресми	ɾesmi
ресторан	ɾestɔˈɾɑn
рет	ɾet
ретінде	ɾetinde
ретке	ɾetˈkæ
реттеп	ɾetˈtep
рецепті	ɾetsɪpˈtʲi
рин	rin
ричмонд	ɾitɕˈmɤnt
роберт	ɾobɘrt
родригеспен	rodrʲigesˈpɛn
роммель	romːl
роуд	ruːd
руларының	ɾʊɫɑɾɯˈnɯŋ
рухы	ɾʊχɯ
рұқсат	ɾʊqsɑt
рұқсатсыз	ɾʊqsɑtsɯs
рэнди	ɾændʲi
саған	sɑˈɣɑn
сағат	sɑˈʁɑt
сағатта	sɑʁɑtːɑ
сағаттан	ˈsɑɣɑtˈtɑn
сағындым	sɑqɯndɯm
сай	sɑj
сайтан	sɑjtɑn
сайын	sɑjɯn
сақалың	ˈsɑqɑɫɯŋ
сақтадым	ˈsɑqtɑdɯm
сақтаймын	sɑqtɑjˈmɯn
сақтайсыз	sɑqtɑjsɯz
сақтап	ˈsɑqtɑp
сақтасын	sɑqˈtɑsɯn
сақтау	sɑqˈtɑw
сақтауым	ˈsɑqtɑwmɯ
сақтығын	ˈsɑqtɯʁɯn
сал	saɫ
салайын	sɑlɑjɯn
саламат	sɑlɑmɑt
саламатсыз	ˈsɑlɑmɑtˈsɯz
саламатсызба	ˈsɑlɑmɑtsɯzβɑ
саламыз	ˈsɑlɑmɯz
саласыз	ˈsɑlɑsɯz
салған	ˈsaɫɣɑn
салем	ˈsɑlæm
салмаймыз	sɑlmɑjˈmɯz
салмаппыз	ˈsɑlmɑpɯz
салсам	ˈsɑɫsɑm
салуға	ˈsɑɫʊɣə
салынған	ˈsɑɫɯŋɑn
салыңдар	ˈsɑɫəŋdɑr
санаймыз	sɑnɑjmɯz
санайсыз	ˈsɑnɑjsɯz
санайсың	ˈsɑnɑjsɯŋ
саналмайды	sɑnɑɫmɑjˈdɯ
сандал	ˈsɑndɑɫ
сандалып	ˈsɑndɑɫɯp
сандхофф	ˈsɑndɑf
сандырағын	ˈsɑndɯrɑɣɯn
сандырақ	ˈsɑndɯrɑq
сандыраққа	ˈsɑndɯrɑqqɑ
сандырақтап	ˈsɑndɯrɑχˌtɑp
сапарға	ˈsɑpɑrʁɑ
сапарды	sɑpɑrdɯ
сапарым	ˈsɑpɑrɯm
сапарымда	ˈsɑpɑrɯmˈdɑ
сапасыз	sɑpɑsɯz
сара	sɑˈrɑ
сарайға	ˈsɑrɑjɣɑ
сарамын	ˈsɑrɑmɯn
сараның	ˈsɑrɑnɯŋ
сараңданып	ˈsɑrɑŋdɑˈnɯp
сараңсың	ˈsɑrɑŋsɯŋ
сата	sɑtɑ
сатқаныңыз	ˈsɑtqɑˌnɯˈʁɯ
сатқын	ˈsɑtqɯn
сатқындар	ˈsɑtqɯndɑr
сатқындықтың	ˈsɑtqɯnɯdɯʁɯŋ
сату	ˈsɑtʊ
сатып	sɑtɯp
сау	sɑw
сауалымыз	ˈsɑwɑləmɯz
сауда	ˈsɑwdɑ
сауды	sɑwˈdɯ
саулығы	ˈsɑwɫɯɣɯ
саулығына	ˈsɑwɫɯjəˈnə
саулық	sɑwˈɫɯq
сауыққа	sɑwɯqˈqɑ
сауып	sɑwɯp
саясатын	sɑjɑsɑtɯn
саяси	sɑjɑsi
сәбиімді	sæbɪmˈdi
сәбиіңізді	ˈsæbɪjɪŋɪzˈdi
сәйкес	sɑjˈkɘs
сәл	ˈsæl
сәлден	ˈsældɘn
сәлем	sælɪm
сәтке	sɑtˈkæ
сәттен	sɛtˈtɛn
сәтті	sætʲi
себебі	ˈsɛbɪˌbɪ
себебім	ˈsɛbɪˌbɪm
себебін	ˈsɛbɪˌbɪn
себебінен	ˈsɛbɪˌbɪˈnɛn
себеп	ˈsɛbɪp
себіңіз	ˈsɛbɪŋɪz
себіңізді	ˈsɛbɪŋɪzˈdɪ
сезесің	sɛzɛˈsɪŋ
сезім	sɛˈzɪm
сезіміңіз	ˈsɛzɪmɪŋɪz
сезімсіз	ˈsɛzɪmsɪz
сезімталдықты	ˈsɛzɪmtɑɫtɯqtɯ
сезінем	ˈsɛzʏˈnæm
сезіп	ˈsɛzɪp
секемім	sekemim
секілді	ˈsɛkɪɫdɪ
секілдімісің	sɛkɪldɪmɪsɪŋ
секір	sekɪr
семіріп	semɪrip
сен	sen
сенбеген	senbegen
сенбейді	senbejdi
сенбеймін	senbejmin
сенбейсіз	senbejsiz
сенбейсің	senbejsin
сенбейтін	senbejˈtin
сенбеуіміз	senbewimiz
сенген	senˈgen
сенгім	senˈɣim
сенгің	senˈɣɪŋ
сенде	sende
сендейлерге	sendejɫɪrˈʁe
сендер	sendeɾ
сендерге	sendeɾɣe
сендерді	sendeɾɯ
сендердің	senderiŋ
сендермен	sendɘrmɘn
сендерсіз	sendeɾˈsɯs
сенді	senˈdi
сендім	senˈdim
сендірудің	sendiru'diŋ
сене	sene
сенеді	senedi
сенем	senem
сенемін	senjemin
сенен	senen
сенер	senɪr
сенесіз	senesiːz
сенесің	senesiŋ
сенетін	senetʲin
сенетіп	senetip
сені	seni
сенікі	seniki
сенімділікте	senimdɪlɪktʲe
сенімдімін	senimdimi
сенімдіммін	senimdimmin
сенімдісің	senimdisiŋ
сенімен	senimɪn
сеніміңізге	senimɪŋɪzge
сенің	seniŋ
сеніңше	seniŋʃe
сеніп	senip
сеннен	senen
сену	senu
сергіп	sergɪp
серуендеп	serʉɪ̯ɪ̯ɪ̯ndɪp
сиқырдың	sɯqɯɾɯŋ
сиқырлы	sɯqɯɾɯ
сиқырмен	sɯqɯrmɘn
сиқыршы	sɯqɯrʃɯ
сиқыршыға	sɯqɯrʃɯɣa
сиқыршылық	sɯqɯɾʃɯɫɯq
сиқыршының	sɯqɯɾʃɯˈnɯŋ
сиқырымды	sɯqɯɾɯmˈdɯ
сионистер	siɔnɪstɪr
сирек	ʃɯˈrek
сияқты	ʃijɑqtɯ
сияқтымыз	ʃijɑqtɯmɯz
сияқтымын	sɪjɑqtɯmɯn
сияқтысың	ʃijɑqtɯsɯŋ
сіз	sɪz
сізбе	sɪzˈbɪ
сізбен	sɪzˈbɪn
сізге	sɪzɣe
сізде	sɪzˈdæ
сізден	siːzˈdɛn
сіздерге	sɪzˈdʲɪrɣe
сізді	sɪzˈdɪ
сіздің	sɪzˈdiŋ
сізідң	siˈzɯŋ
сізсіз	ˈsɪzˈsɪz
сіізге	ɕiːzge
сіңілісі	ˈsɪŋɪlɪsɪ
сіңіріңізді	siŋiɾiŋizdi
сірә	ˈsɪræ
скалли	skɑlʏ
скаллимін	skɑlɯˈmɯn
скальпельді	skɑlʲpʲɪlˈdɪ
скиннер	skʰinʲer
скот	skot
соға	sɔˈʁɑ
соған	sɔˈʁɑn
содан	sɔˈdɑn
созғансыз	sɔzɣɑnsɯz
сойып	sɔjɯp
соққаным	sɔqqɑnɯm
соққаныма	sɔqqɑnɯmɑ
соқпаған	sɔqpɑɣɑn
сол	soɫ
солай	solaɪ
солардың	solaɾɯŋ
солып	soˈlip
сомерсет	sɔmʲɪrˈsʲɛt
сонда	sɔnˈdɑ
сондай	sondaj
сондықтан	sɔndɯqˈtɑn
сонша	sɔnʃɑ
соншалықты	sɔnʃɑɫɯktɯ
соншама	sɔnʃɑmɑ
соны	sɔnɯ
сонымен	sɔnʏmʲɛn
сонысын	sɔnɯsɯn
соң	sɔŋ
соңғы	sɔŋɣɯ
соңғым	sɔŋɣɯm
соңымнан	sɔŋɯmˈnɑn
соңымыздан	sɔŋɯmɯzd̪
соңына	sɔŋɯnɑ
сосын	sɔˈsɯn
сөз	sɵz
сөздеріңді	sɵzdæɾɪŋdɪ
сөзді	sɵzdɪ
сөзімді	søzɪmdɪ
сөзін	sɵˈzɯn
сөзіне	søzɪnɛ
сөзіңді	søzɪŋdɪ
сөйлеген	sɔjleˈgen
сөйлейді	sɔjleji
сөйлейсіз	sɔjlejsɯz
сөйлейтін	sɔjlejtɪn
сөйлеме	sɔjˈlem
сөйлес	sɔjˈles
сөйлесе	sɔjˈles
сөйлесейік	sɔjlesɛjɪk
сөйлесем	sɔjlesem
сөйлесіңізші	sɘjlɘsɘnʐɘʃ
сөйлесіп	sɔjlɛsip
сөйлеспедік	sɔjlespedik
сөйлестік	sɔjlɛstɪk
сөйлестім	sɵjlɪsˈtɪm
сөйлестіңдер	sɔjlesˈtɪŋdɛr
сөйлестіңіз	sɔjlɛstɪŋɪz
сөйлесуге	sɔjlesuɣe
сөйлесуім	sɔjlesuim
сөйлесуіміз	sɵjlesʉiˈmɨz
сөйтіп	søjˈtip
сөндірулі	søndirulɪ
спорт	spɯrt
стадыңдар	staˈdɯŋdɑr
стакандарыңызды	stakanaɾəɯ̙ŋɯzˈdɯ
стамаңдар	staˈmaŋdɑr
стандартқа	stanˈdɑrtqɑ
станциямыз	staɲiʝɑˈmɯz
стерлинг	sterlʲɪŋ
сто	sʰo
стоун	sˈtun
студиясы	stʊdʲɪjəsɯ
стю	ʃtʏ
су	sʉ
субтитірлерін	suβtɪtɪrleɾɪn
суға	sʊɣɑ
суды	sʊdɯ
сумкасы	sʊmˈqɑsɯ
сурет	sʉˈrɪt
суретін	soɾetʰin
суреттегі	soɾetteɣi
суреттерді	soretˈtɘrdi
сусын	sʉsɯn
сусынға	sʉsɯŋɑ
сүзіп	sʉzɪp
сүйген	sɯjˈgen
сүйектері	sɯjɪkˈtæɾɪ
сүйер	sɯjɪr
сүйісудемін	sɯjɯsʉdʉmʉn
сүйкімді	sɯjkɯmdɯ
сүйрей	sɯjˈrej
сүреді	sʉˈrɪdɪ
сүреміз	sʉrɪˈmɪz
сүріп	sɯrip
сүру	sɯˈru
сүтін	sʉtɪn
сүю	sʉjʉ
сұйықтық	sʉjɯqtɯq
сұмдық	sʉmˈdɯq
сұмырай	ˈsʊmɯɾaj
сұра	suˈrɑ
сұраған	sɯɾɑɣɑn
сұрағаны	so̙raʁaˈnɯ
сұрағанын	so̙ɾɑɣɑˈnɯn
сұрағы	sōrɑɣɯ
сұрады	sɯrɑdɯ
сұрадым	soɾɑdɯm
сұрай	sʊˈrɑj
сұрайм	sʉrɑjm
сұраймыз	soʊɾɑjmɯz
сұраймын	sorajmən
сұрайтын	sʉrɑjtɯn
сұрайын	soɾajˈjɯn
сұрақ	sʊˈrɑq
сұрамай	soʊɾɑmɑj
сұрануға	sōɾanuʁɑ
сұрап	sōˈrɑp
сұрау	sɯɾɑw
сұрауға	sʉrɑʊɣɑ
сұрашы	sʉrɑʃɯ
сұхбатқа	sʊχbɑtqɑ
сыбайлас	sɯbɑjˈlɑs
сыйлады	sɯjɯɫɯ
сыйлаймын	sɯjlajmɯn
сыйлайтын	ˈsɯjɯɫɯtɯn
сыйлаңыз	sɯjlɑŋɯz
сыйлығым	sɯjɯˈlɯɣɯm
сыйлық	sɯjɯɫɯq
сыйырды	sɯjɯɾdɯ
сыйырдың	ˈsɯjɯɾdɯŋ
сыйырмен	sɯjɯrmʲen
сымбатты	sɯmβɑtːɯ
сынап	sɯnɑp
сынбаған	sɯmbaˈʁɑn
сынған	sɯŋˈɣɑn
сынды	sɯndɯ
сындыр	sɯndɯɾ
сындыру	sɯndɯɾu
сынып	sɯnɯp
сыңарым	sɯŋɑrɯm
сыра	sɯˈrɑ
сырқат	sɯrqɑt
сыртқа	ˈsɯrtqɑ
сыртқы	sɯrtqɯ
сыртта	ˈsɯrtːɑ
сыртында	sɯrtɯnda
сырыңыз	ˈsɯɾəɯ
сэн	sen
сэнге	ˈsæŋgʲe
сэнді	ˈsændi
сэнды	ˈsɛndɯ
сэннен	senen
сэннің	ˈsɛnnʲi
сэр	sɘr
та	tɑ
таба	tɑbɑ
табады	tɑbɑdɯ
табам	tɑbɑm
табамыз	tɑbɑmɯz
табамын	tɑbɑmɯn
табандылық	taβɑndɯɫɯq
табандылықпен	tɑbɑndɯɫɯqpɛn
табанын	taːbɑnɯn
табасыз	tɑbɑsɯz
табатын	tɑbɑˈtɯn
табатындарың	taːbɑtɯndɑˈrɯŋ
табуымыз	tɑbʊymɯz
табуың	ˈtɑβʊj
табылады	taβɯɫɯˈdɯ
табылатын	taβɯɫɑtɯn
табылған	tabɯɫˈʁɑn
табылғанын	taβɯɫʁɑˈnɯ
табылды	tabɯɫˈdɯ
табыс	tɑbɯs
табыстар	taβɯstɑr
тағамдармен	tɑʁɑmdɑrmʲɪn
тағаммен	tɑɣɑmˈmen
тағамын	tɑɣɑmɯn
тағдырым	tɑɣdɯɾɯm
тағы	tɑˈʁɯ
тағылған	tɑɣɯɫɣɑn
таза	taˈzɑ
тазалағыш	tazalaɣɯʃ
тазалай	tazɑɫaj
тазаламадың	tazɑlɑmɑˈðɯŋ
таймстағы	tɑjmsˈtɑxɯ
тайыз	tɑjɯz
тақта	tɑqˈtɑ
тақтайша	taqtaɪʃɑ
тақырыбын	taqɯrɯbɯn
талапқа	talaqˈqɑ
талғам	taɫˈʁɑm
талғамы	taɫɣɑmɯ
талқыладым	taɫqɯɫɯˈdɯm
талқылама	tɑɫqɯɫɑmɑ
талпындым	tɑɫpɯnˈdɯm
талшық	taɫʃɯq
талшықты	taɫʃɯqˈtɯ
талып	taɫɯp
тамағымыз	tɑmɑɣɯmɯz
тамағына	tɑmɑɣɯnɑ
тамақ	ˈtɑmɑq
тамақпен	tɑmɑqˈpɛn
тамақтан	tɑmɑqˈtɑn
тамақтанбай	tɑmɑqˈtɑnbɑj
тамақтанғың	taˈmaqtaŋ
тамақтандыруды	tɑmɑqˈtɑndɯˈrʊdɯ
тамақтанса	tɑmɑqˈtɑnsɑ
тамаша	tɑmɑʃɑ
тамшы	taːmʃɯ
тамызда	tɑmɯsˈdɑ
танзанияға	taŋzɑniʲɑ
тани	tani
танимын	tanimɯn
танисыз	taniˈsɯz
танитын	tanitɯn
танымаймын	tɑnɯmɑjˈmɯn
танымайсыз	tɑnɯmajˈsɯz
таныс	tɑnɯs
танысайын	tɑnɯsɑjɯn
танысқаныма	tɑnɯsqɑnɯmɑ
таныспын	tɑnɯspɯn
таныстыққа	taˈnɯstɯqqɑ
таныстырғым	tɑnɯstɯrɣɯm
таныстыруым	tɑnɯstɯɾʊm
танысып	tɑnɯsɯp
танысытырғым	tɑnɯsɯtɯɾɯɣɯm
таң	tɑŋ
таңғы	taŋɣɯ
таңғышын	taŋɯʃɯn
таңдадың	tɑŋdɑɯdɯŋ
таңдап	taŋdɑp
таңдым	tɑŋˈdɯm
таңертең	tɑŋɪrˈtɛŋ
тап	tap
тапқыр	tapqɯr
таппай	tɑpɑj
таппасаң	tɑpɑsɑŋ
тапсаң	tapˈsaŋ
тапсырамыз	tapˈsɯrɑmɯz
тапсырма	tapˈsɯrma
тапсырмаң	ˈtɑpsɯrmɑŋ
тапсырыс	tapˈsɯrɯs
тапсырыты	tapˈsɯrɯtɯ
тапты	tap'tɯ
таптық	ˈtɑpqɯq
таптым	tapˈtəm
таптың	ˈtɑptɯŋ
таптыңыз	tapˈtɯŋɯz
таралуы	tɑrɑɫʊɯ
тараңдар	taɾaŋdaɾ
тарап	tɑrɑp
таратады	tɑrɑtɑdɯ
тарихты	tɑˈrɯχtɯ
тарт	tɑrt
тартамыз	tɑrtɑˈmɯz
тартсаң	taɾtsɑŋ
тартып	tɑrtɯp
таста	tɑˈstɑ
тастадым	tɑstɑˈdɯm
тастадың	tɑstɑˈdɯŋ
тастайды	tɑstɑjˈdɯ
тастаймын	tɑstɑjmɯn
тастама	tɑstɑmɑ
тастаңыз	tɑstɑŋɯz
тастаңызшы	tɑstɑŋɯʃ
тастап	tɑˈstɑp
тастапты	tɑstɑpˈtɯ
тасымал	tɑsɯmɑɫ
тасымалдап	tɑsɯmɑɫdɑp
тасымалдаушы	tasɯmɑɫdɑwʃɯ
тасымалдаушылардан	tasɯmɑɫdɑwʃɯɫɑrˈdɑn
тату	tɑtʊ
татып	tɑtɯp
тауып	tawɯp
тауьымыз	tawɯmɯz
тәрізді	taɾizˈdi
тәртіпке	tɘrtɘpˈkɘ
тәртіпті	tɘrtɘptɘ
тәтті	ˈtæti
тәуелді	tawejldi
тәуелсіз	tæwɪlˈsɪz
тәурат	tɑwˈrɑt
твидлдам	tʋɪdɫɑm
твидлди	ˈtwɪdɫdɪ
те	te
театр	teˈɑtər
тез	te̞z
тездет	tezdɪt
тездетіңдер	tezdetiŋder
тездетіп	tezdetiːp
тезірек	teˈzʲiɾek
тек	tek
текпешекпен	tɛkpɛʃɛkpɛn
тексеріңіз	tegseɾiŋɪz
тексеріп	tegseˈriɪp
тексеру	tɛksɛɾʉ
тексеруге	teksɛɾuɣe
тексеруім	teksɛɾuwɪm
теледидар	tʲɪlʲedʲɪˈdɑr
телефон	tʲɪlʲɪˈfɔn
телефонға	telefoŋʁa
телефоны	telefoˈnɯ
телефоның	telefonɯŋ
тең	teŋ
теңіз	teŋiʒ
терапия	terɑpʲiʲɑ
терапиясы	terɑˈpijɑsɯ
тергейтіндей	tʲergejˈtɪndej
терезе	terɪzɪ
терең	terɪŋ
теріңнен	teˈrɪŋnən
терминал	tɛrmʲɪˈnɑɫ
тетікті	teˈtʏkʲtʏ
ти	tɪ
тиген	tiˈgen
тигізе	tiɣɯze
тигізесіз	tɪɣɪzɪsɪz
тигізесің	tiɣɪˈzɪsɪŋ
тигізіп	tɪɣɪzɪp
тиеді	tiˈjɪdi
тиелген	tʰiɪ́lgen
тиер	tʲíjɪr
тиіс	tɪɪs
тиісіп	tʰiɪsɪp
тиме	tʰɪˈmæ
тимей	tʰimej
тихиро	tʰɪxɪrɒ
тихиром	tʰɪxɪˈrɑw
тихироның	tiχiˈroˈnɯŋ
тиым	tɪm
тізем	tiˈzæm
тізімі	tiˈzimi
тізімін	tiˈzimin
тік	tɪk
тіке	tiˈkæ
тікелей	tʰɪkʲɪˈlæj
тікен	tiˈken
тілді	tɪɫˈdɪ
тілегенім	tilɪgeˈnim
тілектер	tiˈlekter
тілі	tili
тілінде	tilinˈde
тіліне	tiliˈne
тілмен	tɪlˈmen
тіптен	tepˈtæŋ
тіпті	tip'ti
тірі	tiˈri
тіріледі	tiˈrilɪde
тірімін	tiˈrimʲin
тірісің	tiˈɾiˌsiŋ
тісіңді	tiˈsiŋdi
тістеп	tiˈstɛp
тозбалаңға	tɔzbɑɫɑŋɣɑ
тойдым	tɔjˈdɯm
токсикологиқалық	toksikoɫoɣiɫɑq
тоқашты	tɔqɑʃtɯ
тоқта	tɔqˈtɑ
тоқтағаным	tɔqtaɣɑnɯm
тоқтай	tɔqtɑj
тоқтайды	tɔqtɑjˈdɯ
тоқталды	tɔqtɑɫdɯ
тоқтама	tɔqˈtɑmɑ
тоқтамай	tɔqˈtɑmɑj
тоқтамаңдар	tɔqˈtɑmɑŋdɑr
тоқтаңдар	tɔqˈtɑŋdɑr
тоқтаңыз	tɔqtaŋɯz
тоқтат	tɔqtɑt
тоқтатты	tɔqtɑtˈtɯ
тоқтатшы	tɔqtɑtʃɯ
тоқтатылуға	tokʰɑtɯɫʊwɑ
тоқтатыңдар	tɔqtaˈtɯŋdar
тоқташы	tɔqˈtɑʃɯ
тоқыдық	tɔqɯdɯq
тоқылдатуды	toqɯldɑtʊdɯ
тола	tɔˈɫɑ
толды	tɔɫdɯ
толқындар	tɔlqɯnˈdɑr
толтыра	tɔɫtɯɾɑ
толу	tɔˈɫʊ
толы	ˈtɔɫɯ
толығымен	ˈtɔɫɯɣɯˈmɛn
толық	ˈtɔlɯq
толықтай	tɔlɯqtɑj
томас	tɔˈmɑs
тонна	tɔnːa
тоңып	tɔŋɯp
топ	top
топтар	toptɑr
топтасып	toptɑsɯp
торай	tɔˈrɑj
торайға	tɔrɑjɑ
тост	tɔst
төбелес	tøbɪlɪs
төзгісіз	tøʒɣɯsɯ
төлей	tøˈlej
төлеймін	tøˈlejmin
төлейсің	tølejsɪŋ
төмен	ˈtømɘn
төменге	ˈtømæŋgɘ
төменде	ˈtømʲɪndʲe
төмендеуде	tømɪndøwðe
төңкеріс	tʰøŋkɘˈris
төңкеріске	tøŋkæriˈske
төреші	ˈtøræʃi
төрт	tɵrt
төртінші	tɵrtɘnʃi
төсегіне	ˈtøsɛgɪnɛ
төсегінен	tøsɛginɛn
төсектегі	ˈtøsɛktæɣi
тр	tɾ
транквилизатор	tranʋiɫɯzaˈtɯr
транквилизаторды	tranqʋɪlɪzɑtɯrɯ
транквилизаторын	tranqʋɪlɪzɑtɯrɯn
транкрилизаторы	tɾɑnkrɪlɪzɑˈɾɯzɯ
трубкаларды	trupkɑlɑrdɯ
трукаларды	tɾukɑɫɑɾdɯ
туалет	tuɑˈlʲɪt
туған	tʊˈʁɑn
туды	tudɯ
тудырады	tudɯrɑdɯ
туннел	tʰunːel
туннелден	tʰunːelˈden
тура	tʊˈrɑ
туралы	tʊrɑˈɫɯ
туралымаған	tʊrɑɫɯmɑˈʁɑŋ
туфлиді	ˈtʊfɫɪdɪ
туфлиім	tʰulfɪm
туфлиыңды	tʰulfɯɫɯŋdɯ
туылғалы	tʉɫɣɑɫɯ
туысқандарымызды	tʰʉjsqɑnːɑɾɯmɯzdɯ
түбі	tʏbi
түгіл	tʏɣɯl
түкір	tʏkɪr
түн	tʰyn
түнде	tʰynˈde
түңгі	tʏŋgɪ
түрде	tʏɾˈde
түрді	tʏɾˈdi
түрімен	tʏrɪˈmʲɪn
түрін	tʏˈrɪn
түріңе	tʏrɪŋe
түрлде	tɯɾɫde
түрлі	tʉɾˈli
түрмеде	tʏrmɘdɘ
түрмені	tʏrˈmɛni
түрмесі	tʏrˈmɘsɪ
түс	tʏs
түсас	tʏsɑs
түсер	tʏsɘr
түсесің	tʏsɪsɪŋ
түсімде	tʏsɯmˈdæ
түсіме	tʏsɪmɛ
түсінбедім	tʏsɪnbɪˈdɪm
түсінбейді	tʏsɪnbɪjdi
түсінбейсің	tʏsɪnbɪjsiŋ
түсінбейтін	tʏsɪnbɛjtɪn
түсінгенің	tʏsɪŋeŋ
түсінді	tʏsɪndɪ
түсіндім	tʏsɪndɪm
түсіндің	tʏsɪnˈdɪŋ
түсіндірді	tʏsɪndɪrdɪ
түсіндірем	tʏsɪndʏrɪm
түсіндіріп	tʏsɪndɪrɪp
түсіндіруге	tʏsɪndɪrʉɣe
түсіне	tʏsɪne
түсінеді	tʏsɪnɪdɪ
түсінемін	tʏsɪnɪmɪn
түсінесіз	tʏsɪnɪsɪz
түсінетін	tʏsɪnetʰin
түсінігіңіз	tʏsɪnɪɣɪŋɪz
түсініксіз	tʏsɪnɪkˈsɪz
түсініктеме	tʏsɪnɪktʲemʲe
түсінікті	tʏsɪnɪktɪ
түсініңіз	tʏsɪnɪŋɪz
түсініп	tʏsɪnɪp
түсінкті	tʏsɪŋkʲtɪ
түсір	tʏsɪr
түсірдім	tʏsɯɾdɯm
түсіре	tʏsɪrɛ
түсіремін	tʏsɪrɪmɪn
түсірерсің	tʏsirersɪŋ
түсіру	tʏsɪrʉ
түскен	tʏskɘn
түснем	tʏsnɛm
түссіз	tʏsˈsɪz
түсті	tʏsˈtɪ
түстік	tʏsˈtɪk
тұмарың	tʰʊmɑˈrɯŋ
тұнба	tʰʊmˈbɑ
тұнбаға	tʰʊnbɑɣɑ
тұнбаны	tʰʊnbɑnɯ
тұнбасы	tʰʊmbɑsɯ
тұр	tʰʊr
тұра	tʰʊˈɾɑ
тұрады	tʊɾɑɯ
тұрайын	tʊɾɑjɯn
тұрам	tʊˈrɑm
тұрама	tʊrɑmɑ
тұрамын	tʊrɑmɯn
тұрасыз	tʊrɑsɯz
тұратынын	tʊrɑtɯnɯn
тұратынына	tʊrɑtɯnʊnɑ
тұрған	tʊɾɣɑn
тұрғанда	tʊrɣɑnˈdɑ
тұрғаннан	tʊrɣɑnɑn
тұрғаным	tʊrɣɑnɯm
тұрғанымызды	tʊrɣanɯmɯzdɯ
тұрғанын	tʊɾɣanɯn
тұрғысынан	tʰʊrɣɯsan
тұрмайсыз	tʊrmɑjsɯz
тұрмыз	tʰʊrmɯz
тұрмын	tʉrmɯn
тұрмысың	tʊrməsɯŋ
тұрса	tʊrsɑ
тұрсаңыз	tʰʊrsɑŋɯz
тұрсыз	tʰʊrsɯz
тұрсың	tʰʊrsɯŋ
тұруыңызды	tʰʊɾʊɯŋɯzdɯ
тұршы	tʊrʃɯ
тұрыңдар	tʊˈrɯŋdɑr
тұрыңыз	tʊɾəŋɯz
тұрыңызшы	tʊɾəŋɯʃ
тұрып	tʊˈrɯp
тұтқындағанға	tʰʊtqɯndɑɣɑ
тұтқындар	tʰʊtqɯndɑɾ
тұтқындарды	tʰʊtqɯndɑɾdɯ
тұтқындардың	tʊtqɯndɑɾɯŋ
тұтқыннан	tʰutqɯnːan
тұтынушы	tutɯnʊʃɯ
тығыз	tɯɣɯz
тығылып	tɯɣɯləp
тығып	tɯɣɯp
тығырықтан	tɯɣɯrɯqtɑn
тыққым	tɯqɯm
тым	tɯm
тындырмайың	tɯndɯrmɑjɯŋ
тыныш	tɯnɯʃ
тыныштал	tɯnɯʃtɑɫ
тыңда	tɯŋdɑ
тыңдағысы	tɯŋdaɣɯsɯ
тыңдайды	tɯŋdɑjˈdɯ
тыңдамады	tɯŋdɑmɑdɯ
тыңдамауға	tɯŋdɑmɑwɑ
тыңдаңыз	tɯŋdɑŋɯz
тыңдаңызшы	tɯŋdɑŋɯʃ
тыңдап	tɯŋdɑp
тыңдашы	tɯŋdɑʃɯ
тырыс	tɯɾɯs
тырысам	tɯɾɯsɑm
тырысамын	tɯɾɯsɑmɯn
тырысқаныма	tɯɾɯsqɑnɯmɑ
тырысып	tɯɾɯsɯp
у	u
уайымдадым	wajɯmdaˈdɯm
уайымдай	wajɯmdɑj
уайымдама	wajɯmdaˈma
уайымсыз	wajɯmsɯz
уақыт	waqɯt
уақытқа	waqɯtqɑ
уақытта	waqɯt̪ːa
уақытты	waqɯtˈtɯ
уақыты	waqɯtɯ
уақытымды	waqɯtɯmˈdɯ
уақытымызды	waqɯtɯmɯzdɯ
уақытыңызды	waqɯtɯŋɯzˈdɯ
уәде	ʊæde
уәдесін	ʊædesin
уәкілдік	ʊækɪldɪk
уганда	ʊɣɑndɑ
угандаға	ʊɣɑndɑʁɑ
угандалық	ʊgɑndɑˈɫɯq
угандалықтан	ʊɣɑndɑɫɯqˈtɑn
угандалықтар	ʊɣɑndɑɫɯqˈtɑr
угандықтар	ʊɣɑnˈdɯqˈtɑr
уланған	ʊɫɑŋɑn
улауға	ʊlɑwɑ
унға	ʊŋʁɑ
университеті	ʊnʲɪvɪrsʲɪtʲɪ
уыстап	ʊtɑsˈp
ү	ʏ
үзіліс	ʉzɪlɪs
үзуге	ʉzʉɣe
үйге	ujge
үйде	ujde
үйден	ujdæn
үйді	ujdi
үйі	ujɪ
үйім	ujim
үйінде	ujɪndɘ
үйіне	ujine
үйінен	ujinɪn
үйің	ujɪŋ
үйіңе	ujinʲe
үйірмесінде	ujɪrmɪsɪndɘ
үйірмесіненбіз	ujɪrmesinɪnbɪz
үйленген	ujlɪŋɪn
үйленгенін	ujlɪŋɪn
үйлер	ujˈlɪr
үйренген	ujrɪŋɪn
үйренгім	ujrɪŋɪm
үйренеміз	ujrɪnɪˈmɪz
үйреніп	ujrɪnɪp
үйрететін	ujretetɪn
үйшігі	ujʃiɣi
үйшік	ujʃɪk
үйшікке	ujʃɪkˈkɛ
үйшіктер	ujʃɪktɘr
үкімет	ʏkɪˈmet
үкіметі	ʏkɪˈmɛtɪ
үкіметтік	ʉkɪmetˈtɪk
үлгерді	ʏlɣərˈdi
үлгересің	ʉlɣeɾeˈsiŋ
үлгі	ʉɫˈɣi
үлгісі	ʏlɣɪsɪ
үлкейген	ʏlˈkʲejˈgen
үлкен	ɘlˈkʲɘn
үлкеннің	ʉlˈkɛnˌnɪŋ
үміттемін	ymɪtˈtæmɪn
үміттеніп	ymɪttenip
үмттенеміз	ʏmt̪t̪enemiˈs
үндістандағы	ʏndɪstɑnɑɣɯ
үнемдейді	ynemdejdi
үнемі	ynæmi
үнін	ønin
үргенін	ʏrgɪˈnɪn
үстінде	ʉstɪnde
үстіне	ystiˈne
үш	ɯʃ
үшеуді	ʉʃewdɪ
үшін	ʉʃin
ұ	ʊ
ұғу	ʊˈɣʊ
ұғып	ʊɣɯp
ұзақ	ʊˈzɑq
ұзарту	ʊzɑrtʊ
ұзын	ʊˈzʏn
ұйғарып	ujɑrɯp
ұйқтадыңыз	ʊjqtɑˈdɯŋɯz
ұйқы	ujqɯ
ұйқысы	ujqɯsɯ
ұйықта	ujʏqˈtə
ұйықтағам	ujʏqtaɣɑm
ұйықтаған	ujɯqtaˈʁɑn
ұйықтай	ujɯqtɑj
ұйықтамай	ujyqtaˈmaj
ұйықтамайды	ujyqtaˈmɑjdi
ұйықтап	ujʏqˈtɑp
ұйықтатын	ujʊqtaˈtɯn
ұйықыда	ujɯqɯdɑ
ұйымдастырыңыз	ujɯmˈdɑstɯˈrɯŋɯz
ұқсайды	ʊqsɑjˈdɯ
ұқсаймын	ʊqsɑjmɯn
ұқсайтын	ʊqsɑjtɯn
ұқсамайды	ʊqsɑmajˈdɯ
ұқсас	ʊqsɑs
ұқтың	ʊqˈtɯŋ
ұлттың	uɫtɯŋ
ұлтымыз	ʊɫtɯmɯz
ұлы	ʊɫɯ
ұлым	ɯˈlɯm
ұмыта	ʊmɯtɑ
ұмытпай	ʊmɯtˈpɑj
ұмытты	ʊmɯtːɯ
ұмыттың	ʊmɯtˈtɯŋ
ұмыттыру	ʊmɯtːɯɾʊ
ұмытылмайды	ʊmɯtɯɫmɑjˈdɯ
ұмытып	ʊmɯtɯp
ұнады	ʊnɑdɯ
ұнай	ʊˈnɑj
ұнайды	ʊnɑjˈdɯ
ұнамай	ʊnɑˈmɑj
ұнамайды	ʊnɑmɑjdɯ
ұнамаймын	ʊnɑmɑjˈmɯn
ұнар	ʊˈnɑr
ұнатамын	ʊnɑtɑˈmɯn
ұнтағын	ʊntɑχɯn
ұрдым	urdɯm
ұрлаған	ʊrɫɑˈɣɑn
ұрланып	ʊrɫɑnɯp
ұрлап	ʊrɫɑp
ұрлауы	ɯɾɫɑwɯ
ұрсуды	ʊrsʊdɯ
ұрсып	ʊrsɯp
ұрушы	ʊɾuʃɯ
ұры	ʊˈɾɯ
ұрысады	ʊɾəsɑdɯ
ұсақ	ʊˈsɑq
ұста	ʊˈstɑ
ұстаған	ʊstɑˈʁɑn
ұстағысы	ʊstaɣɯsɯ
ұстады	ʊstɑdɯ
ұстай	ʊstaɪ
ұсталды	ʊstɑɫdɯ
ұстамасаң	ʊstɑmɑsɑŋ
ұстаңдар	ʊstɑŋdɑr
ұстаңызшы	ʊstɑŋɯʃ
ұстап	ʊˈstæp
ұстата	ʊstɑtɑ
ұстау	ʊstɑw
ұстауда	ʊstaˈwa
ұсынды	ʊsɯnˈdɯ
ұсынып	ʊsɯˈnɯp
ұсынысты	ʊsɯnɯsˈtɯ
ұсынысы	ʊsɯnɯsɯ
ұсынысын	ʊsɯnɯˈsɯn
ұшағын	ʊʃɑqɯn
ұшақ	ʊʃɑq
ұшып	ʊʃɯp
ұялмай	ʊjɑɫmɑj
ұят	ʊˈjɑt
ұятың	ʊjɑˈtɯŋ
фбр	ɸɪβɪr
фейсбуктан	fejsbʊktɑn
ферменттер	fermenter
фермердің	fermerˈdiŋ
фермермен	fermɛrmɛn
ферметтердің	fermetterɪŋ
феронға	fɘrɘnʁɑ
феуердің	fejweɾɪŋ
философиясын	filɘsɔfʲiʲɑsɯn
философсыз	filɘsɔfˈsɯz
фильм	film
фитцпатрик	fitsˈpʰatrik
фокс	fɔks
формасын	fɔrmɑˈsɯn
фосса	foˈsːɑ
франкенштейн	fræŋkənʃtɛjn
франкенштейнін	fræŋkənʃtɛjˈnɪn
француз	frɑnˈtus
фунт	fonts
футболкаңды	ftbolqɑŋdɯ
футболкаңызға	futbolqɑŋɯzɑ
футболкаңызды	futbolqɑŋɯzˈdɯ
хабар	xɑˈbɑr
хабардар	xɑbɑɾdɑɾ
хабардарсың	xɑbɑɾdɑrsɯŋ
хабарлама	χɑbɑɾɫɑmɑ
хабарлап	χɑβɑɾɫɑp
хабарлас	xɑbɑɾɫɑs
хабарласамын	χɑbɑɾɫɑsɑmɯn
хабарласпақшы	xɑbɑɾɫɑsˈpɑqʃɯ
хабарлассаңыз	χɑβɑɾɫɑsɑŋɯz
хабарласты	xɑbɑɾɫɑstɯ
хабарласып	xɑbɑɾɫɑsɯp
хабары	xɑbɑrɯ
хабарыңызды	χɑbɑɾɯŋɯzˈdɯ
хакама	xɑkɑmɑ
хаку	χɑˈku
хакуды	χɑˈkʊdɯ
хакудың	ɑqʊˈdɯŋ
хакусың	χɑkʊsɯŋ
халіңіз	xɑˈlɯˈz
халқы	χɑɫqɯ
халқым	χɑɫqɯm
халық	xɑˈɫɯq
халықаралық	xɑlɯqɑrɑˈlɯq
халыққа	χɑˈɫəqə
халықпен	xɑɫɯqpʰen
халықтың	xɑləqɯtɯŋ
ханым	xɑnɯm
ханымға	xɑnɯmɑ
ханымдар	xɑnɯmdɑɾ
ханымның	xɑnɯmˈnɯ
хат	xɑt
хламидиозды	xlamidʲɪozdɯ
хлор	xɫor
холидей	xɔlʏˈdʲej
христиандар	χrʲistʲiɑndɑr
ххх	xː
цивилизация	sɪvʲɪlʲɪzɑtsɪjə
чи	tʃi
чу	ʃu
ш	ʃ
шабуыл	ʃɑβʏɫ
шабуылдаған	ʃɑbʏɫdɑˈɣɑn
шағамды	ʃɑˈɣɑmdɯ
шағарсын	ʃɑˈɣɑrsən
шағымданам	ʃɑɣɯmdɑnɑm
шағыр	ʃɑˈɣɯɾ
шайтан	ʃɑjˈtɑn
шайтанның	ʃɑjˈtɑnɯnɯ
шақыр	ʃɑqɯr
шақырған	ʃɑqɯrˈʁɑn
шақырғанмын	ʃɑqɯɾʁɑnˈmɯn
шақырғаны	ʃɑqɯrˈʁɑnɯ
шақырғаныма	ʃɑqɯrʁɑnɯmɑ
шақырды	ʃɑqɯɾdɯ
шақырдым	ʃɑqɯɾdɯm
шақырдыңыз	ʃɑqɯɾdɯŋɯz
шақырсаң	ʃɑqɯrˈsɑŋ
шақырттым	ʃɑqɯrtˈtɯm
шақыруға	ʃɑqɯruʁɑ
шақырылмаған	ʃɑqɯɾɯɫmɑˈʁɑn
шақырым	ʃɑqɯˈrɯm
шақырыңдар	ʃɑqɯˈrɯŋdɑr
шақырып	ʃɑqɯˈrɯp
шалбары	ʃɑɫbɑrɯ
шам	ʃɑm
шамалы	ʃɑmɑˈɫɯ
шамасы	ʃɑmɑsɯ
шамдар	ʃɑmˈdɑr
шаң	ʃɑŋ
шапалақтамас	ʃɑpɑɫɑqˈtɑmɑs
шапшаң	ʃɑpʃɑɲ
шара	ʃɑˈrɑ
шарт	ʃɑrt
шарттары	ʃɑrtˈtɑrɯ
шарты	ʃɑrˈtɯ
шартым	ʃɑrtɯm
шартымды	ʃɑrtɯmˈdɯ
шаруа	ʃɑˈɾʊɑ
шаруаға	ʃɑˈɾʊɑɣɑ
шаршаған	ʃɑrʃɑˈɣɑn
шаршады	ʃɑrʃɑˈdɯ
шаршадым	ʃɑrʃɑˈdɯm
шатастырып	ʃɑtɑstɯɾɯp
шашы	ʃɑˈʃɯ
шашыңды	ʃɑˈʃɯŋdɯ
шәй	ʃæj
ше	ʃe
шегін	ʃegin
шексіз	ʃɛkˈsɪz
шерил	ʃɛˈrɯɫ
шет	ʃet
шетел	ʃetɛɫ
шетке	ʃetˈkʲe
шеттегі	ʃetˈtegi
шеш	ʃeʃ
шеше	ʃeʃe
шешеді	ʃeʃeˈdi
шешемнің	ʃeʃemˈnʉj
шешілген	ʃeʃɪlˈgen
шешім	ʃeʃim
шешімді	ʃeʃiːmdɪ
шешіміміз	ʃeʃiːmɪmɪz
шешімімізді	ʃeʃiːmɪmɪzˈdɪ
шешімің	ʃeʃɪˈmɪŋ
шешімнің	ʃeʃiːmˈnʲeɪ
шешкің	ʃeʃkɪŋ
шешпейді	ʃeʃpejˈdi
шешті	ʃeʃti
шештім	ʃeʃtɪm
шешу	ʃeʃu
шешуге	ʃeʃuɣe
шиеленітпе	ʃie̯le̯ni̯tpe
шиллинг	ʃɪlʲɪŋ
шіркеу	ʃɪrˈkø
шіркеуге	ʃɪrˈkøwge
шіркеудегі	ʃɪrˈkøwˈdæʁɪ
шіркеушелер	ʃɪrkɪwʃɪˈlɪr
шкафтар	ʃɑfˈtɑr
шкафы	ʃkɑfɯ
шнауз	ʃnaʊs
шомылатын	ʃomɯɫɑˈtɯn
шомылғым	ʃomɯɫɣɯm
шомылдығы	ʃomɯɫdɯɣɯ
шомылдықта	ʃomɯɫdɯqˈtɑ
шомылып	ʃomɯləp
шотландия	ʃotɫɑndiʝɑ
шотландияда	ʃotɫɑndʲɑdɑ
шотландияданмын	ʃotɫɑndijɑdɑmɯn
шотландияның	ʃotɫɑndijɑˈnɯ
шотландық	ʃotɫɑnˈdɯq
шотландықпын	ʃotɫɑndɯqpɯn
шотландықтармен	ʃotɫɑndɯqtaɾmen
шотына	ʃotɯˈnɑ
шоуға	ʃowɣa
шошқа	ʃoʃqɑ
шошқаға	ʃoʃqɑɣɑ
шошқаларды	ʃoʃqɑɫɑɾdɯ
шошып	ʃoʃɯp
шпалмен	ʃpɑlmɘn
штаты	ʃtɑtɯ
штатында	ʃtɑnɯˈdɑ
шу	ʃuː
шуламаңдар	ʃʊlɑmɑŋdɑr
шулап	ʃʊlɑp
шұжық	ʃʊˈʒɯq
шұлықты	ʃʊɫəqˈtə
шыға	ʃɯˈɣɑ
шығады	ʃɯɣɑdɯ
шығамын	ʃɯɣɑmɯn
шығар	ʃɯˈɣɑr
шығарады	ʃɯɣɑɾɑdɯ
шығарғаным	ʃɯɣɑrɣɑnɯm
шығарды	ʃɯɣɑɾdɯ
шығардың	ʃɯɣɑɾˈdɯŋ
шығарма	ʃɯɣɑrmɑ
шығармай	ʃɯɣɑrmɑj
шығармайды	ʃɯɣɑrmɑjˈdɯ
шығармыз	ʃɯɣɑrmɯz
шығарсыз	ʃɯɣɑrsɯz
шығарсың	ʃɯɣɑrsɯŋ
шығару	ʃɯɣɑˈɾʊ
шығаруды	ʃɯɣɑɾʊdɯ
шығаршы	ʃɯɣɑrʃɯ
шығарылғандар	ʃɯɣɑrylɣɑnˈdɑr
шығарыңдар	ʃɯɣɑryŋdɑr
шығарып	ʃɯɣɑˈrɯp
шығарыпты	ʃɯɣɑrɯptɯ
шығасың	ʃɯɣɑˈsɯŋ
шығатын	ʃɯɣɑˈtɯn
шығу	ʃɯˈɣʊ
шығын	ʃɯɣɯn
шығындар	ʃɯɣɯndɑr
шығынды	ʃɯɣɯnˈdɯ
шығыңдар	ʃɯɣɯŋdɑr
шығып	ʃɯˈɣɯp
шығысты	ʃɯɣɯsˈtɯ
шыда	ʃɯˈdɑ
шыдай	ʃɯdɑj
шыдап	ʃɯdɑp
шық	ʃɯq
шыққан	ʃɯqˈqɑn
шыққанша	ʃɯqˈqɑnʃɑ
шықпады	ʃɯqpɑdɯ
шықпай	ʃɯqˈpɑj
шықпайды	ʃɯqpaɯdɯ
шықпаймын	ʃɯqpaɯmɯn
шықпаңдар	ʃɯqpɑŋdɑr
шықсам	ʃɯqsɑm
шықты	ʃɯqtɯ
шықтық	ʃɯqˈtɯq
шықтым	ʃɯqtɯm
шын	ʃɯn
шынайы	ʃɯnɑjɯ
шындығында	ʃɯnˈdɯʁɯndɑ
шындықты	ʃɯnˈdɯqˈtɯ
шынымен	ʃɯnɯˈmʲen
шынында	ʃɯnɯnˈdɑ
шыңғырғаның	ʃɯŋɯrɑŋɯ
шытырмақ	ʃɯtɯrmɑq
ықпал	ɯqpɑɫ
ылғи	ɯɫɣɯ
ыңғайлы	ɯŋɣɑjˈlɯ
ыңырсуда	ɯŋɯrsudɑ
экономикалық	ɘkɘnɘmʲɘkɘlɯq
экономикамыз	ɘkɑnɘmɘkɑˈmɯz
экономикасы	ɘkɑnɘmɘkɑsɯ
экономикасын	ɘkɔnɘmɘkɘsɯn
экскаватор	ɛkskɑvɑtɯr
эксперимент	ɛkspɪrʲɪˈmʲɛnt
эксперименттер	ɛkspɪrʲɪmʲɪntʲɪr
экстасенсорлы	ɛkstɑsɛnˈsɔrɫɯ
экстрасенс	ɛkstrɑsɛns
экстрасенстермен	ɛkstrɑsɛnsɛrtmen
экстрасенстің	ɛkstrɑsɛnˈsɯŋ
элиосқа	ɘlʲɘsqɑ
элиостың	ɘliɔstɯŋ
эти	etɪ
юбаба	jʊbɑbɑ
юбабаға	jʊbɑbɑɣɑ
юбабамен	jʊbɑbɑmʲɪn
юбабаның	jʊbɑbɑˈnɯŋ
