а	a
абавязак	abavʲazak
абавязацельства	abavʲazatsʲelʲstva
абавязковы	abavʲaskovɨ
абажур	abaʐur
абак	abak
абанемент	abanʲemʲent
абараніць	abaranʲitsʲ
абараняць	abaranʲatsʲ
абарачацца	abaratʂatsːa
абарона	abarona
абат	abat
абатыса	abatɨsa
абацтва	abatstva
абвінаваціць	abvʲinavatsʲitsʲ
абвінавачваць	abvʲinavatʂvatsʲ
абвозіць	abvozʲitsʲ
абгаварыць	abɣavarɨtsʲ
абгаворваць	abɣavorvatsʲ
абгойсаць	abɣojsatsʲ
абед	abʲet
абедам	abʲedam
абедаў	abʲedau̯
абедаць	abʲedatsʲ
абедзве	abʲedzʲvʲe
абедзвюм	abʲedzʲvʲum
абедзвюма	abʲedzʲvʲuma
абедзвюх	abʲedzʲvʲux
абедзе	abʲedzʲe
абеду	abʲedu
абезгалоўліванне	abʲezgaɫou̯lʲivanʲːe
аб'ект	abjekt
аб'ём	abjom
аб'ёма	abjoma
аб'ёмам	abjomam
аб'ёмамі	abjomamʲi
аб'ёмаў	abjomau̯
аб'ёмах	abjomax
аб'ёме	abjomʲe
аб'ёму	abjomu
аб'ёмы	abjomɨ
аблічча	ablʲitʂːa
абмеркаваць	abmʲerkavatsʲ
абмяркоўваць	abmʲarkou̯vatsʲ
абнавіць	abnavʲitsʲ
абносіць	abnosʲitsʲ
або	abo
абодва	abodva
абодвум	abodvum
абодвума	abodvuma
абодвух	abodvux
абора	abora
аборт	abort
абразанне	abrazanʲːe
абразлівага	abrazʲlʲivaɣa
абразлівае	abrazʲlʲivaje
абразлівы	abrazʲlʲivɨ
абрус	abrus
абрыдлівы	abrɨdlʲivɨ
абрэвіятура	abrɛvʲijatura
абсалютны	apsalʲutnɨ
абсалютыст	apsalʲutɨst
абсент	apsʲent
абстрактны	apstraktnɨ
абстраляць	apstralʲatsʲ
абстрэльваць	apstrɛlʲvatsʲ
абсцэс	apstsɛs
абутак	abutak
абуховіч	abuxovʲitʂ
абхазія	apxazʲija
абцугі	aptsuɣʲi
аб'явіць	abjavʲitsʲ
аб'язджае	abjaʐdʐaje
аб'язджаем	abjaʐdʐajem
аб'язджаеце	abjaʐdʐajetsʲe
аб'язджаеш	abjaʐdʐajeʂ
аб'язджаць	abjaʐdʐatsʲ
аб'язджаю	abjaʐdʐaju
аб'яўленне	abjau̯lʲenʲːe
аб'яўляць	abjau̯lʲatsʲ
абяцанка	abʲatsanka
абяцаць	abʲatsatsʲ
авантура	avantura
авантурны	avanturnɨ
авёс	avʲos
авечка	avʲetʂka
агарод	aɣarot
агароджа	aɣarodʐa
агая	aɣaja
агіда	aɣʲida
агледзець	aɣlʲedzʲetsʲ
аглядаць	aɣlʲadatsʲ
агонь	aɣonʲ
аграрны	aɣrarnɨ
аграхімія	aɣraxʲimʲija
агрэст	agrɛst
агрэст	aɣrɛst
агульны	aɣulʲnɨ
агурок	aɣurok
ад	at
адам	adam
адбор	adbor
адбывацца	adbɨvatsːa
адбыцца	adbɨtsːa
адвага	advaɣa
адважны	advaʐnɨ
адвакат	advakat
адваротны	advarotnɨ
адвольны	advolʲnɨ
адгаварыць	adɣavarɨtsʲ
адгэтуль	adɣɛtulʲ
аддаваць	adːavatsʲ
аддадзім	adːadzʲim
аддай	adːaj
аддам	adːam
аддасі	adːasʲi
аддасць	adːasʲtsʲ
аддаць	adːatsʲ
адзежа	adzʲeʐa
адзенне	adzʲenʲːe
адзёр	adzʲor
адзін	adzʲin
адзінаццаты	adzʲinatsːatɨ
адзінаццаць	adzʲinatsːatsʲ
адзіны	adzʲinɨ
адказ	atkas
адказаць	atkazatsʲ
адказваць	atkazvatsʲ
адказнасць	atkaznasʲtsʲ
адказны	atkaznɨ
адклад	atkɫat
адкрыццё	atkrɨtsʲːo
адкуль	atkulʲ
адліга	adlʲiɣa
адмаўляць	admau̯lʲatsʲ
адмена	admʲena
адмова	admova
адна	adna
аднавокі	adnavokʲi
аднагалосны	adnaɣaɫosnɨ
аднаго	adnaɣo
аднак	adnak
аднакаляровы	adnakalʲarovɨ
аднаму	adnamu
аднарог	adnarox
адначасова	adnatʂasova
аднашлюбнасць	adnaʂlʲubnasʲtsʲ
аднашлюбны	adnaʂlʲubnɨ
адніманне	adnʲimanʲːe
адно	adno
адной	adnoj
адносіны	adnosʲinɨ
адносны	adnosnɨ
адною	adnoju
адну	adnu
адны	adnɨ
адным	adnɨm
аднымі	adnɨmʲi
адных	adnɨx
адобрыць	adobrɨtsʲ
адпачываць	atpatʂɨvatsʲ
адпачынак	atpatʂɨnak
адраджэнне	adradʐʲenʲːe
адрас	adras
адрозны	adroznɨ
адрэс	adrɛs
адсутнасць	atsutnasʲtsʲ
адсутнічаць	atsutnʲitʂatsʲ
адсутны	atsutnɨ
адсюль	atsʲsʲulʲ
адтуль	atːulʲ
адукацыя	adukatsɨja
адушаўлёны	aduʂau̯lʲonɨ
адчыніць	atːʂɨnʲitsʲ
адчыняць	atːʂɨnʲatsʲ
адэлаіда	adɛɫajida
адэса	adɛsa
ажыццявіць	aʐɨtsʲːavʲitsʲ
азбука	azbuka
азербайджан	azʲerbajdʐan
азербайджанец	azʲerbajdʐanʲets
азербайджанка	azʲerbajdʐanka
азербайджанскі	azʲerbajdʐanskʲi
азія	azʲija
азіяцкі	azʲijatskʲi
азон	azon
азот	azot
азэрбайджан	azɛrbajdʐan
айсберг	ajzbʲerx
айсбергаў	ajzʲbʲerɣau̯
айцец	ajtsʲets
айчына	ajtʂɨna
акадэмія	akadɛmʲija
акалічнасць	akalʲitʂnasʲtsʲ
акацыя	akatsɨja
акварыум	akvarɨum
акварыюм	akvarɨjum
акім	akʲim
акіян	akʲijan
акно	akno
акрамя	akramʲa
аксаміт	aksamʲit
актрыса	aktrɨsa
актыўны	aktɨu̯nɨ
акула	akuɫa
акуляры	akulʲarɨ
акупант	akupant
акупацыя	akupatsɨja
акурат	akurat
акуратны	akuratnɨ
акушэр	akuʂɛr
акцёр	aktsʲor
акцыя	aktsɨja
акцэнт	aktsɛnt
ала	aɫa
алах	aɫax
албанец	aɫbanʲets
албанія	aɫbanʲija
албанка	aɫbanka
албанскі	aɫbanskʲi
але	alʲe
алег	alʲex
алей	alʲej
алейнікава	alʲejnʲikava
алейнікаў	alʲejnʲikau̯
алена	alʲena
алень	alʲenʲ
алергалогія	alʲerɣaɫoɣʲija
алёс	alʲos
алжыр	aɫʐɨr
алжырац	aɫʐɨrats
алжырка	aɫʐɨrka
алігархія	alʲiɣarxʲija
аліна	alʲina
аловак	aɫovak
алтар	aɫtar
алфавіт	aɫfavʲit
альбанія	alʲbanʲija
альбо	alʲbo
альв	alʲv
альтэрнатыва	alʲtɛrnatɨva
алюміній	alʲumʲinʲij
аляксандар	alʲaksandar
аляксандр	alʲaksandr
аляксандра	alʲaksandra
аляксей	alʲaksʲej
амаль	amalʲ
аман	aman
амела	amʲeɫa
амерыка	amʲerɨka
амерыканец	amʲerɨkanʲets
амерыканізм	amʲerɨkanʲizm
амерыканка	amʲerɨkanka
амерыканскі	amʲerɨkanskʲi
ампер	ampʲer
амяла	amʲaɫa
анамастыка	anamastɨka
ананас	ananas
анархіст	anarxʲist
анастасія	anastasʲija
анатолій	anatolʲij
ангеліна	anɣʲelʲina
ангельскі	angʲelʲskʲi
ангельскі	anɣʲelʲskʲi
ангельску	anɣʲelʲsku
ангельшчына	anɣʲelʲʂtʂɨna
англійская	anɣlʲijskaja
англійскі	anɣlʲijskʲi
англія	anɣlʲija
ангола	anɣoɫa
андора	andora
андорскі	andorskʲi
андрэй	andrɛj
анексіраванне	anʲeksʲiravanʲːe
анёл	anʲoɫ
анестэзія	anʲestɛzʲija
анжаліка	anʐalʲika
анжэла	anʐɛɫa
анісім	anʲisʲim
анталогія	antaɫoɣʲija
антаніна	antanʲina
антарктыда	antarktɨda
антон	anton
антылопа	antɨɫopa
антысемітызм	antɨsʲemʲitɨzm
антысемітызмам	antɨsʲemʲitɨzmam
антысемітызме	antɨsʲemʲitɨzmʲe
антысемітызму	antɨsʲemʲitɨzmu
антэна	antɛna
апазіцыя	apazʲitsɨja
апазнаваць	apaznavatsʲ
апазнаць	apaznatsʲ
апалонік	apaɫonʲik
апарыш	aparɨʂ
апастыль	apastɨlʲ
апельсін	apʲelʲsʲin
апендыцыт	apʲendɨtsɨt
апетыт	apʲetɨt
апетытны	apʲetɨtnɨ
апісальны	apʲisalʲnɨ
апісанне	apʲisanʲːe
апісаць	apʲisatsʲ
апісваць	apʲisvatsʲ
апладненне	apɫadnʲenʲːe
апостраф	apostraf
апошні	apoʂnʲi
апранацца	apranatsːa
апранаць	apranatsʲ
аптэка	aptɛka
аптэкар	aptɛkar
аптэкарка	aptɛkarka
апублікаваць	apublʲikavatsʲ
арабскі	arapskʲi
аранжавы	aranʐavɨ
аргазм	arɣazm
аргентына	arɣʲentɨna
аргенціна	arɣʲenʲtsʲina
ар'ергард	arjerɣart
аркадзій	arkadzʲij
аркуш	arkuʂ
арменія	armʲenʲija
армія	armʲija
армэнія	armɛnʲija
армянін	armʲanʲin
армянка	armʲanka
армянскі	armʲanskʲi
арол	aroɫ
арсеній	arsʲenʲij
артур	artur
артыкул	artɨkuɫ
артышок	artɨʂok
артэрыя	artɛrɨja
арфаграфія	arfaɣrafʲija
архіпелаг	arxʲipʲeɫax
архітраў	arxʲitrau̯
архітэктар	arxʲitɛktar
архітэктарка	arxʲitɛktarka
арцём	artsʲom
арыстоцель	arɨstotsʲelʲ
арышт	arɨʂt
арэлі	arɛlʲi
арэх	arɛx
аса	asa
асабісты	asabʲistɨ
асабліва	asablʲiva
асаблівы	asablʲivɨ
асвета	asʲvʲeta
асёл	asʲoɫ
аселы	asʲeɫɨ
асенні	asʲenʲːi
асілак	asʲiɫak
асіна	asʲina
асіповічы	asʲipovʲitʂɨ
асла	asɫa
аслу	asɫu
аснова	asnova
асноватворны	asnovatvornɨ
асоба	asoba
астравец	astravʲets
астраном	astranom
астраномія	astranomʲija
астраўлян	astrau̯lʲan
астраўлянам	astrau̯lʲanam
астраўлянамі	astrau̯lʲanamʲi
астраўлянах	astrau̯lʲanax
астраўляне	astrau̯lʲanʲe
астраўлянін	astrau̯lʲanʲin
астраўляніна	astrau̯lʲanʲina
астраўлянінам	astrau̯lʲanʲinam
астраўлянінамі	astrau̯lʲanʲinamʲi
астраўлянінаў	astrau̯lʲanʲinau̯
астраўлянінах	astrau̯lʲanʲinax
астраўляніне	astrau̯lʲanʲinʲe
астраўляніну	astrau̯lʲanʲinu
астраўляніны	astrau̯lʲanʲinɨ
астэроід	astɛrojit
асцылограф	astsɨɫoɣraf
асцярожна	asʲtsʲaroʐna
асяроддзе	asʲarodzʲːe
атава	atava
атмасфера	atmasʲfʲera
атраховіч	atraxovʲitʂ
атрута	atruta
атрутны	atrutnɨ
атручванне	atrutʂvanʲːe
атрымае	atrɨmaje
атрымаем	atrɨmajem
атрымаеш	atrɨmajeʂ
атрымацца	atrɨmatsːa
атрымаць	atrɨmatsʲ
атрымаю	atrɨmaju
атрымліваеш	atrɨmlʲivajeʂ
атрымлівацца	atrɨmlʲivatsːa
атрымліваць	atrɨmlʲivatsʲ
атрымліваю	atrɨmlʲivaju
атэізм	atɛjizm
атэлье	atɛlʲje
аўганістан	au̯ɣanʲistan
аўгіеў	au̯ɣʲijeu̯
аўдоцця	au̯dotsʲːa
аўдыёвізуальны	au̯dɨjovʲizualʲnɨ
аўстраліец	au̯stralʲijets
аўстралійка	au̯stralʲijka
аўстралійскі	au̯stralʲijskʲi
аўстралія	au̯stralʲija
аўстрыец	au̯strɨjets
аўстрыйка	au̯strɨjka
аўстрыйскі	au̯strɨjskʲi
аўстрыя	au̯strɨja
аўтамабіль	au̯tamabʲilʲ
аўтамат	au̯tamat
аўтар	au̯tar
аўтарытарны	au̯tarɨtarnɨ
аўтобус	au̯tobus
аўторак	au̯torak
аўца	au̯tsa
афанасій	afanasʲij
афганец	avɣanʲets
афганістан	avɣanʲistan
афіцэр	afʲitsɛr
афрыка	afrɨka
афрыканец	afrɨkanʲets
афрыканка	afrɨkanka
афрыканскі	afrɨkanskʲi
ахвяра	axvʲara
ахосал	axosaɫ
ахоўны	axou̯nɨ
ацэтон	atsɛton
ашмяны	aʂmʲanɨ
аэрадром	aɛradrom
аэрапорт	aɛraport
баба	baba
бабарыка	babarɨka
бабёр	babʲor
бабруйск	babrujsk
бабуля	babulʲa
бабушка	babuʂka
баваўняны	bavau̯nʲanɨ
бавоўна	bavou̯na
багаж	baɣaʂ
багата	baɣata
багаты	baɣatɨ
багатыр	baɣatɨr
багацце	baɣatsʲːe
багдан	baɣdan
багіня	baɣʲinʲa
баграны	baɣranɨ
багуслаў	baɣusɫau̯
бадзёры	badzʲorɨ
бадмінтон	badmʲinton
база	baza
базар	bazar
байрактар	bajraktar
баклажан	bakɫaʐan
бактэрыя	baktɛrɨja
балгарка	baɫɣarka
балгарскі	baɫɣarskʲi
балгарын	baɫɣarɨn
балгарыя	baɫɣarɨja
балець	balʲetsʲ
балівія	balʲivʲija
балота	baɫota
балотнік	baɫotnʲik
балотны	baɫotnɨ
балтыйскі	baɫtɨjskʲi
бальніца	balʲnʲitsa
балюстрада	balʲustrada
балючы	balʲutʂɨ
бамбіць	bambʲitsʲ
бамбук	bambuk
банан	banan
бангладэш	banɣɫadɛʂ
банк	bank
банкруцтва	bankrutstva
барада	barada
барадаты	baradatɨ
баразна	barazna
баран	baran
барана	barana
баранавічы	baranavʲitʂɨ
барань	baranʲ
барва	barva
бар'ер	barjer
бар'ера	barjera
бар'ерам	barjeram
бар'ерамі	barjeramʲi
бар'ераў	barjerau̯
бар'ерах	barjerax
бар'еру	barjeru
бар'еры	barjerɨ
бародаўка	barodau̯ka
баршчам	barʂtʂam
баршчамі	barʂtʂamʲi
баршчах	barʂtʂax
баршчом	barʂtʂom
баршчоў	barʂtʂou̯
баршчу	barʂtʂu
баршчы	barʂtʂɨ
барый	barɨj
барыс	barɨs
барысаў	barɨsau̯
баскетбол	baskʲedboɫ
баскскі	baskskʲi
баснійскі	basʲnʲijskʲi
бастыён	bastɨjon
батаніка	batanʲika
батанічны	batanʲitʂnɨ
бацька	batsʲka
бацькам	batsʲkam
бацькамі	batsʲkamʲi
бацькаў	batsʲkau̯
бацьках	batsʲkax
бацькі	batsʲkʲi
бацьку	batsʲku
баця	batsʲa
бацян	batsʲan
бачанне	batʂanʲːe
бачны	batʂnɨ
бачыць	batʂɨtsʲ
баяцца	bajatsːa
бегаць	bʲeɣatsʲ
бегемот	bʲeɣʲemot
бегчы	bʲextʂɨ
бедната	bʲednata
бедны	bʲednɨ
без	bʲes
безалкагольны	bʲezaɫkaɣolʲnɨ
бездань	bʲezdanʲ
безнадзейнасць	bʲeznadzʲejnasʲtsʲ
безназоўны	bʲeznazou̯nɨ
белаазёрск	bʲeɫaazʲorsk
беларус	bʲeɫarus
беларусак	bʲeɫarusak
беларусі	bʲeɫarusʲi
беларуска	bʲeɫaruska
беларускага	bʲeɫaruskaɣa
беларускае	bʲeɫaruskaje
беларускай	bʲeɫaruskaj
беларускамоўны	bʲeɫaruskamou̯nɨ
беларускаму	bʲeɫaruskamu
беларускаю	bʲeɫaruskaju
беларуская	bʲeɫaruskaja
беларускі	bʲeɫaruskʲi
беларускім	bʲeɫaruskʲim
беларускімі	bʲeɫaruskʲimʲi
беларускіх	bʲeɫaruskʲix
беларускія	bʲeɫaruskʲija
беларускую	bʲeɫaruskuju
беларусцы	bʲeɫarustsɨ
беларусы	bʲeɫarusɨ
беларусь	bʲeɫarusʲ
беларусяй	bʲeɫarusʲaj
беларусяю	bʲeɫarusʲaju
беліз	bʲelʲis
белы	bʲeɫɨ
бельгіец	bʲelʲɣʲijets
бельгійка	bʲelʲɣʲijka
бельгійскі	bʲelʲɣʲijskʲi
бельгія	bʲelʲɣʲija
бензін	bɛnzʲin
бензін	bʲanzʲin
бензін	bʲenʲzʲin
бензін	bʲenzʲin
бенін	bʲenʲin
бераг	bʲerax
берагла	bʲeraɣɫa
бераглі	bʲeraɣlʲi
берагло	bʲeraɣɫo
берагу	bʲeraɣu
берагуць	bʲeraɣutsʲ
берагчы	bʲeraxtʂɨ
беражаце	bʲeraʐatsʲe
беражом	bʲeraʐom
беражы	bʲeraʐɨ
беражыце	bʲeraʐɨtsʲe
беражэ	bʲeraʐɛ
беражэш	bʲeraʐɛʂ
беразіно	bʲerazʲino
бераст	bʲerast
берасце	bʲerasʲtsʲe
берасьце	bʲerasʲtsʲe
бервяно	bʲervʲano
берлін	bʲerlʲin
берылій	bʲerɨlʲij
бес	bʲes
бескарыслівасць	bʲeskarɨsʲlʲivasʲtsʲ
бессмяротны	bʲesʲːmʲarotnɨ
бесстаронні	bʲesːtaronʲːi
бібліятэка	bʲiblʲijatɛka
бібліятэкар	bʲiblʲijatɛkar
бібліятэкарка	bʲiblʲijatɛkarka
бізнес	bʲizʲnʲes
бізнесмен	bʲizʲnʲesmɛn
бізнесмен	bʲizʲnʲesmʲen
бізнесмен	bʲiznɛsmɛn
бізнэс	bʲiznɛs
бізун	bʲizun
бінокль	bʲinoklʲ
бірманскі	bʲirmanskʲi
біруза	bʲiruza
бірузовы	bʲiruzovɨ
біскуп	bʲiskup
бітва	bʲitva
біць	bʲitsʲ
бішкек	bʲiʂkʲek
біялогія	bʲijaɫoɣʲija
благі	bɫaɣʲi
блакітны	bɫakʲitnɨ
бледны	blʲednɨ
блізка	blʲiska
блізкі	blʲiskʲi
блізнюк	blʲizʲnʲuk
бліндаж	blʲindaʂ
бліскавіца	blʲiskavʲitsa
бліскаўка	blʲiskau̯ka
блыха	bɫɨxa
блюда	blʲuda
блюзнер	blʲuzʲnʲer
бляшанка	blʲaʂanka
бо	bo
бог	box
божа	boʐa
бок	bok
боль	bolʲ
больш	bolʲʂ
большасць	bolʲʂasʲtsʲ
бомба	bomba
борзды	borzdɨ
боршч	borʂtʂ
боснія	bosʲnʲija
бочка	botʂka
бразілія	brazʲilʲija
бразільскі	brazʲilʲskʲi
брак	brak
брама	brama
браніслава	branʲisɫava
браніслаў	branʲisɫau̯
браслаў	brasɫau̯
брат	brat
брата	brata
брахаць	braxatsʲ
брахня	braxnʲa
браце	bratsʲe
браціслава	bratsʲisɫava
брацтва	bratstva
браць	bratsʲ
брод	brot
бром	brom
бронза	bronza
бруд	brut
брудны	brudnɨ
бруха	bruxa
брыво	brɨvo
брыдкі	brɨtkʲi
брытва	brɨtva
брэндзі	brɛnʲdzʲi
брэст	brɛst
брэсцкі	brɛstskʲi
брэтонскі	brɛtonskʲi
будаванне	budavanʲːe
будаваць	budavatsʲ
будзе	budzʲe
будзем	budzʲem
будзеце	budzʲetsʲe
будзеш	budzʲeʂ
будзь	butsʲ
будзьце	butsʲːe
буду	budu
будуць	budutsʲ
будучы	budutʂɨ
будучыня	budutʂɨnʲa
будынак	budɨnak
буйны	bujnɨ
буква	bukva
букініст	bukʲinʲist
булава	buɫava
булён	bulʲon
бульба	bulʲba
бульбай	bulʲbaj
бульбаю	bulʲbaju
бульбе	bulʲbʲe
бульбу	bulʲbu
бульбы	bulʲbɨ
бура	bura
бурак	burak
бусел	busʲeɫ
бутан	butan
бутэлька	butɛlʲka
бывае	bɨvaje
бываеш	bɨvajeʂ
бываць	bɨvatsʲ
бываю	bɨvaju
бык	bɨk
быкаў	bɨkau̯
была	bɨɫa
былая	bɨɫaja
былі	bɨlʲi
было	bɨɫo
былога	bɨɫoɣa
былое	bɨɫoje
былою	bɨɫoju
былую	bɨɫuju
былы	bɨɫɨ
былым	bɨɫɨm
былымі	bɨɫɨmʲi
былых	bɨɫɨx
былыя	bɨɫɨja
быстры	bɨstrɨ
быстрыня	bɨstrɨnʲa
быў	bɨu̯
быўшага	bɨu̯ʂaɣa
быўшае	bɨu̯ʂaje
быўшай	bɨu̯ʂaj
быўшаму	bɨu̯ʂamu
быўшаю	bɨu̯ʂaju
быўшая	bɨu̯ʂaja
быўшую	bɨu̯ʂuju
быўшы	bɨu̯ʂɨ
быўшым	bɨu̯ʂɨm
быўшымі	bɨu̯ʂɨmʲi
быўшых	bɨu̯ʂɨx
быўшыя	bɨu̯ʂɨja
быхаў	bɨxau̯
быць	bɨtsʲ
бэльгія	bɛlʲɣʲija
бюро	bʲuro
бяда	bʲada
бядро	bʲadro
бязглузды	bʲazgɫuzdɨ
бязлюддзе	bʲazʲlʲudzʲːe
бязлюдны	bʲazʲlʲudnɨ
бязь	bʲasʲ
бялград	bʲaɫɣrat
бялынічы	bʲaɫɨnʲitʂɨ
бяляш	bʲalʲaʂ
бярог	bʲarox
бяроза	bʲaroza
бярозаўка	bʲarozau̯ka
бярэмя	bʲarɛmʲa
бяспека	bʲasʲpʲeka
бяспечны	bʲasʲpʲetʂnɨ
бяссонны	bʲasːonːɨ
вавёрка	vavʲorka
ваг	vax
вага	vaɣa
вагам	vaɣam
вагамі	vaɣamʲi
вагах	vaɣax
вагі	vaɣʲi
вада	vada
вадарод	vadarot
вадаспад	vadaspat
вадзім	vadzʲim
вадзіць	vadzʲitsʲ
вадзянік	vadzʲanʲik
вадзяны	vadzʲanɨ
вадкасць	vatkasʲtsʲ
вадкі	vatkʲi
важкі	vaʂkʲi
важна	vaʐna
важны	vaʐnɨ
вазіць	vazʲitsʲ
вазьму	vazʲmu
вайна	vajna
вакол	vakoɫ
вакцынацыя	vaktsɨnatsɨja
валакно	vaɫakno
валам	vaɫam
валамі	vaɫamʲi
валах	vaɫax
валахаты	vaɫaxatɨ
валачы	vaɫatʂɨ
валерый	valʲerɨj
валіза	valʲiza
валізе	valʲizʲe
валізы	valʲizɨ
валійскі	valʲijskʲi
валоданне	vaɫodanʲːe
валожын	vaɫoʐɨn
валоў	vaɫou̯
валы	vaɫɨ
валькірыя	valʲkʲirɨja
валянцін	valʲanʲtsʲin
вам	vam
вамі	vamʲi
вампір	vampʲir
ванда	vanda
вандал	vandaɫ
вандроўны	vandrou̯nɨ
ванітаваць	vanʲitavatsʲ
ванна	vanːa
ванная	vanːaja
вантроба	vantroba
вараны	varanɨ
варатар	varatar
варвара	varvara
варожы	varoʐɨ
варона	varona
вароты	varotɨ
варочаць	varotʂatsʲ
варшава	varʂava
варэнік	varɛnʲik
вар'ят	varjat
вас	vas
васілевічы	vasʲilʲevʲitʂɨ
васіліск	vasʲilʲisk
васіль	vasʲilʲ
васьмёра	vasʲmʲora
васьмідзесяты	vasʲmʲidzʲesʲatɨ
васьмісоты	vasʲmʲisotɨ
васьмярым	vasʲmʲarɨm
васьмярымі	vasʲmʲarɨmʲi
васьмярых	vasʲmʲarɨx
васямнаццаты	vasʲamnatsːatɨ
васямнаццаць	vasʲamnatsːatsʲ
ваўкавыск	vau̯kavɨsk
ваўкалак	vau̯kaɫak
ваўчанск	vau̯tʂansk
вачэй	vatʂɛj
ваш	vaʂ
ваша	vaʂa
ваяваць	vajavatsʲ
ведаць	vʲedatsʲ
ведаю	vʲedaju
ведзьма	vʲedzʲma
вежа	vʲeʐa
везці	vʲesʲtsʲi
вейка	vʲejka
век	vʲek
веласіпед	vʲeɫasʲipʲet
велікамучанік	vʲelʲikamutʂanʲik
велікамучаніца	vʲelʲikamutʂanʲitsa
велічыня	vʲelʲitʂɨnʲa
вельмі	vʲelʲmʲi
венгерка	vʲenɣʲerka
венгерскі	vʲenɣʲerskʲi
венгр	vʲenɣr
венгрыя	vʲenɣrɨja
венера	vʲenʲera
венералогія	vʲenʲeraɫoɣʲija
венесуэла	vʲenʲesuɛɫa
вера	vʲera
верабей	vʲerabʲej
верагодны	vʲeraɣodnɨ
верад	vʲerat
верасень	vʲerasʲenʲ
верасеньскі	vʲerasʲenʲskʲi
верацяно	vʲeratsʲano
вербны	vʲerbnɨ
верны	vʲernɨ
версіі	vʲersʲiji
версій	vʲersʲij
версію	vʲersʲiju
версіям	vʲersʲijam
версіях	vʲersʲijax
верталёт	vʲertalʲot
верхнелужыцкі	vʲerxnʲeɫuʐɨtskʲi
верхні	vʲerxnʲi
верхнядзвінск	vʲerxnʲadzʲvʲinsk
верш	vʲerʂ
верыць	vʲerɨtsʲ
вёска	vʲoska
весці	vʲesʲtsʲi
ветка	vʲetka
ветлівы	vʲetlʲivɨ
в'етнам	vjetnam
в'етнамскі	vjetnamskʲi
ветразь	vʲetrasʲ
ветраны	vʲetranɨ
вецер	vʲetsʲer
вечар	vʲetʂar
вечны	vʲetʂnɨ
вешаць	vʲeʂatsʲ
відавочны	vʲidavotʂnɨ
відовішча	vʲidovʲiʂtʂa
відэа	vʲidɛa
відэакліп	vʲidɛaklʲip
відэлец	vʲidɛlʲets
віза	vʲiza
вікенцій	vʲikʲenʲtsʲij
вікіпедыя	vʲikʲipʲedɨja
вікіпэдыя	vʲikʲipɛdɨja
віктар	vʲiktar
вікторыя	vʲiktorɨja
вілейка	vʲilʲejka
вільготны	vʲilʲɣotnɨ
вільнюс	vʲilʲnʲus
вільня	vʲilʲnʲa
вінавальны	vʲinavalʲnɨ
вінаваты	vʲinavatɨ
вінаграднік	vʲinaɣradnʲik
вінніца	vʲinʲːitsa
віно	vʲino
віншавала	vʲinʂavaɫa
віншавалі	vʲinʂavalʲi
віншаваў	vʲinʂavau̯
віншаваць	vʲinʂavatsʲ
віншуе	vʲinʂuje
віншуем	vʲinʂujem
віншуеце	vʲinʂujetsʲe
віншуеш	vʲinʂujeʂ
віншуй	vʲinʂuj
віншуйце	vʲinʂujtsʲe
віншую	vʲinʂuju
віншуюць	vʲinʂujutsʲ
вірус	vʲirus
вісець	vʲisʲetsʲ
віскі	vʲiskʲi
вісла	vʲisɫa
вітай	vʲitaj
віталій	vʲitalʲij
вітаўт	vʲitau̯t
вітаць	vʲitatsʲ
вітаю	vʲitaju
віхура	vʲixura
віцебск	vʲitsʲepsk
віцебскі	vʲitsʲepskʲi
віялета	vʲijalʲeta
воблака	vobɫaka
вобласць	vobɫasʲtsʲ
вобраз	vobras
водар	vodar
водарасць	vodarasʲtsʲ
водка	votka
водны	vodnɨ
водца	votːsa
вожык	voʐɨk
возера	vozʲera
возьмеш	vozʲmʲeʂ
войска	vojska
войскі	vojskʲi
вока	voka
вол	voɫ
волава	voɫava
волас	voɫas
волат	voɫat
вольга	volʲɣa
вольха	volʲxa
вораг	vorax
воран	voran
восем	vosʲem
восемдзесят	vosʲemdzʲesʲat
восемсот	vosʲemsot
восень	vosʲenʲ
воск	vosk
воспа	vospa
востраў	vostrau̯
востры	vostrɨ
вось	vosʲ
восьмы	vosʲmɨ
воўк	vou̯k
воўна	vou̯na
воцат	votsat
вочы	votʂɨ
вош	voʂ
вроцлаў	vrotsɫau̯
вугал	vuɣaɫ
вугаль	vuɣalʲ
вуглярод	vuɣlʲarot
вугольчык	vuɣolʲtʂɨk
вугор	vuɣor
вугоршчына	vuɣorʂtʂɨna
вуда	vuda
вуж	vuʂ
вуздэчка	vuzdɛtʂka
вузел	vuzʲeɫ
вузкі	vuskʲi
вулей	vulʲej
вуліца	vulʲitsa
вулкан	vuɫkan
вус	vus
вусень	vusʲenʲ
вусік	vusʲik
вусны	vusnɨ
вустрыца	vustrɨtsa
вуха	vuxa
вучань	vutʂanʲ
вучнем	vutʂnʲem
вучні	vutʂnʲi
вучню	vutʂnʲu
вучня	vutʂnʲa
вучням	vutʂnʲam
вучнямі	vutʂnʲamʲi
вучняў	vutʂnʲau̯
вучнях	vutʂnʲax
вучыцца	vutʂɨtsːa
вучыць	vutʂɨtsʲ
вушны	vuʂnɨ
вы	vɨ
выбар	vɨbar
выбаршчык	vɨbarʂtʂɨk
выбары	vɨbarɨ
выбачайце	vɨbatʂajtsʲe
выбачыць	vɨbatʂɨtsʲ
вывезьці	vɨvʲesʲtsʲi
вывучыць	vɨvutʂɨtsʲ
выдаваць	vɨdavatsʲ
выдатны	vɨdatnɨ
выдаць	vɨdatsʲ
выдра	vɨdra
выебаць	vɨjebatsʲ
вызваленне	vɨzvalʲenʲːe
вызначаць	vɨznatʂatsʲ
вызначыць	vɨznatʂɨtsʲ
выйсці	vɨjsʲtsʲi
выкапаць	vɨkapatsʲ
выкапень	vɨkapʲenʲ
выкарыстаць	vɨkarɨstatsʲ
выкарыстоўваць	vɨkarɨstou̯vatsʲ
выкаць	vɨkatsʲ
выклічнік	vɨklʲitʂnʲik
выключаць	vɨklʲutʂatsʲ
выкраданне	vɨkradanʲːe
вымавіць	vɨmavʲitsʲ
вымаўляць	vɨmau̯lʲatsʲ
вымова	vɨmova
вымя	vɨmʲa
вынаходства	vɨnaxotstva
вынік	vɨnʲik
выніку	vɨnʲiku
вынятак	vɨnʲatak
вынятковы	vɨnʲatkovɨ
выпадак	vɨpadak
выпадкам	vɨpatkam
выпадкамі	vɨpatkamʲi
выпадкаў	vɨpatkau̯
выпадках	vɨpatkax
выпадкі	vɨpatkʲi
выпадку	vɨpatku
выпіць	vɨpʲitsʲ
выпрабаванне	vɨprabavanʲːe
выраз	vɨras
выразны	vɨraznɨ
вырашыць	vɨraʂɨtsʲ
выслаць	vɨsɫatsʲ
высокае	vɨsokaje
высокі	vɨsokʲi
выспа	vɨspa
выссаць	vɨsːatsʲ
высылаць	vɨsɨɫatsʲ
вытворчасць	vɨtvortʂasʲtsʲ
выхавальнік	vɨxavalʲnʲik
выхавальніца	vɨxavalʲnʲitsa
выходзіць	vɨxodzʲitsʲ
вышыванка	vɨʂɨvanka
вядома	vʲadoma
вядомы	vʲadomɨ
вядро	vʲadro
вяз	vʲas
вязаць	vʲazatsʲ
вязень	vʲazʲenʲ
вялізны	vʲalʲiznɨ
вялікабрытанія	vʲalʲikabrɨtanʲija
вялікдзень	vʲalʲigdzʲenʲ
вялікі	vʲalʲikʲi
вянок	vʲanok
вяпрук	vʲapruk
вярба	vʲarba
вярблюд	vʲarblʲut
вяргейчык	vʲarɣʲejtʂɨk
вяроўка	vʲarou̯ka
вяршкі	vʲarʂkʲi
вясёлка	vʲasʲoɫka
вяселле	vʲasʲelʲːe
вясёлы	vʲasʲoɫɨ
вясенні	vʲasʲenʲːi
вясло	vʲasɫo
вясна	vʲasna
вятрак	vʲatrak
вяхір	vʲaxʲir
вячаслаў	vʲatʂasɫau̯
вячорка	vʲatʂorka
вячэра	vʲatʂɛra
вячэраць	vʲatʂɛratsʲ
габой	ɣaboj
габрэй	ɣabrɛj
гаваркі	ɣavarkʲi
гаварлівы	ɣavarlʲivɨ
гавару	ɣavaru
гавары	ɣavarɨ
гаварыла	ɣavarɨɫa
гаварылі	ɣavarɨlʲi
гаварыў	ɣavarɨu̯
гаварыце	ɣavarɨtsʲe
гаварыць	ɣavarɨtsʲ
гавораць	ɣavoratsʲ
гаворым	ɣavorɨm
гаворыце	ɣavorɨtsʲe
гаворыць	ɣavorɨtsʲ
гаворыш	ɣavorɨʂ
гад	ɣat
гадзіна	ɣadzʲina
гадзіннік	ɣadzʲinʲːik
газ	gas
газ	ɣas
газа	ɣaza
газета	ɣazʲeta
газэта	gazɛta
газэта	ɣazɛta
гай	ɣaj
гайдаць	ɣajdatsʲ
гайка	ɣajka
гайнаўка	ɣajnau̯ka
галава	ɣaɫava
галандскі	ɣaɫantskʲi
галасаванне	ɣaɫasavanʲːe
галёнка	ɣalʲonka
галіна	ɣalʲina
галодны	ɣaɫodnɨ
галосны	ɣaɫosnɨ
галоўка	ɣaɫou̯ka
галоўны	ɣaɫou̯nɨ
галстук	ɣaɫstuk
гальмо	ɣalʲmo
гальштук	ɣalʲʂtuk
гана	gana
гана	ɣana
ганак	ganak
ґанак	ganak
ганак	ɣanak
ганарлівы	ɣanarlʲivɨ
ганарысты	ɣanarɨstɨ
гандаль	ɣandalʲ
гандлем	ɣandlʲem
гандлі	ɣandlʲi
гандлю	ɣandlʲu
гандляр	ɣandlʲar
ганебны	ɣanʲebnɨ
ганконг	ɣankonx
ганна	ɣanːa
гантэль	ɣantɛlʲ
ганцавічы	ɣantsavʲitʂɨ
ганчар	ɣantʂar
ганчарня	ɣantʂarnʲa
ганьба	ɣanʲba
ганяць	ɣanʲatsʲ
гара	ɣara
гарадок	ɣaradok
гараскоп	ɣaraskop
гарачы	ɣaratʂɨ
гарбата	ɣarbata
гарбуз	ɣarbus
гардзей	ɣardzʲej
гармата	ɣarmata
гарнастай	ɣarnastaj
гародніна	ɣarodnʲina
гародня	ɣarodnʲa
гарох	ɣarox
гарсэт	ɣarsɛt
гарчыца	ɣartʂɨtsa
гаршчок	ɣarʂtʂok
гарызонт	ɣarɨzont
гарэлка	ɣarɛɫka
гарэць	ɣarɛtsʲ
гаспадарка	ɣaspadarka
гасцёўня	ɣasʲtsʲou̯nʲa
гасцініца	ɣasʲtsʲinʲitsa
гасьцініца	ɣasʲtsʲinʲitsa
гатовы	ɣatovɨ
гатунак	ɣatunak
гатэль	ɣatɛlʲ
гаўно	ɣau̯no
гаўрыла	ɣau̯rɨɫa
гаць	ɣatsʲ
гаяна	ɣajana
гвалт	gvaɫt
ґвалт	gvaɫt
гвалт	ɣvaɫt
гвалтаваць	gvaɫtavatsʲ
гвалтаваць	ɣvaɫtavatsʲ
гвардзеец	ɣvardzʲejets
гвардзейскі	ɣvardzʲejskʲi
гвардзейцаў	ɣvardzʲejtsau̯
гвардыя	ɣvardɨja
гвозд	ɣvost
гданьск	ɣdanʲsk
геаграфічны	ɣʲeaɣrafʲitʂnɨ
геаграфія	ɣʲeaɣrafʲija
геаметрыя	ɣʲeamʲetrɨja
гей	ɣʲej
гелій	ɣʲelʲij
генадзій	ɣʲenadzʲij
генадзь	ɣʲenatsʲ
генацыд	ɣʲenatsɨt
генацыдаў	ɣʲenatsɨdau̯
генацыдзе	ɣʲenatsɨdzʲe
гендар	ɣʲendar
гендарам	ɣʲendaram
гендару	ɣʲendaru
гендары	ɣʲendarɨ
генеалогія	ɣʲenʲeaɫoɣʲija
георгій	ɣʲeorɣʲij
герасім	ɣʲerasʲim
германія	ɣʲermanʲija
германскі	ɣʲermanskʲi
герой	ɣʲeroj
гешэфт	gʲeʂɛft
гігрометр	ɣʲiɣromʲetr
гідкі	ɣʲitkʲi
гідралогія	ɣʲidraɫoɣʲija
гіль	ɣʲilʲ
гімн	ɣʲimn
гістарычны	ɣʲistarɨtʂnɨ
гісторыі	ɣʲistorɨji
гісторык	ɣʲistorɨk
гісторыю	ɣʲistorɨju
гісторыя	ɣʲistorɨja
гісторыяй	ɣʲistorɨjaj
гісторыяю	ɣʲistorɨjaju
гітара	ɣʲitara
гішпанія	ɣʲiʂpanʲija
глаголіца	ɣɫaɣolʲitsa
гладкі	ɣɫatkʲi
глеб	ɣlʲep
гледзячы	ɣlʲedzʲatʂɨ
гліна	ɣlʲina
глог	ɣɫox
глогам	ɣɫoɣam
глогу	ɣɫoɣu
глод	ɣɫot
глозе	ɣɫozʲe
глузд	ɣɫust
глупства	ɣɫupstva
глухі	ɣɫuxʲi
глыбокае	ɣɫɨbokaje
глыбокі	ɣɫɨbokʲi
глытаць	ɣɫɨtatsʲ
глядзець	ɣlʲadzʲetsʲ
гнаць	ɣnatsʲ
гнілы	ɣnʲiɫɨ
гной	ɣnoj
гнуць	ɣnutsʲ
гняздо	ɣnʲazdo
год	ɣot
годнасць	ɣodnasʲtsʲ
годны	ɣodnɨ
гожы	ɣoʐɨ
голад	ɣoɫat
голас	ɣoɫas
голасны	ɣoɫasnɨ
голуб	ɣoɫup
голы	ɣoɫɨ
гольф	ɣolʲf
гольфа	ɣolʲfa
гольфам	ɣolʲfam
гольфамі	ɣolʲfamʲi
гольфаў	ɣolʲfau̯
гольфах	ɣolʲfax
гольфе	ɣolʲfʲe
гольфу	ɣolʲfu
гольфы	ɣolʲfɨ
гомасексуалізм	ɣomasʲeksualʲizm
гомель	ɣomʲelʲ
гомельскі	ɣomʲelʲskʲi
гонар	ɣonar
гора	ɣora
горад	ɣorat
горадня	ɣoradnʲa
горача	ɣoratʂa
горб	ɣorp
горды	ɣordɨ
горкі	ɣorkʲi
горла	ɣorɫa
горны	ɣornɨ
горшы	ɣorʂɨ
госць	ɣosʲtsʲ
граб	ɣrap
грабеж	ɣrabʲeʂ
грабоўскі	ɣrabou̯skʲi
град	ɣrat
гразь	ɣrasʲ
грам	ɣram
грамадзянін	ɣramadzʲanʲin
грамадзянства	ɣramadzʲanstva
грамадства	ɣramatstva
граматыка	ɣramatɨka
граната	ɣranata
граніца	ɣranʲitsa
гранічны	ɣranʲitʂnɨ
графіт	ɣrafʲit
графіці	grafʲitsʲi
графіці	ɣrafʲitsʲi
граць	ɣratsʲ
грачанка	ɣratʂanka
грашыць	ɣraʂɨtsʲ
гродзенскі	ɣrodzʲenskʲi
гродна	ɣrodna
грошы	ɣroʂɨ
грубіян	ɣrubʲijan
грубы	ɣrubɨ
грудзі	ɣrudzʲi
грузін	ɣruzʲin
грузінка	ɣruzʲinka
грузінскі	ɣruzʲinskʲi
грузія	ɣruzʲija
група	ɣrupa
груша	ɣruʂa
грыб	ɣrɨp
грыба	ɣrɨba
грыбоў	ɣrɨbou̯
грыбы	ɣrɨbɨ
грыва	ɣrɨva
грызці	ɣrɨsʲtsʲi
грэбень	ɣrɛbʲenʲ
грэбля	ɣrɛblʲa
грэбці	ɣrɛptsʲi
грэк	ɣrɛk
грэх	ɣrɛx
грэцкі	ɣrɛtskʲi
грэцыя	ɣrɛtsɨja
грэшны	ɣrɛʂnɨ
губа	ɣuba
губіць	ɣubʲitsʲ
гугліць	guglʲitsʲ
гугліць	ɣuɣlʲitsʲ
гуглю	ɣuɣlʲu
гузік	guzʲik
гузік	ɣuzʲik
гук	ɣuk
гулец	ɣulʲets
гульня	ɣulʲnʲa
гуляць	ɣulʲatsʲ
гумарыст	ɣumarɨst
гумка	ɣumka
гурт	ɣurt
гусак	ɣusak
гусіт	ɣusʲit
густы	ɣustɨ
гусь	ɣusʲ
гутарка	ɣutarka
гутару	ɣutaru
гутарыла	ɣutarɨɫa
гутарылі	ɣutarɨlʲi
гутарым	ɣutarɨm
гутарыў	ɣutarɨu̯
гутарыць	ɣutarɨtsʲ
гутарыш	ɣutarɨʂ
гучнагаварыцель	ɣutʂnaɣavarɨtsʲelʲ
гучны	ɣutʂnɨ
гэта	ɣɛta
гэтага	ɣɛtaɣa
гэтае	ɣɛtaje
гэтай	ɣɛtaj
гэтаму	ɣɛtamu
гэтая	ɣɛtaja
гэту	ɣɛtu
гэтую	ɣɛtuju
гэты	ɣɛtɨ
гэтым	ɣɛtɨm
гэтымі	ɣɛtɨmʲi
гэтых	ɣɛtɨx
гэтыя	ɣɛtɨja
дабранач	dabranatʂ
дабрыдзень	dabrɨdzʲenʲ
давай	davaj
давальны	davalʲnɨ
даваць	davatsʲ
даведка	davʲetka
даведнік	davʲednʲik
давід	davʲit
дагэтуль	daɣɛtulʲ
дадаваць	dadavatsʲ
дадатак	dadatak
дадатковы	dadatkovɨ
дадаць	dadatsʲ
дадому	dadomu
даехаць	dajexatsʲ
дазваляць	dazvalʲatsʲ
дазволіць	dazvolʲitsʲ
даіць	dajitsʲ
даймаць	dajmatsʲ
дайсці	dajsʲtsʲi
даказаць	dakazatsʲ
дакладна	dakɫadna
дакладны	dakɫadnɨ
дакранацца	dakranatsːa
далёкі	dalʲokʲi
даліна	dalʲina
далонь	daɫonʲ
далоў	daɫou̯
далятаць	dalʲatatsʲ
даляцець	dalʲatsʲetsʲ
дама	dama
дамінік	damʲinʲik
дамініка	damʲinʲika
данелаг	danʲeɫax
данецк	danʲetsk
даніловіч	danʲiɫovʲitʂ
данія	danʲija
даныя	danɨja
дапамагаць	dapamaɣatsʲ
дапамагчы	dapamaxtʂɨ
дапамога	dapamoɣa
дапытлівы	dapɨtlʲivɨ
дарагі	daraɣʲi
дарадца	daratːsa
дарашэвіч	daraʂɛvʲitʂ
дарога	daroɣa
дарослы	darosɫɨ
дарыць	darɨtsʲ
дарэчы	darɛtʂɨ
дар'я	darja
даставаць	dastavatsʲ
дастатак	dastatak
дастаткова	dastatkova
дастатковы	dastatkovɨ
дастаць	dastatsʲ
даступны	dastupnɨ
дасягаць	dasʲaɣatsʲ
дасягненне	dasʲaɣnʲenʲːe
дасягнуць	dasʲaɣnutsʲ
датчанін	datːʂanʲin
датчанка	datːʂanka
датычылася	datɨtʂɨɫasʲa
датычыцца	datɨtʂɨtsːa
даўгата	dau̯ɣata
даўні	dau̯nʲi
даўніна	dau̯nʲina
дах	dax
даходзіць	daxodzʲitsʲ
дацкі	datskʲi
даць	datsʲ
дачка	datʂka
даязджаць	dajaʐdʐatsʲ
дбаць	dbatsʲ
два	dva
дваім	dvajim
дваімі	dvajimʲi
дваіх	dvajix
дванаццаты	dvanatsːatɨ
дванаццаць	dvanatsːatsʲ
дваранства	dvaranstva
дваццаты	dvatsːatɨ
дваццаць	dvatsːatsʲ
двое	dvoje
двор	dvor
двум	dvum
двума	dvuma
двух	dvux
двухсоты	dvuxsotɨ
джгаць	dʐgatsʲ
джыхад	dʐɨxat
джэм	dʐɛm
дзве	dzʲvʲe
дзверы	dzʲvʲerɨ
дзвесце	dzʲvʲesʲtsʲe
дзвюм	dzʲvʲum
дзвюма	dzʲvʲuma
дзвюх	dzʲvʲux
дзвярам	dzʲvʲaram
дзвярамі	dzʲvʲaramʲi
дзвярах	dzʲvʲarax
дзвярмі	dzʲvʲarmʲi
дзвярыма	dzʲvʲarɨma
дзвярэй	dzʲvʲarɛj
дзе	dzʲe
дзевер	dzʲevʲer
дзевяноста	dzʲevʲanosta
дзевяносты	dzʲevʲanostɨ
дзевятнаццаты	dzʲevʲatnatsːatɨ
дзевятнаццаць	dzʲevʲatnatsːatsʲ
дзевяцісоты	dzʲevʲatsʲisotɨ
дзевяць	dzʲevʲatsʲ
дзевяцьсот	dzʲevʲatsʲsot
дзёгаць	dzʲoɣatsʲ
дзед	dzʲet
дзеепрыметнік	dzʲejeprɨmʲetnʲik
дзеепрыслоўе	dzʲejeprɨsɫou̯je
дзейнік	dzʲejnʲik
дзейнічаць	dzʲejnʲitʂatsʲ
дзён	dzʲon
дзень	dzʲenʲ
дзерава	dzʲerava
дзесьці	dzʲesʲtsʲi
дзесяцігоддзе	dzʲesʲatsʲiɣodzʲːe
дзесяцітысячны	dzʲesʲatsʲitɨsʲatʂnɨ
дзесяць	dzʲesʲatsʲ
дзеці	dzʲetsʲi
дзець	dzʲetsʲ
дзеяслоў	dzʲejasɫou̯
дзеяць	dzʲejatsʲ
дзіва	dzʲiva
дзіда	dzʲida
дзікабраз	dzʲikabras
дзікі	dzʲikʲi
дзірка	dzʲirka
дзіўна	dzʲiu̯na
дзіўны	dzʲiu̯nɨ
дзіця	dzʲitsʲa
дзмітрый	dzʲmʲitrɨj
дзьмухавец	dzʲmuxavʲets
дзьмуць	dzʲmutsʲ
дзюба	dzʲuba
дзявяты	dzʲavʲatɨ
дзявяцера	dzʲavʲatsʲera
дзядзька	dzʲatsʲka
дзякавала	dzʲakavaɫa
дзякавалі	dzʲakavalʲi
дзякаваў	dzʲakavau̯
дзякаваўшы	dzʲakavau̯ʂɨ
дзякаваць	dzʲakavatsʲ
дзякуе	dzʲakuje
дзякуем	dzʲakujem
дзякуеце	dzʲakujetsʲe
дзякуеш	dzʲakujeʂ
дзякуй	dzʲakuj
дзякуйце	dzʲakujtsʲe
дзякую	dzʲakuju
дзякуюць	dzʲakujutsʲ
дзякуючы	dzʲakujutʂɨ
дзяніс	dzʲanʲis
дзяржава	dzʲarʐava
дзяржынск	dzʲarʐɨnsk
дзясяты	dzʲasʲatɨ
дзясяцера	dzʲasʲatsʲera
дзяўчына	dzʲau̯tʂɨna
дзяўчынка	dzʲau̯tʂɨnka
дзяцел	dzʲatsʲeɫ
дзяцінства	dzʲatsʲinstva
днём	dnʲom
дні	dnʲi
дно	dno
дню	dnʲu
дня	dnʲa
дням	dnʲam
днямі	dnʲamʲi
дняпро	dnʲapro
днях	dnʲax
добра	dobra
добры	dobrɨ
дождж	doʂtʂ
доказ	dokas
дол	doɫ
долата	doɫata
доля	dolʲa
дом	dom
дома	doma
досвед	dosvʲet
дослед	dosʲlʲet
доўг	dou̯x
доўгі	dou̯ɣʲi
дошка	doʂka
драбіны	drabʲinɨ
драгічын	draɣʲitʂɨn
дракон	drakon
дранік	dranʲik
драпаць	drapatsʲ
драпежнік	drapʲeʐnʲik
дробны	drobnɨ
дровы	drovɨ
дрожджы	droʐdʐɨ
дрот	drot
друг	drux
другі	druɣʲi
дружа	druʐa
друкаваць	drukavatsʲ
дрэва	drɛva
дрэнна	drɛnːa
дрэнны	drɛnːɨ
дуб	dup
дуброўна	dubrou̯na
дуброўнік	dubrou̯nʲik
думаць	dumatsʲ
думка	dumka
дупа	dupa
дурны	durnɨ
дух	dux
духмяны	duxmʲanɨ
душ	duʂ
душа	duʂa
душны	duʂnɨ
ды	dɨ
дыван	dɨvan
дызайн	dɨzajn
дызайнаў	dɨzajnau̯
дызайнер	dɨzajnʲer
дык	dɨk
дыктатар	dɨktatar
дыктатура	dɨktatura
дым	dɨm
дыназаўр	dɨnazau̯r
дыня	dɨnʲa
дырэктар	dɨrɛktar
дысертацыя	dɨsʲertatsɨja
дысплей	dɨsplʲej
дысплей	dɨspɫɛj
дыхаць	dɨxatsʲ
дыяпазітыў	dɨjapazʲitɨu̯
дэкорум	dɛkorum
дэльфін	dɛlʲfʲin
дэмакрат	dɛmakrat
дэмакратка	dɛmakratka
дэмакратыя	dɛmakratɨja
дэманстрацыя	dɛmanstratsɨja
дэндрахраналогія	dɛndraxranaɫoɣʲija
дэтанатар	dɛtanatar
е	je
ё	jo
ева	jeva
егіпцянін	jeɣʲiptsʲanʲin
егіпцянка	jeɣʲiptsʲanka
ёгурт	joɣurt
ёгуртам	joɣurtam
ёгуртамі	joɣurtamʲi
ёгуртаў	joɣurtau̯
ёгуртах	joɣurtax
ёгурту	joɣurtu
ёгурты	joɣurtɨ
ёгурце	joɣurtsʲe
едзь	jetsʲ
еду	jedu
ежа	jeʐa
ездзіць	jezdzʲitsʲ
ёй	joj
ейны	jejnɨ
елізавета	jelʲizavʲeta
ёлка	joɫka
ельск	jelʲsk
ельяшэвіч	jelʲjaʂɛvʲitʂ
ем	jem
ён	jon
епіскап	jepʲiskap
ерась	jerasʲ
ерэван	jerɛvan
есці	jesʲtsʲi
есць	jesʲtsʲ
ёсць	josʲtsʲ
есьці	jesʲtsʲi
еўдакім	jeu̯dakʲim
еўдакія	jeu̯dakʲija
ёўня	jou̯nʲa
еўра	jeu̯ra
еўрабачанне	jeu̯rabatʂanʲːe
еўрапеец	jeu̯rapʲejets
еўрапейка	jeu̯rapʲejka
еўрапейскі	jeu̯rapʲejskʲi
еўропа	jeu̯ropa
ехала	jexaɫa
ехалі	jexalʲi
ехаў	jexau̯
ехаць	jexatsʲ
ёю	joju
жаба	ʐaba
жабінка	ʐabʲinka
жабрак	ʐabrak
жабрачка	ʐabratʂka
жаваранак	ʐavaranak
жаданне	ʐadanʲːe
жадаць	ʐadatsʲ
жадаю	ʐadaju
жаднага	ʐadnaɣa
жаднаму	ʐadnamu
жадны	ʐadnɨ
жазло	ʐazɫo
жаласны	ʐaɫasnɨ
жалеза	ʐalʲeza
жалоба	ʐaɫoba
жана	ʐana
жанета	ʐanʲeta
жаніх	ʐanʲix
жаноцкі	ʐanotskʲi
жаночы	ʐanotʂɨ
жанчына	ʐantʂɨna
жанчыны	ʐantʂɨnɨ
жар	ʐar
жарабец	ʐarabʲets
жарабя	ʐarabʲa
жарало	ʐaraɫo
жаргон	ʐarɣon
жарсць	ʐarsʲtsʲ
жарт	ʐart
жартаваць	ʐartavatsʲ
жаўна	ʐau̯na
жах	ʐax
жахлівы	ʐaxlʲivɨ
жгут	ʐgut
жнівень	ʐnʲivʲenʲ
жнівеньскі	ʐnʲivʲenʲskʲi
жніво	ʐnʲivo
жолаб	ʐoɫap
жолуд	ʐoɫut
жонка	ʐonka
жопа	ʐopa
жорсткасць	ʐorstkasʲtsʲ
жорсткі	ʐorstkʲi
жоўты	ʐou̯tɨ
жоўць	ʐou̯tsʲ
жужаль	ʐuʐalʲ
жук	ʐuk
жуковіч	ʐukovʲitʂ
жукоўскі	ʐukou̯skʲi
журнал	ʐurnaɫ
журналіст	ʐurnalʲist
журналістка	ʐurnalʲistka
жывёла	ʐɨvʲoɫa
жывот	ʐɨvot
жывы	ʐɨvɨ
жыд	ʐɨt
жыла	ʐɨɫa
жыта	ʐɨta
жытомір	ʐɨtomʲir
жыхар	ʐɨxar
жыццё	ʐɨtsʲːo
жыць	ʐɨtsʲ
жэньшэнь	ʐɛnʲʂɛnʲ
жэрабя	ʐɛrabʲa
заахвоціць	zaaxvotsʲitsʲ
забабоны	zababonɨ
забараніць	zabaranʲitsʲ
забараняць	zabaranʲatsʲ
забарона	zabarona
забастоўка	zabastou̯ka
забеспячэнне	zabʲesʲpʲatʂɛnʲːe
забіваць	zabʲivatsʲ
забіць	zabʲitsʲ
забойства	zabojstva
забойца	zabojtsa
заборскі	zaborskʲi
забываць	zabɨvatsʲ
забыць	zabɨtsʲ
завірусе	zavʲirusʲe
завірух	zavʲirux
завіруха	zavʲiruxa
завірухай	zavʲiruxaj
завірухам	zavʲiruxam
завірухамі	zavʲiruxamʲi
завірухах	zavʲiruxax
завірухаю	zavʲiruxaju
завірухі	zavʲiruxʲi
завіруху	zavʲiruxu
заводзіць	zavodzʲitsʲ
загад	zaɣat
загадзя	zaɣadzʲa
загадка	zaɣatka
загрэб	zaɣrɛp
зазвычай	zazvɨtʂaj
зайздрасць	zajzdrasʲtsʲ
зайздросны	zajzdrosnɨ
займацца	zajmatsːa
займаць	zajmatsʲ
займеннік	zajmʲenʲːik
заканадаўства	zakanadau̯stva
заканазнавец	zakanaznavʲets
закінуты	zakʲinutɨ
закон	zakon
закратаваць	zakratavatsʲ
залаты	zaɫatɨ
залежны	zalʲeʐnɨ
заложнік	zaɫoʐnʲik
заложны	zaɫoʐnɨ
залоза	zaɫoza
залупа	zaɫupa
замак	zamak
замежны	zamʲeʐnɨ
замест	zamʲest
замок	zamok
занядбаны	zanʲadbanɨ
занятак	zanʲatak
запавет	zapavʲet
запалка	zapaɫka
запальнічка	zapalʲnʲitʂka
запарожжа	zaparoʐːa
заплаціў	zapɫatsʲiu̯
заплаціць	zapɫatsʲitsʲ
запыт	zapɨt
запытанне	zapɨtanʲːe
запытанню	zapɨtanʲːu
запытання	zapɨtanʲːa
запытаць	zapɨtatsʲ
запэўніваць	zapɛu̯nʲivatsʲ
запэўніць	zapɛu̯nʲitsʲ
запякаць	zapʲakatsʲ
запясце	zapʲasʲtsʲe
запячы	zapʲatʂɨ
зараз	zaras
зараплавец	zarapɫavʲets
засада	zasada
заставацца	zastavatsːa
застацца	zastatsːa
затока	zatoka
затор	zator
затым	zatɨm
заўжды	zau̯ʐdɨ
заўзяты	zau̯zʲatɨ
заўсёды	zau̯sʲodɨ
заўтра	zau̯tra
захаваць	zaxavatsʲ
захад	zaxat
захапіць	zaxapʲitsʲ
захапляцца	zaxaplʲatsːa
захапляюся	zaxaplʲajusʲa
захаранка	zaxaranka
захацець	zaxatsʲetsʲ
заходні	zaxodnʲi
захоплены	zaxoplʲenɨ
захоўваць	zaxou̯vatsʲ
зачараваць	zatʂaravatsʲ
зачароўваць	zatʂarou̯vatsʲ
зачарсцвець	zatʂarsʲtsʲvʲetsʲ
зачыніць	zatʂɨnʲitsʲ
зачыняць	zatʂɨnʲatsʲ
зашмат	zaʂmat
заявіць	zajavʲitsʲ
заяўляць	zajau̯lʲatsʲ
заяц	zajats
збежнасць	zʲbʲeʐnasʲtsʲ
зберагчы	zʲbʲeraxtʂɨ
збіраць	zʲbʲiratsʲ
збожжа	zboʐːa
зброя	zbroja
званіць	zvanʲitsʲ
звар'яцець	zvarjatsʲetsʲ
зваць	zvatsʲ
звер	zʲvʲer
звестка	zʲvʲestka
звон	zvon
звычай	zvɨtʂaj
звычайна	zvɨtʂajna
звычайны	zvɨtʂajnɨ
звязда	zʲvʲazda
згадаць	zgadatsʲ
згадаю	zgadaju
згадваць	zgadvatsʲ
згаджацца	zgadʐatsːa
згадзіцца	zgadzʲitsːa
згарэць	zgarɛtsʲ
згвалтаваць	zgvaɫtavatsʲ
згінуць	zgʲinutsʲ
згода	zgoda
згодай	zgodaj
згодаю	zgodaju
згодзе	zgodzʲe
згодны	zgodnɨ
згоду	zgodu
згоды	zgodɨ
здабыча	zdabɨtʂa
здавацца	zdavatsːa
здань	zdanʲ
здараецца	zdarajetsːa
здарацца	zdaratsːa
здараюцца	zdarajutsːa
здаровы	zdarovɨ
здароў	zdarou̯
здароўе	zdarou̯je
здарыцца	zdarɨtsːa
здарэнне	zdarɛnʲːe
здзекавалася	zdzʲekavaɫasʲa
здзекаваліся	zdzʲekavalʲisʲa
здзекаваўся	zdzʲekavau̯sʲa
здзекаваўшыся	zdzʲekavau̯ʂɨsʲa
здзекавацца	zdzʲekavatsːa
здзекуемся	zdzʲekujemsʲa
здзекуецеся	zdzʲekujetsʲesʲa
здзекуецца	zdzʲekujetsːa
здзекуешся	zdzʲekujesʲːa
здзекуйся	zdzʲekujsʲa
здзекуйцеся	zdzʲekujtsʲesʲa
здзекуюся	zdzʲekujusʲa
здзекуюцца	zdzʲekujutsːa
здзекуючыся	zdzʲekujutʂɨsʲa
здольнасць	zdolʲnasʲtsʲ
здольны	zdolʲnɨ
здрада	zdrada
здраднік	zdradnʲik
здымае	zdɨmaje
здымаем	zdɨmajem
здымаеце	zdɨmajetsʲe
здымаеш	zdɨmajeʂ
здымаў	zdɨmau̯
здымаць	zdɨmatsʲ
здымаю	zdɨmaju
здымаюць	zdɨmajutsʲ
землятрус	zʲemlʲatrus
земфіра	zʲemfʲira
зерне	zʲernʲe
з'есці	zʲjesʲtsʲi
зефір	zʲefʲir
зіма	zʲima
зімні	zʲimnʲi
зімны	zʲimnɨ
зламацца	zɫamatsːa
зламаць	zɫamatsʲ
злачынец	zɫatʂɨnʲets
злачыннасць	zɫatʂɨnːasʲtsʲ
злачынства	zɫatʂɨnstva
злёгку	zʲlʲoxku
злодзей	zɫodzʲej
злучнік	zɫutʂnʲik
злы	zɫɨ
змагар	zmaɣar
змагла	zmaɣɫa
змагло	zmaɣɫo
змагу	zmaɣu
змагчы	zmaxtʂɨ
змог	zmox
змораны	zmoranɨ
змрок	zmrok
змрочны	zmrotʂnɨ
змяніцца	zʲmʲanʲitsːa
змяніць	zʲmʲanʲitsʲ
змяняцца	zʲmʲanʲatsːa
змяняць	zʲmʲanʲatsʲ
змяя	zʲmʲaja
знавец	znavʲets
знадворны	znadvornɨ
знаёміць	znajomʲitsʲ
знай	znaj
знайсці	znajsʲtsʲi
знак	znak
знала	znaɫa
знаў	znau̯
знаходжу	znaxodʐu
знаходзіцца	znaxodzʲitsːa
знаходзіць	znaxodzʲitsʲ
знаходзяцца	znaxodzʲatsːa
знаць	znatsʲ
значу	znatʂu
значыць	znatʂɨtsʲ
значэнне	znatʂɛnʲːe
знаю	znaju
знікаць	zʲnʲikatsʲ
знікненне	zʲnʲiknʲenʲːe
знікнуць	zʲnʲiknutsʲ
зніч	zʲnʲitʂ
знічка	zʲnʲitʂka
зноў	znou̯
зняць	zʲnʲatsʲ
золата	zoɫata
зорак	zorak
зорачка	zoratʂka
зорка	zorka
зося	zosʲa
зрабі	zrabʲi
зрабіла	zrabʲiɫa
зрабілі	zrabʲilʲi
зрабіў	zrabʲiu̯
зрабіце	zrabʲitsʲe
зрабіцца	zrabʲitsːa
зрабіць	zrabʲitsʲ
зраблю	zrablʲu
зразумець	zrazumʲetsʲ
зробім	zrobʲim
зробіце	zrobʲitsʲe
зробіць	zrobʲitsʲ
зробіш	zrobʲiʂ
зробяць	zrobʲatsʲ
зрок	zrok
зроку	zroku
зрэшты	zrɛʂtɨ
зуб	zup
зуба	zuba
зурна	zurna
зусім	zusʲim
зша	ʂːa
зычны	zɨtʂnɨ
з'ява	zʲjava
з'явіцца	zʲjavʲitsːa
зязюля	zʲazʲulʲa
зялёны	zʲalʲonɨ
зямля	zʲamlʲa
зяновіч	zʲanovʲitʂ
з'яўляцца	zʲjau̯lʲatsːa
зяць	zʲatsʲ
і	ji
іарданія	jiardanʲija
іван	jivan
іванава	jivanava
іваноў	jivanou̯
івацэвічы	jivatsɛvʲitʂɨ
івашкевіч	jivaʂkʲevʲitʂ
ігар	jiɣar
ігла	jiɣɫa
ігнат	jiɣnat
іголка	jiɣoɫka
ігра	jiɣra
іграць	jiɣratsʲ
ідзе	jidzʲe
ідзём	jidzʲom
ідзеш	jidzʲeʂ
ідзі	jidzʲi
ідзіце	jidzʲitsʲe
ідзяце	jidzʲatsʲe
іду	jidu
ідуць	jidutsʲ
ідучы	jidutʂɨ
ідыш	jidɨʂ
ідэя	jidɛja
іерусалім	jijerusalʲim
ізраіль	jizrajilʲ
ізраільскі	jizrajilʲskʲi
ікона	jikona
ілгаць	jiɫɣatsʲ
ілья	jilʲja
ім	jim
імбір	jimbʲir
імгла	jimɣɫa
імені	jimʲenʲi
іміграцыя	jimʲiɣratsɨja
імітацыя	jimʲitatsɨja
імпартны	jimpartnɨ
імперыя	jimpʲerɨja
імя	ɨmʲa
імя	jimʲa
інаўгурацыя	jinau̯guratsɨja
інаўгурацыя	jinau̯ɣuratsɨja
інгалятар	jinɣalʲatar
інданезійскі	jindanʲezʲijskʲi
інданезія	jindanʲezʲija
індывідуалізацыя	jindɨvʲidualʲizatsɨja
індыйскі	jindɨjskʲi
індыя	jindɨja
інстытут	jinstɨtut
інтарэс	jintarɛs
інтэрв'ю	jintɛrvju
інтэрнат	jintɛrnat
інфармацыя	jinfarmatsɨja
інфінітыў	jinfʲinʲitɨu̯
інфляцыя	jinflʲatsɨja
інцэст	jintsɛst
іншаземец	jinʂazʲemʲets
іншы	jinʂɨ
іосіф	jiosʲif
ірак	jirak
іран	jiran
іранец	jiranʲets
іранка	jiranka
іранскі	jiranskʲi
ірваць	jirvatsʲ
іржа	jirʐa
іржавець	jirʐavʲetsʲ
іржавы	jirʐavɨ
іржаць	jirʐatsʲ
іркуцк	jirkutsk
ірландзец	jirɫanʲdzʲets
ірландка	jirɫantka
ірландскі	jirɫantskʲi
ірландыя	jirɫandɨja
ірляндыя	jirlʲandɨja
ірына	jirɨna
ірэна	jirɛna
іскра	jiskra
ісландскі	jisɫantskʲi
ісландыя	jisɫandɨja
існаваць	jisnavatsʲ
існуе	jisnuje
існуём	jisnujom
існуеш	jisnujeʂ
існую	jisnuju
існуюць	jisnujutsʲ
існуяце	jisnujatsʲe
іспанія	jispanʲija
іспанскі	jispanskʲi
істотны	jistotnɨ
ісус	jisus
ісці	jisʲtsʲi
італія	jitalʲija
італьянец	jitalʲjanʲets
італьянка	jitalʲjanka
італьянскі	jitalʲjanskʲi
іх	jix
іхны	jixnɨ
ішак	jiʂak
ішла	jiʂɫa
ішлі	jiʂlʲi
ішло	jiʂɫo
ішоў	jiʂou̯
ішоўшы	jiʂou̯ʂɨ
каб	kap
кабета	kabʲeta
кабура	kabura
кабыла	kabɨɫa
кава	kava
кавадла	kavadɫa
кавай	kavaj
каваю	kavaju
каве	kavʲe
каву	kavu
кавун	kavun
кавуна	kavuna
кавунам	kavunam
кавунах	kavunax
кавуне	kavunʲe
кавуном	kavunom
кавуну	kavunu
кавы	kavɨ
кавярня	kavʲarnʲa
каго	kaɣo
кажан	kaʐan
кажаш	kaʐaʂ
кажу	kaʐu
кажух	kaʐux
каза	kaza
казак	kazak
казахскі	kazaxskʲi
казахстан	kazaxstan
казаць	kazatsʲ
казёл	kazʲoɫ
казімір	kazʲimʲir
казка	kaska
казура	kazura
каланізацыі	kaɫanʲizatsɨji
каланізацыю	kaɫanʲizatsɨju
каланізацыя	kaɫanʲizatsɨja
каланізацыяй	kaɫanʲizatsɨjaj
каланізацыяю	kaɫanʲizatsɨjaju
калаўрот	kaɫau̯rot
калашына	kaɫaʂɨna
калгас	kaɫɣas
калёквіум	kalʲokvʲium
калена	kalʲena
калеснікава	kalʲesʲnʲikava
калеснікаў	kalʲesʲnʲikau̯
калёсы	kalʲosɨ
калі	kalʲi
калідор	kalʲidor
калій	kalʲij
каліноўскі	kalʲinou̯skʲi
калодзеж	kaɫodzʲeʂ
калонія	kaɫonʲija
калоць	kaɫotsʲ
калумбія	kaɫumbʲija
калчан	kaɫtʂan
калыска	kaɫɨska
каля	kalʲa
каляды	kalʲadɨ
каляндар	kalʲandar
каляя	kalʲaja
камандзір	kamanʲdzʲir
камар	kamar
камбоджа	kambodʐa
камень	kamʲenʲ
камета	kamʲeta
каміла	kamʲiɫa
кампанія	kampanʲija
камп'ютар	kampjutar
камп'ютара	kampjutara
камп'ютараў	kampjutarau̯
камп'ютары	kampjutarɨ
камп'ютэр	kampjutɛr
каму	kamu
камунізм	kamunʲizm
канада	kanada
канадскі	kanatskʲi
канапа	kanapa
канапка	kanapka
канверт	kanvʲert
кандрат	kandrat
канец	kanʲets
каноплі	kanoplʲi
кансерватызм	kansʲervatɨzm
канстанцін	kanstanʲtsʲin
канстытуцыя	kanstɨtutsɨja
кантынент	kantɨnʲent
кантычка	kantɨtʂka
канфлікт	kanflʲikt
канцэрт	kantsɛrt
каньяк	kanʲjak
капаць	kapatsʲ
капейка	kapʲejka
капіталізм	kapʲitalʲizm
капіталіст	kapʲitalʲist
капуста	kapusta
капыт	kapɨt
капялюш	kapʲalʲuʂ
кара	kara
карабель	karabʲelʲ
карабельня	karabʲelʲnʲa
каракалпакстан	karakaɫpakstan
каралева	karalʲeva
каралевіч	karalʲevʲitʂ
каралеўна	karalʲeu̯na
каралеўскі	karalʲeu̯skʲi
каралеўства	karalʲeu̯stva
каралі	karalʲi
караліна	karalʲina
каранавірус	karanavʲirus
карандаш	karandaʂ
караць	karatsʲ
кар'ер	karjer
кар'ера	karjera
карл	karɫ
карлік	karlʲik
каробка	karopka
карова	karova
кароль	karolʲ
карона	karona
кароста	karosta
кароткі	karotkʲi
кароўка	karou̯ka
кароўнік	karou̯nʲik
карта	karta
карціна	kartsʲina
карчма	kartʂma
карыслівасць	karɨsʲlʲivasʲtsʲ
карыснасць	karɨsnasʲtsʲ
карысны	karɨsnɨ
карыстальнік	karɨstalʲnʲik
карыстацца	karɨstatsːa
карыта	karɨta
карыца	karɨtsa
карычневы	karɨtʂnʲevɨ
карэйскі	karɛjskʲi
карэспандэнт	karɛspandɛnt
карэя	karɛja
каса	kasa
касаваць	kasavatsʲ
касінер	kasʲinʲer
касір	kasʲir
касірка	kasʲirka
кастрычнік	kastrɨtʂnʲik
кастрычніцкі	kastrɨtʂnʲitskʲi
касцёл	kasʲtsʲoɫ
кат	kat
катаваць	katavatsʲ
каталонскі	kataɫonskʲi
каторы	katorɨ
каўбаса	kau̯basa
каўка	kau̯ka
каўнер	kau̯nʲer
каўтаць	kau̯tatsʲ
каўтун	kau̯tun
кафедра	kafʲedra
кафэ	kafɛ
кахае	kaxaje
кахаем	kaxajem
кахаеце	kaxajetsʲe
кахаеш	kaxajeʂ
каханне	kaxanʲːe
каханнем	kaxanʲːem
каханні	kaxanʲːi
каханню	kaxanʲːu
кахання	kaxanʲːa
кахаць	kaxatsʲ
кахаю	kaxaju
кахаюць	kaxajutsʲ
кацап	katsap
кацапшчына	katsapʂtʂɨna
кацёл	katsʲoɫ
кацяня	katsʲanʲa
кацярына	katsʲarɨna
качарга	katʂarɣa
качка	katʂka
качканос	katʂkanos
каша	kaʂa
кашалёк	kaʂalʲok
кашаль	kaʂalʲ
кашмар	kaʂmar
каштоўнасць	kaʂtou̯nasʲtsʲ
каштоўны	kaʂtou̯nɨ
кашубскі	kaʂupskʲi
кашуля	kaʂulʲa
квадрат	kvadrat
квакусе	kvakusʲe
квакуха	kvakuxa
квакухай	kvakuxaj
квакухаю	kvakuxaju
квакухі	kvakuxʲi
квакуху	kvakuxu
кваліфікацыя	kvalʲifʲikatsɨja
квас	kvas
кватэра	kvatɛra
кветка	kvʲetka
кекс	kʲeks
кёльн	kʲolʲn
кепскі	kʲepskʲi
кетчуп	kʲetːʂup
кідаць	kʲidatsʲ
кіеў	kʲijeu̯
кіеўскі	kʲijeu̯skʲi
кій	kʲij
кілаграм	kʲiɫaɣram
кіламетр	kʲiɫamʲetr
кілім	kʲilʲim
кім	kʲim
кінатэатр	kʲinatɛatr
кіне	kʲinʲe
кінем	kʲinʲem
кінеце	kʲinʲetsʲe
кінеш	kʲinʲeʂ
кінжал	kʲinʐaɫ
кіно	kʲino
кіну	kʲinu
кінуць	kʲinutsʲ
кіньце	kʲinʲtsʲe
кіпрыёт	kʲiprɨjot
кіпрыётка	kʲiprɨjotka
кіраўнік	kʲirau̯nʲik
кіргіскі	kʲirɣʲiskʲi
кіроўца	kʲirou̯tsa
кірыл	kʲirɨɫ
кірыліца	kʲirɨlʲitsa
кісінгер	kʲisʲinɣʲer
кісінджэр	kʲisʲindʐɛr
кісларод	kʲisɫarot
кіслата	kʲisɫata
кіслоты	kʲisɫotɨ
кіслы	kʲisɫɨ
кіт	kʲit
кітаец	kʲitajets
кітай	kʲitaj
кітайскі	kʲitajskʲi
кітаянка	kʲitajanka
кішка	kʲiʂka
кішынёў	kʲiʂɨnʲou̯
кішэнь	kʲiʂɛnʲ
кіяўлянін	kʲijau̯lʲanʲin
клавіятура	kɫavʲijatura
клавіятурай	kɫavʲijaturaj
клавіятураю	kɫavʲijaturaju
клавіятуру	kɫavʲijaturu
клавіятуры	kɫavʲijaturɨ
клайпеда	kɫajpʲeda
класіфікацыя	kɫasʲifʲikatsɨja
класці	kɫasʲtsʲi
класціся	kɫasʲtsʲisʲa
клён	klʲon
клетка	klʲetka
клікаць	klʲikatsʲ
клікнуць	klʲiknutsʲ
клімовіч	klʲimovʲitʂ
клінтух	klʲintux
кліп	klʲip
клітар	klʲitar
клічнік	klʲitʂnʲik
клубніца	kɫubnʲitsa
клубнічны	kɫubnʲitʂnɨ
клуня	kɫunʲa
ключ	klʲutʂ
клясыфікацыя	klʲasɨfʲikatsɨja
кніга	knʲiɣa
кніганоша	knʲiɣanoʂa
кнігаўка	knʲiɣau̯ka
кніжка	knʲiʂka
кнот	knot
князёк	knʲazʲok
князь	knʲasʲ
кобрын	kobrɨn
кожны	koʐnɨ
кола	koɫa
колас	koɫas
коласа	koɫasa
колер	kolʲer
колькасны	kolʲkasnɨ
колькасць	kolʲkasʲtsʲ
колькі	kolʲkʲi
консул	konsuɫ
конь	konʲ
корань	koranʲ
корнскі	kornskʲi
косава	kosava
коска	koska
косць	kosʲtsʲ
кот	kot
коўдра	kou̯dra
кошка	koʂka
кошык	koʂɨk
краб	krap
кравец	kravʲets
краіна	krajina
край	kraj
крайні	krajnʲi
кракадзіл	krakadzʲiɫ
кракаў	krakau̯
крама	krama
крана	krana
кранаць	kranatsʲ
крануць	kranutsʲ
крапіва	krapʲiva
крапіўніцкі	krapʲiu̯nʲitskʲi
красавік	krasavʲik
красавіка	krasavʲika
красавіку	krasavʲiku
красавіцкі	krasavʲitskʲi
краснуха	krasnuxa
красці	krasʲtsʲi
краявід	krajavʲit
кроза	kroza
крок	krok
кропка	kropka
кропля	kroplʲa
крот	krot
кроў	krou̯
кроўю	krou̯ju
круг	krux
круглы	kruɣɫɨ
крупскі	krupskʲi
круты	krutɨ
крывавы	krɨvavɨ
крывёй	krɨvʲoj
крывёю	krɨvʲoju
крыві	krɨvʲi
крывы	krɨvɨ
крыж	krɨʂ
крыжанка	krɨʐanka
крыжмаваць	krɨʐmavatsʲ
крызіс	krɨzʲis
крыло	krɨɫo
крыніца	krɨnʲitsa
крысціна	krɨsʲtsʲina
крыўда	krɨu̯da
крыўдзіць	krɨu̯dzʲitsʲ
крыху	krɨxu
крычаць	krɨtʂatsʲ
крэветка	krɛvʲetka
крэветкі	krɛvʲetkʲi
крэйда	krɛjda
крэйдай	krɛjdaj
крэйдаю	krɛjdaju
крэйдзе	krɛjdzʲe
крэйду	krɛjdu
крэйды	krɛjdɨ
крэмень	krɛmʲenʲ
крэмль	krɛmlʲ
крэпасць	krɛpasʲtsʲ
крэпкі	krɛpkʲi
крэсел	krɛsʲeɫ
крэсла	krɛsɫa
крэслаў	krɛsɫau̯
ксёндз	ksʲonts
ксенія	ksʲenʲija
куба	kuba
кубак	kubak
куды	kudɨ
кудысьці	kudɨsʲtsʲi
кузьма	kuzʲma
куколь	kukolʲ
кулак	kuɫak
культура	kulʲtura
куля	kulʲa
куніца	kunʲitsa
купіць	kupʲitsʲ
купляе	kuplʲaje
купляеш	kuplʲajeʂ
купляй	kuplʲaj
купляйце	kuplʲajtsʲe
купляла	kuplʲaɫa
купляў	kuplʲau̯
купляць	kuplʲatsʲ
купляю	kuplʲaju
курбыка	kurbɨka
курва	kurva
куру	kuru
курыца	kurɨtsa
курыць	kurɨtsʲ
кусаць	kusatsʲ
куст	kust
кустамі	kustamʲi
кустоў	kustou̯
кусце	kusʲtsʲe
кут	kut
куфель	kufʲelʲ
кухня	kuxnʲa
кхмерскі	kxmʲerskʲi
кшталт	kʂtaɫt
кыргызстан	kɨrɣɨsːtan
лавіць	ɫavʲitsʲ
лагапедыя	ɫaɣapʲedɨja
ладан	ɫadan
ладдзя	ɫadzʲːa
лазіць	ɫazʲitsʲ
лайно	ɫajno
лак	ɫak
ламацца	ɫamatsːa
ламаць	ɫamatsʲ
ланцуг	ɫantsux
лаоскі	ɫaoskʲi
лапата	ɫapata
лапаць	ɫapatsʲ
ларыса	ɫarɨsa
ласка	ɫaska
ласось	ɫasosʲ
ластаўка	ɫastau̯ka
латвіец	ɫatvʲijets
латвія	ɫatvʲija
латунь	ɫatunʲ
латушка	ɫatuʂka
латышскі	ɫatɨsːkʲi
лаўка	ɫau̯ka
лаўрэнцій	ɫau̯rɛnʲtsʲij
лацінскі	ɫatsʲinskʲi
лгаць	ɫɣatsʲ
леанід	lʲeanʲit
лебедзь	lʲebʲetsʲ
лебядзіны	lʲebʲadzʲinɨ
левы	lʲevɨ
легітымны	lʲeɣʲitɨmnɨ
лёгкае	lʲoxkaje
лёгкі	lʲoxkʲi
легчы	lʲextʂɨ
лёд	lʲot
ледавік	lʲedavʲik
лёды	lʲodɨ
лезці	lʲesʲtsʲi
лекар	lʲekar
лекарка	lʲekarka
лекі	lʲekʲi
лексікалогія	lʲeksʲikaɫoɣʲija
ленін	lʲenʲin
лепш	lʲepʂ
лепшы	lʲepʂɨ
лес	lʲes
лёс	lʲos
лета	lʲeta
летні	lʲetnʲi
лётнік	lʲotnʲik
лётнішча	lʲotnʲiʂtʂa
летува	lʲetuva
леў	lʲeu̯
лідар	lʲidar
лідзія	lʲidzʲija
лік	lʲik
ліловы	lʲiɫovɨ
лінгвіст	lʲinɣvʲist
ліній	lʲinʲij
лінію	lʲinʲiju
лінія	lʲinʲija
лініям	lʲinʲijam
лініях	lʲinʲijax
ліпа	lʲipa
ліпень	lʲipʲenʲ
ліпеньскі	lʲipʲenʲskʲi
ліса	lʲisa
ліст	lʲist
лістапад	lʲistapat
лістападаўскі	lʲistapadau̯skʲi
літара	lʲitara
літаральны	lʲitaralʲnɨ
літаратура	lʲitaratura
літва	lʲitva
літоўскі	lʲitou̯skʲi
ліўскі	lʲiu̯skʲi
ліфт	lʲift
ліфта	lʲifta
ліфтам	lʲiftam
ліфтах	lʲiftax
ліхі	lʲixʲi
ліхтар	lʲixtar
ліхтаровіч	lʲixtarovʲitʂ
ліхтэнштэйн	lʲixtɛnʂtɛjn
ліць	lʲitsʲ
лічаць	lʲitʂatsʲ
лічба	lʲidʐba
лічу	lʲitʂu
лічы	lʲitʂɨ
лічым	lʲitʂɨm
лічыце	lʲitʂɨtsʲe
лічыць	lʲitʂɨtsʲ
лічыш	lʲitʂɨʂ
лоб	ɫop
лодка	ɫotka
ложак	ɫoʐak
локаць	ɫokatsʲ
локшына	ɫokʂɨna
лондан	ɫondan
лось	ɫosʲ
луг	ɫux
луганск	ɫuɣansk
лужыца	ɫuʐɨtsa
лужыцкі	ɫuʐɨtskʲi
лук	ɫuk
лукашызм	ɫukaʂɨzm
лукашыст	ɫukaʂɨst
лукашэнка	ɫukaʂɛnka
лукашэнкам	ɫukaʂɛnkam
лукашэнкамі	ɫukaʂɛnkamʲi
лукашэнкаў	ɫukaʂɛnkau̯
лукашэнках	ɫukaʂɛnkax
лукашэнкі	ɫukaʂɛnkʲi
лукашэнку	ɫukaʂɛnku
луцк	ɫutsk
лыжка	ɫɨʂka
лысы	ɫɨsɨ
лытка	ɫɨtka
лыч	ɫɨtʂ
лыча	ɫɨtʂa
лычам	ɫɨtʂam
лычамі	ɫɨtʂamʲi
лычах	ɫɨtʂax
лычом	ɫɨtʂom
лычоў	ɫɨtʂou̯
лычу	ɫɨtʂu
лычы	ɫɨtʂɨ
львоў	lʲvou̯
льга	lʲɣa
любві	lʲubvʲi
любі	lʲubʲi
любіла	lʲubʲiɫa
любілі	lʲubʲilʲi
любім	lʲubʲim
любіў	lʲubʲiu̯
любіўшы	lʲubʲiu̯ʂɨ
любіце	lʲubʲitsʲe
любіць	lʲubʲitsʲ
любіш	lʲubʲiʂ
люблін	lʲublʲin
люблю	lʲublʲu
любові	lʲubovʲi
любоў	lʲubou̯
любы	lʲubɨ
любяць	lʲubʲatsʲ
любячы	lʲubʲatʂɨ
людзі	lʲudzʲi
людскі	lʲutskʲi
люксембург	lʲuksʲemburx
люксембургскі	lʲuksʲemburxskʲi
люксэмбург	lʲuksɛmburx
люстэрка	lʲustɛrka
лютаўскі	lʲutau̯skʲi
люты	lʲutɨ
ля	lʲa
лябёдка	lʲabʲotka
лядзяш	lʲadzʲaʂ
ляжаць	lʲaʐatsʲ
лякарня	lʲakarnʲa
лякацца	lʲakatsːa
лялька	lʲalʲka
лямпа	lʲampa
лянівы	lʲanʲivɨ
лятаць	lʲatatsʲ
ляхавічы	lʲaxavʲitʂɨ
ляцець	lʲatsʲetsʲ
мааізм	maajizm
маастрыхт	maastrɨxt
мабільнік	mabʲilʲnʲik
мабыць	mabɨtsʲ
магазін	maɣazʲin
магдалена	maɣdalʲena
магіла	maɣʲiɫa
магілёў	maɣʲilʲou̯
магілёўскі	maɣʲilʲou̯ʲskʲi
магла	maɣɫa
маглі	maɣlʲi
магло	maɣɫo
магній	maɣnʲij
магніт	maɣnʲit
магнітафон	maɣnʲitafon
магу	maɣu
магутны	maɣutnɨ
магчы	maxtʂɨ
магчыма	maxtʂɨma
магчымасць	maxtʂɨmasʲtsʲ
магчымы	maxtʂɨmɨ
мае	maje
маё	majo
маёй	majoj
маёнтак	majontak
маёю	majoju
мажджэр	maʐdʐɛr
мажліва	maʐlʲiva
мажы	maʐɨ
мажыце	maʐɨtsʲe
маз	mas
мазамбік	mazambʲik
маім	majim
маімі	majimʲi
маіх	majix
май	maj
майго	majɣo
майка	majka
майму	majmu
майскі	majskʲi
майстэрня	majstɛrnʲa
майце	majtsʲe
макароншчык	makaronʂtʂɨk
макароншчыца	makaronʂtʂɨtsa
макарэвіч	makarɛvʲitʂ
македонія	makʲedonʲija
македонскі	makʲedonskʲi
макрыца	makrɨtsa
максім	maksʲim
макшанская	makʂanskaja
мала	maɫa
маладзец	maɫadzʲets
маладзік	maɫadzʲik
малады	maɫadɨ
малаец	maɫajets
малайзіец	maɫajzʲijets
малайзійка	maɫajzʲijka
малайзійскі	maɫajzʲijskʲi
малайка	maɫajka
малайскі	maɫajskʲi
малайца	maɫajtsa
малайцам	maɫajtsam
малайцамі	maɫajtsamʲi
малайцаў	maɫajtsau̯
малайцах	maɫajtsax
малайце	maɫajtsʲe
малайцом	maɫajtsom
малайцоў	maɫajtsou̯
малайцу	maɫajtsu
малайцы	maɫajtsɨ
малака	maɫaka
малако	maɫako
малаком	maɫakom
малаку	maɫaku
маланка	maɫanka
малацэ	maɫatsɛ
малдова	maɫdova
маленькі	malʲenʲkʲi
маліна	malʲina
малітва	malʲitva
малітвеннік	malʲitvʲenʲːik
малочны	maɫotʂnɨ
малпа	maɫpa
малпачка	maɫpatʂka
малы	maɫɨ
мальта	malʲta
малюнак	malʲunak
малюю	malʲuju
маляваць	malʲavatsʲ
мама	mama
манака	manaka
манастыр	manastɨr
манах	manax
манголія	manɣolʲija
мангольскі	manɣolʲskʲi
манумент	manumʲent
мапа	mapa
мара	mara
марак	marak
маргарыта	marɣarɨta
марка	marka
маркіз	markʲis
марожанае	maroʐanaje
мароз	maros
марозіва	marozʲiva
марозівам	marozʲivam
марозіве	marozʲivʲe
марозіву	marozʲivu
марока	maroka
марудны	marudnɨ
марыва	marɨva
марына	marɨna
марыя	marɨja
маска	maska
маскат	maskat
масква	maskva
масла	masɫa
маслёнка	masʲlʲonka
мастак	mastak
мастацтва	mastatstva
мастурбаваць	masturbavatsʲ
мастурбацыя	masturbatsɨja
матвей	matvʲej
матор	mator
матылёк	matɨlʲok
матыль	matɨlʲ
матэматыка	matɛmatɨka
маўклівы	mau̯klʲivɨ
маўрыкій	mau̯rɨkʲij
маўчаць	mau̯tʂatsʲ
мацвей	matsʲvʲej
маці	matsʲi
машонка	maʂonka
машына	maʂɨna
маю	maju
мая	maja
маяк	majak
мёд	mʲot
медзь	mʲetsʲ
межаваць	mʲeʐavatsʲ
мексіка	mʲeksʲika
мексіканскі	mʲeksʲikanskʲi
мелкі	mʲeɫkʲi
мельнік	mʲelʲnʲik
менавіта	mʲenavʲita
менск	mʲensk
менструацыя	mʲenstruatsɨja
менш	mʲenʂ
меншасць	mʲenʂasʲtsʲ
меркаванне	mʲerkavanʲːe
мёртвы	mʲortvɨ
месны	mʲesnɨ
места	mʲesta
месца	mʲestsa
месці	mʲesʲtsʲi
месяц	mʲesʲats
метро	mʲetro
мех	mʲex
мець	mʲetsʲ
меч	mʲetʂ
міграцыя	mʲiɣratsɨja
між	mʲiʂ
міжнародны	mʲiʐnarodnɨ
мікалаеў	mʲikaɫajeu̯
мікалай	mʲikaɫaj
мікіта	mʲikʲita
мікрафон	mʲikrafon
міліметр	mʲilʲimʲetr
мілімэтар	mʲilʲimɛtar
міліцыя	mʲilʲitsɨja
мілы	mʲiɫɨ
мільён	mʲilʲjon
мільённы	mʲilʲjonːɨ
мільярд	mʲilʲjart
мільярдны	mʲilʲjardnɨ
міністар	mʲinʲistar
міністр	mʲinʲistr
мінск	mʲinsk
мінскі	mʲinskʲi
мінулае	mʲinuɫaje
мінулы	mʲinuɫɨ
міншчына	mʲinʂtʂɨna
мір	mʲir
мірон	mʲiron
міт	mʲit
мітынг	mʲitɨnx
міф	mʲif
міхаіл	mʲixajiɫ
міцкевіч	mʲitskʲevʲitʂ
млын	mɫɨn
мне	mnʲe
многа	mnoɣa
множны	mnoʐnɨ
мной	mnoj
мною	mnoju
мо	mo
мова	mova
мовазнавец	movaznavʲets
мовазнаўства	movaznau̯stva
мовай	movaj
мовам	movam
мовамі	movamʲi
мовах	movax
моваю	movaju
мове	movʲe
мовіць	movʲitsʲ
мову	movu
мовы	movɨ
мог	mox
могілкі	moɣʲiɫkʲi
могуць	moɣutsʲ
можа	moʐa
можам	moʐam
можаце	moʐatsʲe
можаш	moʐaʂ
можна	moʐna
мозг	mosk
мозг	mosx
мой	moj
мокры	mokrɨ
моладзь	moɫatsʲ
молат	moɫat
момант	momant
мора	mora
морак	morak
морамі	moramʲi
мораў	morau̯
морж	morʂ
морква	morkva
моркву	morkvu
мост	most
моў	mou̯
моўны	mou̯nɨ
моц	mots
моцны	motsnɨ
мрок	mrok
мсціслаў	msʲtsʲisɫau̯
мудры	mudrɨ
муж	muʂ
мужнасць	muʐnasʲtsʲ
мужчын	muʂtʂɨn
мужчына	muʂtʂɨna
мужчынам	muʂtʂɨnam
мужчынамі	muʂtʂɨnamʲi
мужчынах	muʂtʂɨnax
мужчыне	muʂtʂɨnʲe
мужчынскі	muʂtʂɨnskʲi
мужчыну	muʂtʂɨnu
мужчыны	muʂtʂɨnɨ
музыка	muzɨka
музычны	muzɨtʂnɨ
муляр	mulʲar
мур	mur
мурашка	muraʂka
мурашнік	muraʂnʲik
мусіць	musʲitsʲ
мутэрка	mutɛrka
муха	muxa
мушкет	muʂkʲet
мы	mɨ
мые	mɨje
мыем	mɨjem
мыеце	mɨjetsʲe
мыеш	mɨjeʂ
мый	mɨj
мыйце	mɨjtsʲe
мыла	mɨɫa
мылам	mɨɫam
мыле	mɨlʲe
мылу	mɨɫu
мыс	mɨs
мыў	mɨu̯
мыцца	mɨtsːa
мыць	mɨtsʲ
мыш	mɨʂ
мыю	mɨju
мыюць	mɨjutsʲ
мэбля	mɛblʲa
мэлён	mɛlʲon
мэляса	mɛlʲasa
мэнскі	mɛnskʲi
мэта	mɛta
мэтар	mɛtar
мядзведзі	mʲadzʲvʲedzʲi
мядзведзь	mʲadzʲvʲetsʲ
мядзведзю	mʲadzʲvʲedzʲu
мядзведзя	mʲadzʲvʲedzʲa
мяжа	mʲaʐa
мяккі	mʲakʲːi
мяне	mʲanʲe
мянушка	mʲanuʂka
мянчук	mʲantʂuk
мярэжа	mʲarɛʐa
мяса	mʲasa
мясцовы	mʲastsovɨ
мятла	mʲatɫa
мяць	mʲatsʲ
мяч	mʲatʂ
мяшанец	mʲaʂanʲets
мяшок	mʲaʂok
на	na
наадварот	naadvarot
набліжацца	nablʲiʐatsːa
навалачка	navaɫatʂka
навальніца	navalʲnʲitsa
нават	navat
навекі	navʲekʲi
наверсе	navʲersʲe
наверх	navʲerx
навіна	navʲina
навіны	navʲinɨ
навіцкі	navʲitskʲi
навокал	navokaɫ
навошта	navoʂta
навука	navuka
навуковец	navukovʲets
навучу	navutʂu
навучыцца	navutʂɨtsːa
навучыць	navutʂɨtsʲ
навякі	navʲakʲi
нага	naɣa
нагавіцы	naɣavʲitsɨ
нагарода	naɣaroda
нагі	naɣʲi
над	nat
надвае	nadvaje
надвое	nadvoje
надворак	nadvorak
надвор'е	nadvorje
надворка	nadvorka
надворкам	nadvorkam
надворкамі	nadvorkamʲi
надворкаў	nadvorkau̯
надворках	nadvorkax
надворкі	nadvorkʲi
надворку	nadvorku
надзейны	nadzʲejnɨ
надзець	nadzʲetsʲ
надзея	nadzʲeja
надзяваць	nadzʲavatsʲ
надоечы	nadojetʂɨ
нажніцы	naʐnʲitsɨ
нажы	naʐɨ
назад	nazat
назаўсёды	nazau̯sʲodɨ
назаўтра	nazau̯tra
назва	nazva
наздра	nazdra
назоўнік	nazou̯nʲik
назоўны	nazou̯nɨ
найгоршы	najɣorʂɨ
найдзюк	najdzʲuk
найлепшы	najlʲepʂɨ
наймаць	najmatsʲ
наколькі	nakolʲkʲi
наконт	nakont
накрыты	nakrɨtɨ
накрыць	nakrɨtsʲ
налепка	nalʲepka
нам	nam
намер	namʲer
намі	namʲi
намібія	namʲibʲija
наогул	naoɣuɫ
напад	napat
нападаць	napadatsʲ
напарстак	naparstak
напасці	napasʲtsʲi
наперад	napʲerat
наперадзе	napʲeradzʲe
напісаць	napʲisatsʲ
напляваць	naplʲavatsʲ
напой	napoj
напою	napoju
напрыклад	naprɨkɫat
напэўна	napɛu̯na
нара	nara
нарада	narada
нараджэнне	naradʐɛnʲːe
нарадзіць	naradzʲitsʲ
нарвегія	narvʲeɣʲija
нарвежскі	narvʲesːkʲi
нарвэгія	narvɛɣʲija
наркотык	narkotɨk
нармальны	narmalʲnɨ
народ	narot
народзе	narodzʲe
народны	narodnɨ
нарцыс	nartsɨs
нарысаваць	narɨsavatsʲ
нарэшце	narɛsʲtsʲe
нас	nas
насам	nasam
насамі	nasamʲi
насамрэч	nasamrɛtʂ
насарог	nasarox
насах	nasax
насельнік	nasʲelʲnʲik
насельніцтва	nasʲelʲnʲitstva
насенне	nasʲenʲːe
насіць	nasʲitsʲ
насоў	nasou̯
настаўнік	nastau̯nʲik
наступальны	nastupalʲnɨ
наступны	nastupnɨ
наступства	nastupstva
насы	nasɨ
насякомае	nasʲakomaje
наталля	natalʲːa
натоўп	natou̯p
натхнення	natxnʲenʲːa
наўмысны	nau̯mɨsnɨ
націск	natsʲisk
нацызм	natsɨzm
нацыяналізм	natsɨjanalʲizm
начаваць	natʂavatsʲ
начарціць	natʂartsʲitsʲ
начлег	natʂlʲex
наш	naʂ
наша	naʂa
нашча	naʂtʂa
нашчадак	naʂtʂadak
наяўны	najau̯nɨ
не	nʲa
не	nʲe
неабвержны	nʲeabvʲerʐnɨ
неабходны	nʲeapxodnɨ
неадкладны	nʲeatkɫadnɨ
неба	nʲeba
нёба	nʲoba
небаскроб	nʲebaskrop
небасяг	nʲebasʲax
небяспека	nʲebʲasʲpʲeka
небяспечны	nʲebʲasʲpʲetʂnɨ
невымоўны	nʲevɨmou̯nɨ
недастатковы	nʲedastatkovɨ
недахоп	nʲedaxop
незалежна	nʲezalʲeʐna
незалежнасць	nʲezalʲeʐnasʲtsʲ
незалежны	nʲezalʲeʐnɨ
незаменны	nʲezamʲenːɨ
незвычайны	nʲezvɨtʂajnɨ
незнаёмец	nʲeznajomʲets
нейкі	nʲejkʲi
нейтралізацыя	nʲejtralʲizatsɨja
некалькім	nʲekalʲkʲim
некалькімі	nʲekalʲkʲimʲi
некалькіх	nʲekalʲkʲix
некаторы	nʲekatorɨ
нельга	nʲelʲɣa
нёман	nʲoman
немаўля	nʲemau̯lʲa
немец	nʲemʲets
немка	nʲemka
ненавідзець	nʲenavʲidzʲetsʲ
ненадзейны	nʲenadzʲejnɨ
непазбежны	nʲepazʲbʲeʐnɨ
непал	nʲepaɫ
непаслушэнства	nʲepasɫuʂɛnstva
непасрэдны	nʲepasrɛdnɨ
непасціжны	nʲepasʲtsʲiʐnɨ
нептун	nʲeptun
нерв	nʲerv
несці	nʲesʲtsʲi
нетапыр	nʲetapɨr
неўдах	nʲeu̯dax
нехта	nʲexta
нецярплівы	nʲetsʲarplʲivɨ
нешта	nʲeʂta
ніадкуль	nʲiatkulʲ
нібы	nʲibɨ
ніва	nʲiva
нідзе	nʲidzʲe
нідэрланды	nʲidɛrɫandɨ
нідэрлянды	nʲidɛrlʲandɨ
ніж	nʲiʂ
ніжнелужыцкі	nʲiʐnʲeɫuʐɨtskʲi
ніжні	nʲiʐnʲi
ніз	nʲis
ніза	nʲiza
нізам	nʲizam
нізкі	nʲiskʲi
нікарагуа	nʲikaraɣua
нікіфарэнка	nʲikʲifarɛnka
ніколі	nʲikolʲi
нікуды	nʲikudɨ
ніна	nʲina
ніхто	nʲixto
ніць	nʲitsʲ
нішто	nʲiʂto
ніякі	nʲijakʲi
новага	novaɣa
новае	novaje
новай	novaj
новаму	novamu
нованабыты	novanabɨtɨ
новаю	novaju
новая	novaja
новік	novʲik
новую	novuju
новы	novɨ
новым	novɨm
новымі	novɨmʲi
новых	novɨx
новыя	novɨja
ногаць	noɣatsʲ
нож	noʂ
ноздра	nozdra
нораў	norau̯
нос	nos
носа	nosa
носам	nosam
носе	nosʲe
носу	nosu
носы	nosɨ
носьбіт	nozʲbʲit
ноўтбук	nou̯dbuk
ноч	notʂ
ну	nu
нулёў	nulʲou̯
нулі	nulʲi
нуль	nulʲ
нулявы	nulʲavɨ
нулямі	nulʲamʲi
нумар	numar
нырка	nɨrka
нюанс	nʲuans
нюх	nʲux
нюхаць	nʲuxatsʲ
ня	nʲa
нябачны	nʲabatʂnɨ
нявінны	nʲavʲinːɨ
нядзелі	nʲadzʲelʲi
нядзеля	nʲadzʲelʲa
нядоўга	nʲadou̯ɣa
нязграбны	nʲazgrabnɨ
няма	nʲama
нямецкі	nʲamʲetskʲi
нямеччына	nʲamʲetʂːɨna
нямнога	nʲamnoɣa
нямы	nʲamɨ
нянавісць	nʲanavʲisʲtsʲ
няроўнасць	nʲarou̯nasʲtsʲ
няўжо	nʲau̯ʐo
няўхільны	nʲau̯xʲilʲnɨ
няхай	nʲaxaj
нячутны	nʲatʂutnɨ
няшмат	nʲaʂmat
няшчасце	nʲaʂtʂasʲtsʲe
опера	opʲera
опіум	opʲium
осла	osɫa
офіс	ofʲis
па	pa
паабедаць	paabʲedatsʲ
пабачэнне	pabatʂɛnʲːe
пабегаць	pabʲeɣatsʲ
пабіць	pabʲitsʲ
пабудаваць	pabudavatsʲ
павадзіць	pavadzʲitsʲ
павазіць	pavazʲitsʲ
паведаміць	pavʲedamʲitsʲ
паведамляе	pavʲedamlʲaje
паведамляць	pavʲedamlʲatsʲ
павезці	pavʲesʲtsʲi
павека	pavʲeka
павел	pavʲeɫ
паверх	pavʲerx
паверыць	pavʲerɨtsʲ
павесці	pavʲesʲtsʲi
павет	pavʲet
паветра	pavʲetra
павешаць	pavʲeʂatsʲ
павінен	pavʲinʲen
павіншаваць	pavʲinʂavatsʲ
павісець	pavʲisʲetsʲ
паводзіны	pavodzʲinɨ
павольны	pavolʲnɨ
павук	pavuk
павуціна	pavutsʲina
павячэраць	pavʲatʂɛratsʲ
пагаварыць	paɣavarɨtsʲ
пагадненне	paɣadnʲenʲːe
паганы	paɣanɨ
паганяць	paɣanʲatsʲ
пагарда	paɣarda
пагарджаць	paɣardʐatsʲ
пагардлівы	paɣardlʲivɨ
пагаршаць	paɣarʂatsʲ
паглынаць	paɣɫɨnatsʲ
паглынуць	paɣɫɨnutsʲ
паглядзець	paɣlʲadzʲetsʲ
пагнаць	paɣnatsʲ
пагода	paɣoda
пагодаю	paɣodaju
пагоду	paɣodu
пагоды	paɣodɨ
пагорак	paɣorak
пагоршыць	paɣorʂɨtsʲ
пагроза	paɣroza
пад	pat
падабаемся	padabajemsʲa
падабаецеся	padabajetsʲesʲa
падабаецца	padabajetsːa
падабаешся	padabajesʲːa
падабайка	padabajka
падабайся	padabajsʲa
падабайцеся	padabajtsʲesʲa
падабалася	padabaɫasʲa
падабаліся	padabalʲisʲa
падабаўся	padabau̯sʲa
падабацца	padabatsːa
падабаюся	padabajusʲa
падабаюцца	padabajutsːa
падаконнік	padakonʲːik
падарожжа	padaroʐːa
падарожнічае	padaroʐnʲitʂaje
падарожнічаеш	padaroʐnʲitʂajeʂ
падарожнічаць	padaroʐnʲitʂatsʲ
падарожнічаю	padaroʐnʲitʂaju
падарунак	padarunak
падарыць	padarɨtsʲ
падатак	padatak
падаць	padatsʲ
падбародак	padbarodak
падвал	padvaɫ
падвода	padvoda
падзейнічаць	padzʲejnʲitʂatsʲ
падзея	padzʲeja
падзяліцца	padzʲalʲitsːa
падкова	patkova
падлетак	padlʲetak
падлога	padɫoɣa
паднімаць	padnʲimatsʲ
паднябенне	padnʲabʲenʲːe
падняць	padnʲatsʲ
падобны	padobnɨ
падпаха	patpaxa
падпісаць	patpʲisatsʲ
падручнік	padrutʂnʲik
падсітак	patsʲsʲitak
падтрымаць	patːrɨmatsʲ
падтрымліваць	patːrɨmlʲivatsʲ
падтрымліваю	patːrɨmlʲivaju
падчас	patːʂas
паездзіць	pajezdzʲitsʲ
паехаць	pajexatsʲ
пажадаць	paʐadatsʲ
пажар	paʐar
пажарышча	paʐarɨʂtʂa
пазаўчора	pazau̯tʂora
пазваніць	pazvanʲitsʲ
пазваць	pazvatsʲ
пазнаёміць	paznajomʲitsʲ
пазначаць	paznatʂatsʲ
пазначыць	paznatʂɨtsʲ
пазногаць	paznoɣatsʲ
пазычаць	pazɨtʂatsʲ
пазычыць	pazɨtʂɨtsʲ
паіць	pajitsʲ
пайду	pajdu
пайсці	pajsʲtsʲi
пакажа	pakaʐa
пакажам	pakaʐam
пакажаце	pakaʐatsʲe
пакажаш	pakaʐaʂ
пакажу	pakaʐu
пакажуць	pakaʐutsʲ
пакажы	pakaʐɨ
пакажыце	pakaʐɨtsʲe
паказала	pakazaɫa
паказалі	pakazalʲi
паказаны	pakazanɨ
паказаў	pakazau̯
паказаўшы	pakazau̯ʂɨ
паказаць	pakazatsʲ
паказваць	pakazvatsʲ
пакет	pakʲet
пакідаць	pakʲidatsʲ
пакінуць	pakʲinutsʲ
пакістан	pakʲistan
пакласці	pakɫasʲtsʲi
пакой	pakoj
пакорлівы	pakorlʲivɨ
пакрываць	pakrɨvatsʲ
пакуль	pakulʲ
пакупка	pakupka
пакупнік	pakupnʲik
пакурыць	pakurɨtsʲ
пакута	pakuta
палазіць	paɫazʲitsʲ
паласа	paɫasa
палатно	paɫatno
палахлівы	paɫaxlʲivɨ
палац	paɫats
палезці	palʲesʲtsʲi
палена	palʲena
палепшыць	palʲepʂɨtsʲ
палессе	palʲesʲːe
палестына	palʲestɨna
палец	palʲets
паліна	palʲina
палітзняволены	palʲidzʲzʲnʲavolʲenɨ
палітолаг	palʲitoɫax
палітыка	palʲitɨka
паліца	palʲitsa
паліцай	palʲitsaj
паліцыя	palʲitsɨja
паліць	palʲitsʲ
палічыць	palʲitʂɨtsʲ
палка	paɫka
палова	paɫova
палову	paɫovu
палон	paɫon
палохацца	paɫoxatsːa
пальцамі	palʲtsamʲi
пальцаў	palʲtsau̯
пальчатка	palʲtʂatka
паляваць	palʲavatsʲ
паляк	palʲak
паляпшаць	palʲapʂatsʲ
паляўніцтвазнаўства	palʲau̯nʲitstvaznau̯stva
паляўнічы	palʲau̯nʲitʂɨ
палячка	palʲatʂka
памагаць	pamaɣatsʲ
памагчы	pamaxtʂɨ
памер	pamʲer
памідор	pamʲidor
паміж	pamʲiʂ
памінаць	pamʲinatsʲ
паміраць	pamʲiratsʲ
памочнік	pamotʂnʲik
памыліцца	pamɨlʲitsːa
памылка	pamɨɫka
памыляцца	pamɨlʲatsːa
памыляюся	pamɨlʲajusʲa
памыцца	pamɨtsːa
памыць	pamɨtsʲ
памянуць	pamʲanutsʲ
памятаеш	pamʲatajeʂ
памятаць	pamʲatatsʲ
памятаю	pamʲataju
памяць	pamʲatsʲ
памяшканне	pamʲaʂkanʲːe
памяшканнем	pamʲaʂkanʲːem
памяшканні	pamʲaʂkanʲːi
памяшканню	pamʲaʂkanʲːu
памяшкання	pamʲaʂkanʲːa
памяшканням	pamʲaʂkanʲːam
памяшканнямі	pamʲaʂkanʲːamʲi
памяшканняў	pamʲaʂkanʲːau̯
памяшканнях	pamʲaʂkanʲːax
пан	pan
панама	panama
панасіць	panasʲitsʲ
пандэмія	pandɛmʲija
панесці	panʲesʲtsʲi
пані	panʲi
панславізм	pansɫavʲizm
панчоха	pantʂoxa
панядзелак	panʲadzʲeɫak
папера	papʲera
паплаваць	papɫavatsʲ
паплыць	papɫɨtsʲ
папрасіць	paprasʲitsʲ
папугай	papuɣaj
папярэдні	papʲarɛdnʲi
парагвай	paraɣvaj
парада	parada
парадак	paradak
паражэнне	paraʐɛnʲːe
паралон	paraɫon
парасон	parason
паратыт	paratɨt
параўнанне	parau̯nanʲːe
параўнаць	parau̯natsʲ
парафія	parafʲija
параход	paraxot
парк	park
парнаграфічны	parnaɣrafʲitʂnɨ
парнаграфія	parnaɣrafʲija
парог	parox
парожні	paroʐnʲi
парой	paroj
парою	paroju
парсюк	parsʲuk
партрэт	partrɛt
партугалія	partuɣalʲija
партугальскі	partuɣalʲskʲi
партфель	partfʲelʲ
партфэль	partfɛlʲ
партызан	partɨzan
партыя	partɨja
парушэнне	paruʂɛnʲːe
парыж	parɨʂ
парыжскі	parɨsːkʲi
парык	parɨk
парэнча	parɛntʂa
парэчка	parɛtʂka
пас	pas
пасад	pasat
пасведчанне	pasʲvʲetːʂanʲːe
паскарацца	paskaratsːa
паскараць	paskaratsʲ
паскарэнне	paskarɛnʲːe
паскорыцца	paskorɨtsːa
паскорыць	paskorɨtsʲ
паслухаць	pasɫuxatsʲ
паслухаю	pasɫuxaju
паслухмяны	pasɫuxmʲanɨ
паслушны	pasɫuʂnɨ
паслушэнства	pasɫuʂɛnstva
пасля	pasʲlʲa
пасол	pasoɫ
паспрабаваць	pasprabavatsʲ
паспрачацца	paspratʂatsːa
паспрыяць	pasprɨjatsʲ
пасрэдны	pasrɛdnɨ
паставіць	pastavʲitsʲ
пастаянна	pastajanːa
пастаяць	pastajatsʲ
паступаць	pastupatsʲ
паступіць	pastupʲitsʲ
пасці	pasʲtsʲi
пасылаць	pasɨɫatsʲ
пасьянс	pasʲjans
пасьянсамі	pasʲjansamʲi
пасьянсаў	pasʲjansau̯
пасябраваць	pasʲabravatsʲ
патака	pataka
паток	patok
патрабаваць	patrabavatsʲ
патрыятызм	patrɨjatɨzm
патрыятызма	patrɨjatɨzma
патрыятызмам	patrɨjatɨzmam
патрыятызмамі	patrɨjatɨzmamʲi
патрыятызмаў	patrɨjatɨzmau̯
патрыятызмах	patrɨjatɨzmax
патрыятызме	patrɨjatɨzmʲe
патрыятызму	patrɨjatɨzmu
патрыятызмы	patrɨjatɨzmɨ
патрэбен	patrɛbʲen
патрэбна	patrɛbna
патрэбны	patrɛbnɨ
патыліца	patɨlʲitsa
патэльня	patɛlʲnʲa
паўаўтамат	pawau̯tamat
паўвостраў	pau̯vostrau̯
паўднёвы	pau̯dnʲovɨ
паўзці	pau̯sʲtsʲi
паўночны	pau̯notʂnɨ
паўстанне	pau̯stanʲːe
паўтара	pau̯tara
паўтараць	pau̯taratsʲ
паўтарыць	pau̯tarɨtsʲ
пафарбаваць	pafarbavatsʲ
пах	pax
пахаванне	paxavanʲːe
пахадзіць	paxadzʲitsʲ
пахнуць	paxnutsʲ
паходня	paxodnʲa
пацалаваць	patsaɫavatsʲ
пацалунак	patsaɫunak
пацук	patsuk
пачакаць	patʂakatsʲ
пачастунак	patʂastunak
пачатак	patʂatak
пачацца	patʂatsːa
пачаць	patʂatsʲ
пачварны	patʂvarnɨ
пачуццё	patʂutsʲːo
пачуць	patʂutsʲ
пачынацца	patʂɨnatsːa
пачынаць	patʂɨnatsʲ
пачысціць	patʂɨsʲtsʲitsʲ
пашпарт	paʂpart
паштэт	paʂtɛt
паэзія	paɛzʲija
паэт	paɛt
паэта	paɛta
певень	pʲevʲenʲ
педагогіка	pʲedaɣoɣʲika
п'едэстал	pjedɛstaɫ
пекар	pʲekar
пекарка	pʲekarka
пекін	pʲekʲin
пекла	pʲekɫa
пельмень	pʲelʲmʲenʲ
пеніс	pʲenʲis
пенсільванія	pʲensʲilʲvanʲija
пень	pʲenʲ
пераапранацца	pʲeraapranatsːa
перавага	pʲeravaɣa
пераважна	pʲeravaʐna
перагаварыць	pʲeraɣavarɨtsʲ
перад	pʲerat
перадаваць	pʲeradavatsʲ
перадапошні	pʲeradapoʂnʲi
перадаць	pʲeradatsʲ
перажываць	pʲeraʐɨvatsʲ
перажыць	pʲeraʐɨtsʲ
пераклад	pʲerakɫat
перакладаць	pʲerakɫadatsʲ
перакладчык	pʲerakɫatːʂɨk
перакладчыца	pʲerakɫatːʂɨtsa
перамагаць	pʲeramaɣatsʲ
перамагчы	pʲeramaxtʂɨ
перамір'е	pʲeramʲirje
перамовы	pʲeramovɨ
перамога	pʲeramoɣa
перамяшчэнне	pʲeramʲaʂtʂɛnʲːe
пераначаваць	pʲeranatʂavatsʲ
перасаджвацца	pʲerasadʐvatsːa
ператрус	pʲeratrus
перац	pʲerats
пераязджаць	pʲerajaʐdʐatsʲ
персідскі	pʲersʲitskʲi
персік	pʲersʲik
персцень	pʲersʲtsʲenʲ
перу	pʲeru
першамучанік	pʲerʂamutʂanʲik
першамучаніца	pʲerʂamutʂanʲitsa
першы	pʲerʂɨ
перыяд	pʲerɨjat
пёс	pʲos
песня	pʲesʲnʲa
пётр	pʲotr
пеўню	pʲevʲenʲ
печ	pʲetʂ
печань	pʲetʂanʲ
печка	pʲetʂka
пешка	pʲeʂka
піва	pʲiva
півавар	pʲivavar
піваварка	pʲivavarka
півоня	pʲivonʲa
пізда	pʲizda
піла	pʲiɫa
пільны	pʲilʲnɨ
пінгвін	pʲinɣvʲin
пінск	pʲinsk
пірог	pʲirox
пісаць	pʲisatsʲ
піскулька	pʲiskulʲka
пісталет	pʲistalʲet
пісьменнік	pʲisʲmʲenʲːik
пісьменніца	pʲisʲmʲenʲːitsa
пісьмо	pʲisʲmo
піў	pʲiu̯
піца	pʲitsa
піццё	pʲitsʲːo
піць	pʲitsʲ
плаваць	pɫavatsʲ
плагіят	pɫaɣʲijat
плакаць	pɫakatsʲ
плакса	pɫaksa
план	pɫan
планаванне	pɫanavanʲːe
планета	pɫanʲeta
планшэт	pɫanʂɛt
платформа	pɫatforma
плаціна	pɫatsʲina
плаціць	pɫatsʲitsʲ
племя	plʲemʲa
плён	plʲon
плесці	plʲesʲtsʲi
плод	pɫot
плоскі	pɫoskʲi
плошча	pɫoʂtʂa
плуг	pɫux
плысці	pɫɨsʲtsʲi
плыць	pɫɨtsʲ
пляваць	plʲavatsʲ
пляж	plʲaʂ
пляменнік	plʲamʲenʲːik
пляменніца	plʲamʲenʲːitsa
плян	plʲan
плянаваньне	plʲanavanʲːe
плячо	plʲatʂo
побач	pobatʂ
поезд	pojest
позна	pozna
познань	poznanʲ
позні	pozʲnʲi
пойдзеш	pojdzʲeʂ
пол	poɫ
полаз	poɫas
полацак	poɫatsak
полацк	poɫatsk
поле	polʲe
полы	poɫɨ
полымны	poɫɨmnɨ
полымя	poɫɨmʲa
полька	polʲka
польскі	polʲskʲi
польшча	polʲʂtʂa
помнік	pomnʲik
помніць	pomnʲitsʲ
помста	pomsta
пончык	pontʂɨk
поп	pop
попел	popʲeɫ
попельніца	popʲelʲnʲitsa
порах	porax
порт	port
поспех	pospʲex
пот	pot
поўдзень	pou̯dzʲenʲ
поўнасцю	pou̯nasʲtsʲu
поўнач	pou̯natʂ
поўны	pou̯nɨ
похва	poxva
почырк	potʂɨrk
пошта	poʂta
пошук	poʂuk
пояс	pojas
пра	pra
прабабуля	prababulʲa
прабачэнне	prabatʂɛnʲːe
праблема	prablʲema
права	prava
правадыр	pravadɨr
правапіс	pravapʲis
праведны	pravʲednɨ
правесці	pravʲesʲtsʲi
правіла	pravʲiɫa
правільна	pravʲilʲna
правільны	pravʲilʲnɨ
правіцель	pravʲitsʲelʲ
правы	pravɨ
прага	praɣa
праграма	praɣrama
праграмны	praɣramnɨ
прадаваць	pradavatsʲ
прадаць	pradatsʲ
прадзед	pradzʲet
прадмет	pradmʲet
прадмета	pradmʲeta
прадпрыемства	pratprɨjemstva
прадстаўнік	pratstau̯nʲik
прадукт	pradukt
праект	prajekt
пража	praʐa
праз	pras
празрысты	prazrɨstɨ
прайдзісвет	prajdzʲisʲvʲet
праймаць	prajmatsʲ
прайсці	prajsʲtsʲi
пракофій	prakofʲij
прамень	pramʲenʲ
прамоўца	pramou̯tsa
прамы	pramɨ
прамысловасць	pramɨsɫovasʲtsʲ
праніклівы	pranʲiklʲivɨ
прапанавала	prapanavaɫa
прапанавалі	prapanavalʲi
прапанаваў	prapanavau̯
прапанаваць	prapanavatsʲ
прапанова	prapanova
прапановай	prapanovaj
прапановам	prapanovam
прапановамі	prapanovamʲi
прапановах	prapanovax
прапановаю	prapanovaju
прапанове	prapanovʲe
прапанову	prapanovu
прапановы	prapanovɨ
прапаноў	prapanou̯
прапануе	prapanuje
прапануем	prapanujem
прапануеце	prapanujetsʲe
прапануеш	prapanujeʂ
прапануй	prapanuj
прапануйце	prapanujtsʲe
прапаную	prapanuju
прапануюць	prapanujutsʲ
прас	pras
прасіць	prasʲitsʲ
праславянскі	prasɫavʲanskʲi
праспект	praspʲekt
прастата	prastata
прастол	prastoɫ
прастора	prastora
прастытутка	prastɨtutka
пратасевіч	pratasʲevʲitʂ
праўда	prau̯da
праўдашукальнік	prau̯daʂukalʲnʲik
прафесіі	prafʲesʲiji
прафесій	prafʲesʲij
прафесію	prafʲesʲiju
прафесія	prafʲesʲija
прафесіяй	prafʲesʲijaj
прафесіям	prafʲesʲijam
прафесіямі	prafʲesʲijamʲi
прафесіях	prafʲesʲijax
праца	pratsa
працаваць	pratsavatsʲ
працаўнік	pratsau̯nʲik
працоўны	pratsou̯nɨ
праць	pratsʲ
працэс	pratsɛs
працэсам	pratsɛsam
працэсамі	pratsɛsamʲi
працэсаў	pratsɛsau̯
працэсах	pratsɛsax
працэсе	pratsɛsʲe
працэсу	pratsɛsu
працэсы	pratsɛsɨ
прачнуцца	pratʂnutsːa
прачынацца	pratʂɨnatsːa
прачытаць	pratʂɨtatsʲ
прашчур	praʂtʂur
продак	prodak
проза	proza
прозвішча	prozʲvʲiʂtʂa
проса	prosa
просам	prosam
просты	prostɨ
проціяддзе	protsʲijadzʲːe
пружаны	pruʐanɨ
пруткі	prutkʲi
пры	prɨ
прыватнасць	prɨvatnasʲtsʲ
прыватны	prɨvatnɨ
прывет	prɨvʲet
прывід	prɨvʲit
прывітанне	prɨvʲitanʲːe
прывітаць	prɨvʲitatsʲ
прывозіць	prɨvozʲitsʲ
прыгажосці	prɨɣaʐosʲtsʲi
прыгажосць	prɨɣaʐosʲtsʲ
прыгажосцю	prɨɣaʐosʲtsʲu
прыгажун	prɨɣaʐun
прыгажуня	prɨɣaʐunʲa
прыгнёт	prɨɣnʲot
прыгода	prɨɣoda
прыгожы	prɨɣoʐɨ
прыдатны	prɨdatnɨ
прыехаць	prɨjexatsʲ
прызыў	prɨzɨu̯
прызямленне	prɨzʲamlʲenʲːe
прыйсці	prɨjsʲtsʲi
прыказка	prɨkaska
прыклад	prɨkɫat
прылада	prɨɫada
прымаць	prɨmatsʲ
прыметнік	prɨmʲetnʲik
прыназоўнік	prɨnazou̯nʲik
прынамсі	prɨnamsʲi
прынесці	prɨnʲesʲtsʲi
прыносіць	prɨnosʲitsʲ
прынтар	prɨntar
прыняць	prɨnʲatsʲ
прыпынак	prɨpɨnak
прыпяць	prɨpʲatsʲ
прырода	prɨroda
прыродны	prɨrodnɨ
прысабечыць	prɨsabʲetʂɨtsʲ
прысады	prɨsadɨ
прыслоўе	prɨsɫou̯je
прыстасаванне	prɨstasavanʲːe
прысутнасць	prɨsutnasʲtsʲ
прысутны	prɨsutnɨ
прысяга	prɨsʲaɣa
прытулак	prɨtuɫak
прыходзіць	prɨxodzʲitsʲ
прычына	prɨtʂɨna
прыязджаць	prɨjaʐdʐatsʲ
прыяцель	prɨjatsʲelʲ
прэзідэнт	prɛzʲidɛnt
прэстыжны	prɛstɨʐnɨ
птушка	ptuʂka
публіка	publʲika
пуга	puɣa
пудзіла	pudzʲiɫa
пуп	pup
пупышка	pupɨʂka
пурпурны	purpurnɨ
пустка	pustka
пусты	pustɨ
пустыня	pustɨnʲa
пустэльнік	pustɛlʲnʲik
пустэльня	pustɛlʲnʲa
пута	puta
путы	putɨ
пуце	putsʲe
пуцін	putsʲin
пуць	putsʲ
пчала	ptʂaɫa
пшаніца	pʂanʲitsa
пыл	pɨɫ
пыласос	pɨɫasos
пытальнік	pɨtalʲnʲik
пытанне	pɨtanʲːe
пытання	pɨtanʲːa
пытацца	pɨtatsːa
пытаць	pɨtatsʲ
пэндзаль	pɛndzalʲ
пэўнасць	pɛu̯nasʲtsʲ
пэўны	pɛu̯nɨ
пякарня	pʲakarnʲa
пяльмень	pʲalʲmʲenʲ
п'яны	pjanɨ
пярдзець	pʲardzʲetsʲ
пяро	pʲaro
пярсцёнак	pʲarsʲtsʲonak
пярэсты	pʲarɛstɨ
пясок	pʲasok
пятка	pʲatka
пятля	pʲatlʲa
пятнаццаты	pʲatnatsːatɨ
пятнаццаць	pʲatnatsːatsʲ
пятніца	pʲatnʲitsa
пятніцы	pʲatnʲitsɨ
пятро	pʲatro
пяты	pʲatɨ
п'яўка	pjau̯ka
пяцёра	pʲatsʲora
пяці	pʲatsʲi
пяцідзесяты	pʲatsʲidzʲasʲatɨ
пяцісоты	pʲatsʲisotɨ
пяццю	pʲatsʲːu
пяць	pʲatsʲ
пяцьдзесят	pʲadzʲːesʲat
пяцьсот	pʲatsʲsot
пячаць	pʲatʂatsʲ
пячоначны	pʲatʂonatʂnɨ
пячора	pʲatʂora
пячы	pʲatʂɨ
пяшчота	pʲaʂtʂota
пяшчотны	pʲaʂtʂotnɨ
раб	rap
рабёнак	rabʲonak
рабі	rabʲi
рабіла	rabʲiɫa
рабілі	rabʲilʲi
рабіў	rabʲiu̯
рабіце	rabʲitsʲe
рабіць	rabʲitsʲ
раблю	rablʲu
работнік	rabotnʲik
рабро	rabro
рабяты	rabʲatɨ
рагуля	raɣulʲa
рад	rat
радасны	radasnɨ
радасць	radasʲtsʲ
раджацца	radʐatsːa
раджу	radʐu
радзівон	radzʲivon
радзіма	radzʲima
радзіна	radzʲina
радзіцца	radzʲitsːa
радзіць	radzʲitsʲ
радкевіч	ratkʲevʲitʂ
радыё	radɨjo
радыёабсталяванне	radɨjoapstalʲavanʲːe
радыёвежа	radɨjovʲeʐa
радыёвузел	radɨjovuzʲeɫ
радыёвяшчанне	radɨjovʲaʂtʂanʲːe
радыёлакатар	radɨjoɫakatar
радыёстанцыя	radɨjostantsɨja
радыёсувязь	radɨjosuvʲasʲ
радыёхімія	radɨjoxʲimʲija
радыёцэнтр	radɨjotsɛntr
радыкалізм	radɨkalʲizm
раён	rajon
раз	ras
разам	razam
разбівацца	razʲbʲivatsːa
разбіваць	razʲbʲivatsʲ
разбіцца	razʲbʲitsːa
разбіць	razbʲitsʲ
разбурэнне	razburɛnʲːe
раздзел	razdzʲeɫ
разлік	razʲlʲik
размаўляць	razmau̯lʲatsʲ
размова	razmova
размовіць	razmovʲitsʲ
разумець	razumʲetsʲ
разумны	razumnɨ
раз'юшаны	razʲjuʂanɨ
раз'юшваць	razʲjuʂvatsʲ
раіса	rajisa
раіць	rajitsʲ
рай	raj
рак	rak
рака	raka
ракета	rakʲeta
рала	raɫa
раман	raman
раманчук	ramantʂuk
рамеснік	ramʲesʲnʲik
рамяство	ramʲastvo
рана	rana
раней	ranʲej
раніца	ranʲitsa
ранні	ranʲːi
раптам	raptam
раптоўны	raptou̯nɨ
рапуха	rapuxa
раса	rasa
расамаха	rasamaxa
расеец	rasʲejets
расейскі	rasʲejskʲi
расея	rasʲeja
расізм	rasʲizm
расійскі	rasʲijskʲi
расія	rasʲija
расіянін	rasʲijanʲin
расіянка	rasʲijanka
расказаны	raskazanɨ
расказаць	raskazatsʲ
расклад	raskɫat
раскоша	raskoʂa
расліна	rasʲlʲina
распавядаць	raspavʲadatsʲ
распаўсюджванне	raspau̯sʲudʐvanʲːe
распаўсюджвання	raspau̯sʲudʐvanʲːa
расплюшчу	rasplʲuʂtʂu
расплюшчым	rasplʲuʂtʂɨm
расплюшчыць	rasplʲuʂtʂɨtsʲ
расплюшчыш	rasplʲuʂtʂɨʂ
рассеяны	rasʲːejanɨ
растлумачу	rastɫumatʂu
растлумачыць	rastɫumatʂɨtsʲ
расці	rasʲtsʲi
расціслаў	rasʲtsʲisɫau̯
расчараваць	raʂtʂaravatsʲ
расчосак	raʂtʂosak
расчоска	raʂtʂoska
расчоскай	raʂtʂoskaj
расчоскам	raʂtʂoskam
расчосках	raʂtʂoskax
расчоскаю	raʂtʂoskaju
расчоскі	raʂtʂoskʲi
расчоску	raʂtʂosku
расчосцы	raʂtʂostsɨ
расьліна	rasʲlʲina
расяны	rasʲanɨ
ратавала	ratavaɫa
ратавалі	ratavalʲi
ратаваў	ratavau̯
ратаваць	ratavatsʲ
ратую	ratuju
ратуюць	ratujutsʲ
раўнівы	rau̯nʲivɨ
раўці	rau̯tsʲi
рахавала	raxavaɫa
рахаваў	raxavau̯
рахаваць	raxavatsʲ
рахуе	raxuje
рахуй	raxuj
рахунак	raxunak
рахунка	raxunka
рахую	raxuju
рашаць	raʂatsʲ
рашыць	raʂɨtsʲ
рашэнне	raʂɛnʲːe
рваць	rvatsʲ
ржаць	rʐatsʲ
робат	robat
робім	robʲim
робіце	robʲitsʲe
робіць	robʲitsʲ
робіш	robʲiʂ
робяць	robʲatsʲ
ровар	rovar
рог	rox
род	rot
родны	rodnɨ
розніца	rozʲnʲitsa
розны	roznɨ
розум	rozum
розуму	rozumu
рок	rok
ром	rom
росны	rosnɨ
рот	rot
роў	rou̯
роўнабочны	rou̯nabotʂnɨ
роўны	rou̯nɨ
ртуць	rtutsʲ
руанда	ruanda
рубель	rubʲelʲ
ружанец	ruʐanʲets
ружовашчокі	ruʐovaʂtʂokʲi
ружовы	ruʐovɨ
руйнаваць	rujnavatsʲ
рук	ruk
рука	ruka
рукам	rukam
рукамі	rukamʲi
рукаў	rukau̯
руках	rukax
рукі	rukʲi
рукой	rukoj
рукою	rukoju
руку	ruku
румынія	rumɨnʲija
румынскі	rumɨnskʲi
руская	ruskaja
рускі	ruskʲi
русь	rusʲ
рух	rux
рухавік	ruxavʲik
руцэ	rutsɛ
ручка	rutʂka
ручкай	rutʂkaj
ручкамі	rutʂkamʲi
ручкаю	rutʂkaju
ручкі	rutʂkʲi
ручнік	rutʂnʲik
ручніка	rutʂnʲika
ручцы	rutsːɨ
рыба	rɨba
рыга	rɨga
рыга	rɨɣa
рыгор	rɨɣor
рыдлёўка	rɨdlʲou̯ka
рыж	rɨʂ
рыкаць	rɨkatsʲ
рыла	rɨɫa
рым	rɨm
рынак	rɨnak
рыс	rɨs
рыса	rɨsa
рысаваць	rɨsavatsʲ
рысуе	rɨsuje
рысуеш	rɨsujeʂ
рысунак	rɨsunak
рысую	rɨsuju
рысь	rɨsʲ
рыцар	rɨtsar
рыць	rɨtsʲ
рэакцыя	rɛaktsɨja
рэвалюцыя	rɛvalʲutsɨja
рэгіён	rɛɣʲijon
рэгіна	rɛɣʲina
рэдка	rɛtka
рэдкі	rɛtkʲi
рэзаць	rɛzatsʲ
рэйка	rɛjka
рэклама	rɛkɫama
рэлігія	rɛlʲiɣʲija
рэмень	rɛmʲenʲ
рэспубліка	rɛspublʲika
рэстаран	rɛstaran
рэферэндум	rɛfʲerɛndum
рэч	rɛtʂ
рэчыва	rɛtʂɨva
рэшата	rɛʂata
рэшта	rɛʂta
сабак	sabak
сабака	sabaka
сабакам	sabakam
сабакамі	sabakamʲi
сабаках	sabakax
сабакі	sabakʲi
сабаку	sabaku
сабе	sabʲe
сабой	saboj
сабор	sabor
сабою	saboju
сабраць	sabratsʲ
сава	sava
савет	savʲet
савецкі	savʲetskʲi
сад	sat
садавіна	sadavʲina
садоўскі	sadou̯skʲi
сажалка	saʐaɫka
сакавік	sakavʲik
сакавіцкі	sakavʲitskʲi
саковіч	sakovʲitʂ
сакрамант	sakramant
салавей	saɫavʲej
салгаць	saɫɣatsʲ
салдат	saɫdat
салігорск	salʲiɣorsk
салодкі	saɫotkʲi
салома	saɫoma
сам	sam
самагубства	samaɣupstva
самалёт	samalʲot
самастрэл	samastrɛɫ
самаход	samaxot
самотны	samotnɨ
самы	samɨ
сані	sanʲi
санлівасць	sanlʲivasʲtsʲ
сапраўднае	saprau̯dnaje
сапраўдны	saprau̯dnɨ
сапраўды	saprau̯dɨ
сараева	sarajeva
саракавы	sarakavɨ
сараматны	saramatnɨ
сарамлівы	saramlʲivɨ
сардэчны	sardɛtʂnɨ
сарна	sarna
сарока	saroka
сасна	sasna
сатана	satana
саўдзельнік	sau̯dzʲelʲnʲik
сацсетка	satsʲsʲetka
сацыялізм	satsɨjalʲizm
сачавіца	satʂavʲitsa
саюз	sajus
свабода	svaboda
свабодны	svabodnɨ
сварка	svarka
сведка	sʲvʲetka
свежы	sʲvʲeʐɨ
свёкар	sʲvʲokar
свет	sʲvʲet
светлы	sʲvʲetɫɨ
свечак	sʲvʲetʂak
свечачка	sʲvʲetʂatʂka
свечачны	sʲvʲetʂatʂnɨ
свечка	sʲvʲetʂka
свечкай	sʲvʲetʂkaj
свечкам	sʲvʲetʂkam
свечкамі	sʲvʲetʂkamʲi
свечках	sʲvʲetʂkax
свечкаю	sʲvʲetʂkaju
свечкі	sʲvʲetʂkʲi
свечку	sʲvʲetʂku
свечцы	sʲvʲetsːɨ
свінец	sʲvʲinʲets
свіння	sʲvʲinʲːa
свісток	sʲvʲistok
світанне	sʲvʲitanʲːe
світар	sʲvʲitar
своечасова	svojetʂasova
свой	svoj
свякроў	sʲvʲakrou̯
свякруха	sʲvʲakruxa
свята	sʲvʲata
святар	sʲvʲatar
святлана	sʲvʲatɫana
святлафор	sʲvʲatɫafor
святло	sʲvʲatɫo
святы	sʲvʲatɨ
свяча	sʲvʲatʂa
свяшчэннаслужыцель	sʲvʲaʂtʂɛnːasɫuʐɨtsʲelʲ
сезон	sʲezon
секунда	sʲekunda
сёлета	sʲolʲeta
селядзец	sʲelʲadzʲets
селязёнка	sʲelʲazʲonka
сем	sʲem
семдзесят	sʲemdzʲesʲat
семсот	sʲemsot
сёмы	sʲomɨ
семя	sʲemʲa
сена	sʲena
сене	sʲenʲe
сені	sʲenʲi
сёння	sʲonʲːa
сену	sʲenu
сера	sʲera
серабро	sʲerabro
серада	sʲerada
серады	sʲeradɨ
сербія	sʲerbʲija
сербскі	sʲerpskʲi
серп	sʲerp
серучы	sʲerutʂɨ
сёрфінг	sʲorfʲinx
сёстрам	sʲostram
сёстрамі	sʲostramʲi
сёстраў	sʲostrau̯
сёстрах	sʲostrax
сёстры	sʲostrɨ
сесці	sʲesʲtsʲi
сеул	sʲeuɫ
сібір	sʲibʲir
сівы	sʲivɨ
сіла	sʲiɫa
сімвал	sʲimvaɫ
сінагога	sʲinaɣoɣa
сінгапур	sʲingapur
сінгапур	sʲinɣapur
сіні	sʲinʲi
сініца	sʲinʲitsa
сінонім	sʲinonʲim
сіньцзян	sʲinʲdzʲzʲan
сіпель	sʲipʲelʲ
сіта	sʲita
сітуацыя	sʲituatsɨja
скажу	skaʐu
скажы	skaʐɨ
сказаць	skazatsʲ
скараціць	skaratsʲitsʲ
скарачаць	skaratʂatsʲ
скарб	skarp
скарбам	skarbam
скарбамі	skarbamʲi
скарбаў	skarbau̯
скарбах	skarbax
скарбе	skarbʲe
скарбу	skarbu
скарбы	skarbɨ
скарпіён	skarpʲijon
скарыстаць	skarɨstatsʲ
скарыстоўваць	skarɨstou̯vatsʲ
скасаваць	skasavatsʲ
скасую	skasuju
сківіца	skʲivʲitsa
складана	skɫadana
скланенне	skɫanʲenʲːe
склон	skɫon
скоп'е	skopje
скорасць	skorasʲtsʲ
скрасці	skrasʲtsʲi
скрозь	skrosʲ
скромны	skromnɨ
скрыня	skrɨnʲa
скрыпка	skrɨpka
скупы	skupɨ
скур	skur
скура	skura
скурай	skuraj
скурам	skuram
скурамі	skuramʲi
скурах	skurax
скураю	skuraju
скуру	skuru
скуры	skurɨ
слабы	sɫabɨ
слава	sɫava
славак	sɫavak
славакія	sɫavakʲija
славацкі	sɫavatskʲi
славачка	sɫavatʂka
славаччына	sɫavatʂːɨna
славенія	sɫavʲenʲija
славенскі	sɫavʲenskʲi
славінскі	sɫavʲinskʲi
славонія	sɫavonʲija
славянін	sɫavʲanʲin
славянка	sɫavʲanka
славянскі	sɫavʲanskʲi
слайд	sɫajt
слайдзе	sɫajdzʲe
сланечнік	sɫanʲetʂnʲik
слата	sɫata
слаць	sɫatsʲ
след	sʲlʲet
слёз	sʲlʲos
слёзка	sʲlʲoska
слёзны	sʲlʲoznɨ
слёзы	sʲlʲozɨ
слесар	sʲlʲesar
сліва	sʲlʲiva
слімак	sʲlʲimak
сліна	sʲlʲina
слова	sɫova
слон	sɫon
слота	sɫota
слоўнік	sɫou̯nʲik
слоўны	sɫou̯nɨ
служба	sɫuʐba
служыць	sɫuʐɨtsʲ
слуп	sɫup
слухае	sɫuxaje
слухаем	sɫuxajem
слухаеце	sɫuxajetsʲe
слухаеш	sɫuxajeʂ
слухай	sɫuxaj
слухайце	sɫuxajtsʲe
слухала	sɫuxaɫa
слухалі	sɫuxalʲi
слухаў	sɫuxau̯
слухаць	sɫuxatsʲ
слухач	sɫuxatʂ
слухачка	sɫuxatʂka
слухаю	sɫuxaju
слухаюць	sɫuxajutsʲ
слухаючы	sɫuxajutʂɨ
слушнасць	sɫuʂnasʲtsʲ
слых	sɫɨx
слыху	sɫɨxu
сляза	sʲlʲaza
слязам	sʲlʲazam
слязамі	sʲlʲazamʲi
слязах	sʲlʲazax
слязе	sʲlʲazʲe
слязінка	sʲlʲazʲinka
слязіцца	sʲlʲazʲitsːa
слязлівы	sʲlʲazʲlʲivɨ
слязой	sʲlʲazoj
слязою	sʲlʲazoju
слязу	sʲlʲazu
слязы	sʲlʲazɨ
слязьмі	sʲlʲazʲmʲi
сляпы	sʲlʲapɨ
смак	smak
смактаць	smaktatsʲ
смачны	smatʂnɨ
смелы	sʲmʲeɫɨ
смерць	sʲmʲertsʲ
смех	sʲmʲex
смецце	sʲmʲetsʲːe
смоўж	smou̯ʂ
смык	smɨk
смычок	smɨtʂok
смярдзець	sʲmʲardzʲetsʲ
смяротны	sʲmʲarotnɨ
смяяцца	sʲmʲajatsːa
снарад	snarat
снег	sʲnʲex
снегу	sʲnʲeɣu
снежань	sʲnʲeʐanʲ
снежаньскі	sʲnʲeʐanʲskʲi
снежны	sʲnʲeʐnɨ
сноп	snop
снукер	snukʲer
снягір	sʲnʲaɣʲir
сняданак	sʲnʲadanak
сняданкам	sʲnʲadankam
сняданкаў	sʲnʲadankau̯
сняданку	sʲnʲadanku
сняжынка	sʲnʲaʐɨnka
собаль	sobalʲ
содні	sodnʲi
сойка	sojka
сок	sok
сокал	sokaɫ
солад	soɫat
соль	solʲ
сон	son
сонечны	sonʲetʂnɨ
сонны	sonːɨ
сонца	sontsa
сорак	sorak
сорам	soram
соты	sotɨ
соф'я	sofja
соя	soja
спаборніцтва	spabornʲitstva
спавядальнік	spavʲadalʲnʲik
спадабаецца	spadabajetsːa
спадабалася	spadabaɫasʲa
спадабаліся	spadabalʲisʲa
спадабаўся	spadabau̯sʲa
спадабацца	spadabatsːa
спадабаюцца	spadabajutsːa
спадар	spadar
спадарожнік	spadaroʐnʲik
спадарства	spadarstva
спадарыня	spadarɨnʲa
спадзяваешся	spadzʲavajesʲːa
спадзявацца	spadzʲavatsːa
спадзяваюся	spadzʲavajusʲa
спадніца	spadnʲitsa
спазніцца	spazʲnʲitsːa
спазняцца	spazʲnʲatsːa
спакой	spakoj
спакойны	spakojnɨ
спальня	spalʲnʲa
спампаваць	spampavatsʲ
спаніель	spanʲijelʲ
спаніэль	spanʲiɛlʲ
спартсмен	spartsmɛn
спартсмен	spartsmʲen
спасіба	spasʲiba
спатканне	spatkanʲːe
спатыкаць	spatɨkatsʲ
спаць	spatsʲ
сперма	sʲpʲerma
спецпрадстаўнік	sʲpʲetspratstau̯nʲik
спіна	sʲpʲina
спірт	sʲpʲirt
спіса	sʲpʲisa
спісу	sʲpʲisu
сплю	splʲu
сподак	spodak
спорт	sport
спрабаваць	sprabavatsʲ
справа	sprava
спражэнне	spraʐɛnʲːe
спрачаешся	spratʂajesʲːa
спрачацца	spratʂatsːa
спрачаюся	spratʂajusʲa
спроб	sprop
спроба	sproba
спрыяць	sprɨjatsʲ
спрэчка	sprɛtʂka
спускацца	spuskatsːa
спусціцца	spusʲtsʲitsːa
спыніць	spɨnʲitsʲ
спытаць	spɨtatsʲ
спявак	sʲpʲavak
спяваць	sʲpʲavatsʲ
спякотны	sʲpʲakotnɨ
спячы	sʲpʲatʂɨ
сраў	srau̯
сраць	sratsʲ
срэбра	srɛbra
ссаць	sːatsʲ
ставіць	stavʲitsʲ
стагоддзе	staɣodzʲːe
стадыён	stadɨjon
стакан	stakan
стала	staɫa
сталі	stalʲi
сталіца	stalʲitsa
стамеска	stamʲeska
станавіцца	stanavʲitsːa
станаўлюся	stanau̯lʲusʲa
станіслаў	stanʲisɫau̯
становімся	stanovʲimsʲa
становіцца	stanovʲitsːa
становішся	stanovʲisʲːa
стану	stanu
станцыя	stantsɨja
стань	stanʲ
старадаўні	staradau̯nʲi
старажытны	staraʐɨtnɨ
старана	starana
стараста	starasta
старацца	staratsːa
старонка	staronka
старшыня	starʂɨnʲa
стары	starɨ
статкевіч	statkʲevʲitʂ
статысячны	stotɨsʲatʂnɨ
стаў	stau̯
стаць	statsʲ
стаяць	stajatsʲ
ствараеш	stvarajeʂ
ствараць	stvaratsʲ
ствараю	stvaraju
стварыць	stvarɨtsʲ
ствол	stvoɫ
сто	sto
стог	stox
стол	stoɫ
столін	stolʲin
столь	stolʲ
стольнік	stolʲnʲik
стомлены	stomlʲenɨ
стораж	storaʂ
стоўб	stou̯p
страва	strava
страказа	strakaza
страла	straɫa
страляць	stralʲatsʲ
страта	strata
стратэгічны	stratɛɣʲitʂnɨ
страўнік	strau̯nʲik
страх	strax
страціць	stratsʲitsʲ
строгі	stroɣʲi
стронга	stronɣa
стрыгчы	strɨxtʂɨ
стрыечны	strɨjetʂnɨ
стрэл	strɛɫ
стрэліць	strɛlʲitsʲ
стрэлка	strɛɫka
стрэльба	strɛlʲba
стрэмя	strɛmʲa
студзень	studzʲenʲ
студзеньскі	studzʲenʲskʲi
студэнт	studɛnt
студэнтка	studɛntka
ступень	stupʲenʲ
суадносіны	suadnosʲinɨ
суайчыннік	suajtʂɨnʲːik
субота	subota
суботы	subotɨ
сувязь	suvʲasʲ
суграмадзянін	suɣramadzʲanʲin
суд	sut
суддзя	sudzʲːa
судна	sudna
суднабудаванне	sudnabudavanʲːe
сукала	sukaɫa
сукенка	sukʲenka
сукно	sukno
сукня	suknʲa
сумець	sumʲetsʲ
сумка	sumka
сумленне	sumlʲenʲːe
сумленны	sumlʲenːɨ
сумнеў	sumnʲeu̯
сумны	sumnɨ
сумнявацца	sumnʲavatsːa
суп	sup
суполка	supoɫka
супрацоўніцтва	supratsou̯nʲitstva
супраць	supratsʲ
сура	sura
сурвэтка	survɛtka
сур'ёзны	surjoznɨ
сурынам	surɨnam
сусвет	susvʲet
сусед	susʲet
сустракае	sustrakaje
сустракаем	sustrakajem
сустракаеце	sustrakajetsʲe
сустракаеш	sustrakajeʂ
сустракай	sustrakaj
сустракацца	sustrakatsːa
сустракаць	sustrakatsʲ
сустракаю	sustrakaju
сустракаюць	sustrakajutsʲ
сустрэцца	sustrɛtsːa
сустрэць	sustrɛtsʲ
сустрэча	sustrɛtʂa
суткі	sutkʲi
суфікс	sufʲiks
сухазем'е	suxazʲemje
сухі	suxʲi
сучасны	sutʂasnɨ
сцаць	stsatsʲ
сціплы	sʲtsʲipɫɨ
сцюард	sʲtsʲuart
сцябло	sʲtsʲabɫo
сцяг	sʲtsʲax
сцягно	sʲtsʲaɣno
сцяна	sʲtsʲana
сцяпан	sʲtsʲapan
сшытак	ʂːɨtak
сымбаль	sɨmbalʲ
сын	sɨn
сыр	sɨr
сыры	sɨrɨ
сысун	sɨsun
сысці	sɨsʲtsʲi
сыты	sɨtɨ
сыходзіць	sɨxodzʲitsʲ
сьвечка	sʲvʲetʂka
сьвяча	sʲvʲatʂa
сьлімак	sʲlʲimak
сьляза	sʲlʲaza
сэрца	sɛrtsa
сюды	sʲudɨ
сябар	sʲabar
сябе	sʲabʲe
сяброўства	sʲabrou̯stva
сягоння	sʲaɣonʲːa
сядзець	sʲadzʲetsʲ
сядзіба	sʲadzʲiba
сядло	sʲadɫo
сякера	sʲakʲera
сяло	sʲaɫo
сямён	sʲamʲon
сямёра	sʲamʲora
сямі	sʲamʲi
сямідзесяты	sʲamʲidzʲesʲatɨ
сямісоты	sʲamʲisotɨ
сямнаццаты	sʲamnatsːatɨ
сямнаццаць	sʲamnatsːatsʲ
сямю	sʲamʲu
сям'я	sʲamja
сянкевіч	sʲankʲevʲitʂ
сяргей	sʲarɣʲej
сярдзіты	sʲardzʲitɨ
сярод	sʲarot
сяру	sʲaru
сярэбраны	sʲarɛbranɨ
сярэдзін	sʲarɛdzʲin
сярэдзіна	sʲarɛdzʲina
сярэдзінай	sʲarɛdzʲinaj
сярэдзінам	sʲarɛdzʲinam
сярэдзінамі	sʲarɛdzʲinamʲi
сярэдзінах	sʲarɛdzʲinax
сярэдзінаю	sʲarɛdzʲinaju
сярэдзіне	sʲarɛdzʲinʲe
сярэдзіну	sʲarɛdzʲinu
сярэдзіны	sʲarɛdzʲinɨ
сярэдні	sʲarɛdnʲi
сярэднявечча	sʲarɛdnʲavʲetʂːa
сястра	sʲastra
сястрой	sʲastroj
сястрою	sʲastroju
сястру	sʲastru
сястры	sʲastrɨ
сясцёр	sʲasʲtsʲor
сятчатка	sʲatːʂatka
табе	tabʲe
табліца	tablʲitsa
табой	taboj
табою	taboju
тавар	tavar
таварыш	tavarɨʂ
тагальскі	taɣalʲskʲi
таджыкістан	tadʐɨkʲistan
таджыкскі	tadʐɨkskʲi
тады	tadɨ
тайланд	tajɫant
тайна	tajna
тайскі	tajskʲi
так	tak
такая	takaja
такі	takʲi
такім	takʲim
такімі	takʲimʲi
такіх	takʲix
такія	takʲija
такога	takoɣa
такое	takoje
такой	takoj
такому	takomu
такою	takoju
таксама	taksama
таксаномія	taksanomʲija
таксі	taksʲi
тактоўны	taktou̯nɨ
тактычны	taktɨtʂnɨ
такую	takuju
талерка	talʲerka
талочка	taɫotʂka
там	tam
тамара	tamara
тамашэвіч	tamaʂɛvʲitʂ
таму	tamu
танзанія	tanzanʲija
танны	tanːɨ
танцаваць	tantsavatsʲ
тапор	tapor
таран	taran
тарашкевіца	taraʂkʲevʲitsa
тарашкевіч	taraʂkʲevʲitʂ
тата	tata
таўпека	tau̯pʲeka
таўчы	tau̯tʂɨ
таццяна	tatsʲːana
тая	taja
таямніца	tajamnʲitsa
твар	tvar
тварог	tvarox
тварыць	tvarɨtsʲ
твой	tvoj
твор	tvor
творны	tvornɨ
творчы	tvortʂɨ
ткацтва	tkatstva
ткач	tkatʂ
тлумач	tɫumatʂ
тлумачаць	tɫumatʂatsʲ
тлумачу	tɫumatʂu
тлумачце	tɫumatsʲːe
тлумачыла	tɫumatʂɨɫa
тлумачылі	tɫumatʂɨlʲi
тлумачым	tɫumatʂɨm
тлумачыў	tɫumatʂɨu̯
тлумачыце	tɫumatʂɨtsʲe
тлумачыць	tɫumatʂɨtsʲ
тлумачыш	tɫumatʂɨʂ
тлустае	tɫustaje
тлустая	tɫustaja
тлусты	tɫustɨ
тлустыя	tɫustɨja
тлусцець	tɫusʲtsʲetsʲ
тлушч	tɫuʂtʂ
тое	toje
той	toj
токіа	tokʲia
толькі	tolʲkʲi
том	tom
тонкі	tonkʲi
торт	tort
торф	torf
тоўсты	tou̯stɨ
трава	trava
травень	travʲenʲ
травеньскі	travʲenʲskʲi
традыцыя	tradɨtsɨja
трактар	traktar
трактарыст	traktarɨst
трактарыстка	traktarɨstka
трасянка	trasʲanka
траціць	tratsʲitsʲ
трое	troje
тром	trom
трох	trox
трохвугольнік	troxvuɣolʲnʲik
трохі	troxʲi
трохсоты	troxsotɨ
трошачкі	troʂatʂkʲi
трошкі	troʂkʲi
труна	truna
трус	trus
трусы	trusɨ
труфля	truflʲa
труцень	trutsʲenʲ
тры	trɨ
трываць	trɨvatsʲ
трыльён	trɨlʲjon
трыльённы	trɨlʲjonːɨ
трыма	trɨma
трымаць	trɨmatsʲ
трынаццаты	trɨnatsːatɨ
трынаццаць	trɨnatsːatsʲ
трыснёг	trɨsʲnʲox
трыста	trɨsta
трыццаты	trɨtsːatɨ
трыццаць	trɨtsːatsʲ
трэба	trɛba
трэсці	trɛsʲtsʲi
трэці	trɛtsʲi
туалет	tualʲet
тугі	tuɣʲi
туды	tudɨ
туман	tuman
туніс	tunʲis
тупы	tupɨ
турак	turak
туркменістан	turkmʲenʲistan
туркменскі	turkmʲenskʲi
турма	turma
турцыя	turtsɨja
турчанка	turtʂanka
турыст	turɨst
турыстаў	turɨstau̯
турысты	turɨstɨ
турэмны	turɛmnɨ
турэцкі	turɛtskʲi
турэччына	turɛtʂːɨna
тут	tut
тхор	txor
ты	tɨ
тыгр	tɨɣr
тыдзень	tɨdzʲenʲ
тыкаць	tɨkatsʲ
тып	tɨp
тыповы	tɨpovɨ
тысяча	tɨsʲatʂa
тысячагоддзе	tɨsʲatʂaɣodzʲːe
тысячны	tɨsʲatʂnɨ
тытунь	tɨtunʲ
тэатр	tɛatr
тэкст	tɛkst
тэкста	tɛksta
тэлебачанне	tɛlʲebatʂanʲːe
тэлевізар	tɛlʲevʲizar
тэлефон	tɛlʲefon
тэрарыст	tɛrarɨst
тэрмастат	tɛrmastat
тэрмін	tɛrmʲin
тэрор	tɛror
тэст	tɛst
тэстастэрон	tɛstastɛron
тэсцікула	tɛsʲtsʲikuɫa
тэхас	tɛxas
у	u
убачыць	ubatʂɨtsʲ
увага	uvaɣa
увагай	uvaɣaj
увагаю	uvaɣaju
увагі	uvaɣʲi
увагу	uvaɣu
уважлівы	uvaʐlʲivɨ
увазе	uvazʲe
увайсці	uvajsʲtsʲi
уварванне	uvarvanʲːe
уваходзіць	uvaxodzʲitsʲ
уведаць	uvʲedatsʲ
ўведаць	wvʲedatsʲ
увесну	uvʲesnu
ўвесну	wvʲesnu
увесь	uvʲesʲ
увогуле	uvoɣulʲe
увосень	uvosʲenʲ
ўвосень	wvosʲenʲ
уганда	uganda
уганда	uɣanda
угорскі	uɣorskʲi
удараць	udaratsʲ
ўдараць	wdaratsʲ
ударыць	udarɨtsʲ
ўдарыць	wdarɨtsʲ
удзел	udzʲeɫ
удзельнік	udzʲelʲnʲik
удзень	udzʲenʲ
удзячны	udzʲatʂnɨ
ужгарад	uʐgarat
ужо	uʐo
ужываць	uʐɨvatsʲ
ўжываць	wʐɨvatsʲ
ужыць	uʐɨtsʲ
ўжыць	wʐɨtsʲ
узаемнасць	uzajemnasʲtsʲ
узбекістан	uzʲbʲekʲistan
узбекскі	uzʲbʲekskʲi
узімку	uzʲimku
ўзімку	wzʲimku
узнаўленне	uznau̯lʲenʲːe
узначальваць	uznatʂalʲvatsʲ
узровень	uzrovʲenʲ
узрост	uzrost
ўзрост	wzrost
узроўню	uzrou̯nʲu
узяць	uzʲatsʲ
ўзяць	wzʲatsʲ
уйгур	ujɣur
уклад	ukɫat
уключаць	uklʲutʂatsʲ
ўключаць	wklʲutʂatsʲ
украіна	ukrajina
украінец	ukrajinʲets
украінка	ukrajinka
украінская	ukrajinskaja
украінскі	ukrajinskʲi
улада	uɫada
уладзімер	uɫadzʲimʲer
ўладзімер	wɫadzʲimʲer
уладзімір	uɫadzʲimʲir
уладзіслаў	uɫadzʲisɫau̯
ўладзіслаў	wɫadzʲisɫau̯
уласны	uɫasnɨ
ўласны	wɫasnɨ
уласцівасць	uɫasʲtsʲivasʲtsʲ
улетку	ulʲetku
ўлетку	wlʲetku
улляна	ulʲːana
улонне	uɫonʲːe
улюбёны	ulʲubʲonɨ
умець	umʲetsʲ
ўмець	wmʲetsʲ
умова	umova
універмаг	unʲivʲermax
універсітэт	unʲivʲersʲitɛt
унікаць	unʲikatsʲ
ўнікаць	wnʲikatsʲ
унікнуць	unʲiknutsʲ
ўнікнуць	wnʲiknutsʲ
унук	unuk
унутраны	unutranɨ
унучка	unutʂka
упарты	upartɨ
упасці	upasʲtsʲi
упершыню	upʲerʂɨnʲu
уплывовы	upɫɨvovɨ
уплыў	upɫɨu̯
ўплыў	wpɫɨu̯
упякаць	upʲakatsʲ
урад	urat
уражальны	uraʐalʲnɨ
уражанне	uraʐanʲːe
урду	urdu
урок	urok
урока	uroka
урокамі	urokamʲi
урокаў	urokau̯
урокі	urokʲi
уругвай	uruɣvaj
усвядоміць	usʲvʲadomʲitsʲ
усе	usʲe
усё	usʲo
ўсё	wsʲo
усеагульны	usʲeaɣulʲnɨ
усёахопны	usʲoaxopnɨ
усёмагутны	usʲomaɣutnɨ
усёю	usʲoju
усім	usʲim
ускладаць	uskɫadatsʲ
усмешка	usʲmʲeʂka
усміхацца	usʲmʲixatsːa
усміхнуцца	usʲmʲixatsːa
уставаць	ustavatsʲ
ўставаць	wstavatsʲ
устаць	ustatsʲ
ўстаць	wstatsʲ
усход	usxot
ўсход	wsxot
усходнеславянскі	usxodnʲesɫavʲanskʲi
усходні	usxodnʲi
ўсходні	wsxodnʲi
усюды	usʲudɨ
уся	usʲa
утвараць	utvaratsʲ
ухіліцца	uxʲilʲitsːa
ўхіліцца	wxʲilʲitsːa
ухіляцца	uxʲilʲatsːa
ўхіляцца	wxʲilʲatsːa
уцякач	utsʲakatʂ
учора	utʂora
ўчора	wtʂora
учуць	utʂutsʲ
ўчуць	wtʂutsʲ
ўэльс	wɛlʲs
уявіць	ujavʲitsʲ
уяўляць	ujau̯lʲatsʲ
фабрыка	fabrɨka
файна	fajna
файны	fajnɨ
факт	fakt
фактычна	faktɨtʂna
фальклорны	falʲkɫornɨ
фараон	faraon
фарба	farba
фарбавала	farbavaɫa
фарбавалі	farbavalʲi
фарбаваў	farbavau̯
фарбаваць	farbavatsʲ
фарбуе	farbuje
фарбуем	farbujem
фарбуеце	farbujetsʲe
фарбуеш	farbujeʂ
фарбуй	farbuj
фарбую	farbuju
фарбуюць	farbujutsʲ
фармалізм	farmalʲizm
фартэпіяна	fartɛpʲijana
фарэрскі	farɛrskʲi
фатаграфія	fataɣrafʲija
фатэль	fatɛlʲ
фах	fax
фашызм	faʂɨzm
фёдар	fʲodar
федэрацыя	fʲedɛratsɨja
фёкла	fʲokɫa
фемінізм	fʲemʲinʲizm
ферзь	fʲersʲ
ферма	fʲerma
фізіка	fʲizʲika
фізкультура	fʲiskulʲtura
філасофія	fʲiɫasofʲija
філіжанка	fʲilʲiʐanka
філіп	fʲilʲip
філіповіч	fʲilʲipovʲitʂ
фільм	fʲilʲm
фінвал	fʲinvaɫ
фінік	fʲinʲik
фінляндыя	fʲinlʲandɨja
фінскі	fʲinskʲi
фіньшампань	fʲinʲʂampanʲ
фірма	fʲirma
фіялетавы	fʲijalʲetavɨ
флейта	flʲejta
форма	forma
формай	formaj
формамі	formamʲi
формаў	formau̯
формаю	formaju
фосфар	fosfar
францужанка	frantsuʐanka
француз	frantsus
французскі	frantsusːkʲi
францыск	frantsɨsk
францыя	frantsɨja
фрызскі	frɨsːkʲi
фрыцюр	frɨtsʲur
фрыцюрніца	frɨtsʲurnʲitsa
фургон	furɣon
фурман	furman
футбол	fudboɫ
хава	xava
хавацца	xavatsːa
хаджу	xadʐu
хадзі	xadzʲi
хадзіў	xadzʲiu̯
хадзіць	xadzʲitsʲ
хай	xaj
хакей	xakʲej
халадзільнік	xaɫadzʲilʲnʲik
халасцяк	xaɫasʲtsʲak
халера	xalʲera
халодны	xaɫodnɨ
хамуйла	xamujɫa
хамяк	xamʲak
харват	xarvat
харватка	xarvatka
харватыя	xarvatɨja
харвацкі	xarvatskʲi
харкаў	xarkau̯
харобры	xarobrɨ
харошы	xaroʂɨ
харч	xartʂ
хата	xata
хатні	xatnʲi
хацець	xatsʲetsʲ
хвалюешся	xvalʲujesʲːa
хвалюйся	xvalʲujsʲa
хвалююся	xvalʲujusʲa
хваля	xvalʲa
хвалявацца	xvalʲavatsːa
хвароба	xvaroba
хварэць	xvarɛtsʲ
хвіліна	xvʲilʲina
хвілінак	xvʲilʲinak
хвіліне	xvʲilʲinʲe
хвілінка	xvʲilʲinka
хвілінкай	xvʲilʲinkaj
хвілінкам	xvʲilʲinkam
хвілінкамі	xvʲilʲinkamʲi
хвілінках	xvʲilʲinkax
хвілінкаю	xvʲilʲinkaju
хвілінкі	xvʲilʲinkʲi
хвілінку	xvʲilʲinku
хвіліну	xvʲilʲinu
хвілінцы	xvʲilʲintsɨ
хвіліны	xvʲilʲinɨ
хвіля	xvʲilʲa
хвойнік	xvojnʲik
хвораст	xvorast
хворы	xvorɨ
хвост	xvost
хіба	xʲiba
хімічны	xʲimʲitʂnɨ
хімія	xʲimʲija
хімчыстка	xʲimtʂɨstka
хіндзі	xʲinʲdzʲi
хітры	xʲitrɨ
хлеб	xlʲep
хлеў	xlʲeu̯
хлопец	xɫopʲets
хлопчык	xɫoptʂɨk
хлор	xɫor
хлусня	xɫusʲnʲa
хмара	xmara
хмарка	xmarka
хмыз	xmɨs
хобі	xobʲi
ходзім	xodzʲim
ходзіць	xodzʲitsʲ
ходзіш	xodzʲiʂ
холад	xoɫat
холадна	xoɫadna
храм	xram
храптовіч	xraptovʲitʂ
хрушч	xruʂtʂ
хрыстос	xrɨstos
хрысціянін	xrɨsʲtsʲijanʲin
хрэн	xrɛn
хто	xto
хтось	xtosʲ
хтосьці	xtosʲtsʲi
худы	xudɨ
хуй	xuj
хуйло	xujɫo
хурма	xurma
хурме	xurmʲe
хурмой	xurmoj
хурмою	xurmoju
хурму	xurmu
хурмы	xurmɨ
хустка	xustka
хутар	xutar
хуткі	xutkʲi
цалаваць	tsaɫavatsʲ
цалкам	tsaɫkam
цана	tsana
цаны	tsanɨ
цапкала	tsapkaɫa
цар	tsar
царква	tsarkva
царства	tsarstva
царыца	tsarɨtsa
цацка	tsatska
цвёрды	tsʲvʲordɨ
цвет	tsʲvʲet
цвік	tsʲvʲik
цвісці	tsʲvʲisʲtsʲi
цвыркун	tsvɨrkun
цвярозы	tsʲvʲarozɨ
цела	tsʲeɫa
целы	tsʲeɫɨ
цёмны	tsʲomnɨ
цемя	tsʲemʲa
цень	tsʲenʲ
цёплы	tsʲopɫɨ
цёрн	tsʲorn
церці	tsʲertsʲi
цесны	tsʲesnɨ
цеста	tsʲesta
цесць	tsʲesʲtsʲ
цётка	tsʲotka
цёця	tsʲotsʲa
цешча	tsʲeʂtʂa
ці	tsʲi
цікавы	tsʲikavɨ
цімафей	tsʲimafʲej
ціск	tsʲisk
ціха	tsʲixa
ціхан	tsʲixan
ціхановіч	tsʲixanovʲitʂ
ціханоўская	tsʲixanou̯skaja
ціханоўскі	tsʲixanou̯skʲi
ціхі	tsʲixʲi
цішыня	tsʲiʂɨnʲa
цмок	tsmok
цнатлівы	tsnatlʲivɨ
цнота	tsnota
цуд	tsut
цудоўна	tsudou̯na
цудоўны	tsudou̯nɨ
цукар	tsukar
цукерка	tsukʲerka
цыбулі	tsɨbulʲi
цыбулю	tsɨbulʲu
цыбуля	tsɨbulʲa
цыбуляй	tsɨbulʲaj
цыбуляю	tsɨbulʲaju
цыгарэта	tsɨɣarɛta
цырк	tsɨrk
цыркуль	tsɨrkulʲ
цырульнік	tsɨrulʲnʲik
цырульня	tsɨrulʲnʲa
цырымонія	tsɨrɨmonʲija
цыянід	tsɨjanʲit
цьма	tsʲma
цэлага	tsɛɫaɣa
цэлае	tsɛɫaje
цэлая	tsɛɫaja
цэлы	tsɛɫɨ
цэнтр	tsɛntr
цэсар	tsɛsar
цюлень	tsʲulʲenʲ
цюльпан	tsʲulʲpan
цябе	tsʲabʲe
цягаць	tsʲaɣatsʲ
цягліца	tsʲaɣlʲitsa
цягнік	tsʲaɣnʲik
цягнуць	tsʲaɣnutsʲ
цяжар	tsʲaʐar
цяжарнасць	tsʲaʐarnasʲtsʲ
цяжарная	tsʲaʐarnaja
цяжарны	tsʲaʐarnɨ
цяжка	tsʲaʂka
цяжкадаступны	tsʲaʂkadastupnɨ
цяжкі	tsʲaʂkʲi
цяліца	tsʲalʲitsa
цяля	tsʲalʲa
цямніца	tsʲamnʲitsa
цяпер	tsʲapʲer
цяперашні	tsʲapʲeraʂnʲi
цяпло	tsʲapɫo
цярплівы	tsʲarplʲivɨ
цясла	tsʲasɫa
цячы	tsʲatʂɨ
чабан	tʂaban
чаго	tʂaɣo
чай	tʂaj
чакаць	tʂakatsʲ
чалавек	tʂaɫavʲek
чалавецтва	tʂaɫavʲetstva
чалавеча	tʂaɫavʲetʂa
чалавечы	tʂaɫavʲetʂɨ
чало	tʂaɫo
чамадан	tʂamadan
чаму	tʂamu
чапля	tʂaplʲa
чаравік	tʂaravʲik
чарадзей	tʂaradzʲej
чарадзею	tʂaradzʲeju
чарадзея	tʂaradzʲeja
чарапаха	tʂarapaxa
чараўнік	tʂarau̯nʲik
чарвяк	tʂarvʲak
чарга	tʂarɣa
чарговы	tʂarɣovɨ
чарнагорскі	tʂarnaɣorskʲi
чарнагорыя	tʂarnaɣorɨja
чарнаўцы	tʂarnau̯tsɨ
чарнец	tʂarnʲets
чарніла	tʂarnʲiɫa
чарнушка	tʂarnuʂka
чарняк	tʂarnʲak
чаромха	tʂaromxa
чарот	tʂarot
чароўны	tʂarou̯nɨ
чарпак	tʂarpak
чарціць	tʂartsʲitsʲ
чарэшня	tʂarɛʂnʲa
час	tʂas
часам	tʂasam
часнок	tʂasnok
часта	tʂasta
частка	tʂastka
частковы	tʂastkovɨ
часты	tʂastɨ
чатырма	tʂatɨrma
чатырнаццаты	tʂatɨrnatsːatɨ
чатырнаццаць	tʂatɨrnatsːatsʲ
чатыром	tʂatɨrom
чатырох	tʂatɨrox
чатырохсоты	tʂatɨroxsotɨ
чатыры	tʂatɨrɨ
чатырыста	tʂatɨrɨsta
чацвер	tʂatsʲvʲer
чацвёра	tʂatsʲvʲora
чацвёрты	tʂatsʲvʲortɨ
чацьвер	tʂatsʲvʲer
чаша	tʂaʂa
чашай	tʂaʂaj
чашамі	tʂaʂamʲi
чашаю	tʂaʂaju
чашы	tʂaʂɨ
чмара	tʂmara
чмель	tʂmʲelʲ
човен	tʂovʲen
чорны	tʂornɨ
чорт	tʂort
чужаземец	tʂuʐazʲemʲets
чужаземны	tʂuʐazʲemnɨ
чужы	tʂuʐɨ
чутны	tʂutnɨ
чухаць	tʂuxatsʲ
чуць	tʂutsʲ
чую	tʂuju
чыгунка	tʂɨɣunka
чый	tʂɨj
чылі	tʂɨlʲi
чым	tʂɨm
чырвоны	tʂɨrvonɨ
чыстка	tʂɨstka
чысты	tʂɨstɨ
чысціць	tʂɨsʲtsʲitsʲ
чытанне	tʂɨtanʲːe
чытаць	tʂɨtatsʲ
чытач	tʂɨtatʂ
чэрава	tʂɛrava
чэрап	tʂɛrap
чэрвень	tʂɛrvʲenʲ
чэрвеньскі	tʂɛrvʲenʲskʲi
чэсць	tʂɛsʲtsʲ
чэх	tʂɛx
чэхаславакія	tʂɛxasɫavakʲija
чэхія	tʂɛxʲija
чэшка	tʂɛʂka
чэшскі	tʂɛsːkʲi
чэшскі	tʂɛskʲi
ш	ʂ
шабля	ʂablʲa
шабуня	ʂabunʲa
шаг	ʂax
шакалад	ʂakaɫat
шалёны	ʂalʲonɨ
шалік	ʂalʲik
шалом	ʂaɫom
шаноўны	ʂanou̯nɨ
шапка	ʂapka
шарманка	ʂarmanka
шарф	ʂarf
шаснаццаты	ʂasnatsːatɨ
шаснаццаць	ʂasnatsːatsʲ
шасцёра	ʂasʲtsʲora
шасці	ʂasʲtsʲi
шасцівугольнік	ʂasʲtsʲivuɣolʲnʲik
шасцідзесяты	ʂasʲtsʲidzʲesʲatɨ
шасцісоты	ʂasʲtsʲisotɨ
шасцю	ʂasʲtsʲu
шатландскі	ʂatɫantskʲi
шатландыя	ʂatɫandɨja
шахматы	ʂaxmatɨ
шахматыст	ʂaxmatɨst
шахматыстка	ʂaxmatɨstka
швагер	ʂvagʲer
шваґер	ʂvagʲer
швагер	ʂvaɣʲer
швайцарыя	ʂvajtsarɨja
шведскі	ʂvʲetskʲi
швейцарыя	ʂvʲejtsarɨja
швецыя	ʂvʲetsɨja
шкада	ʂkada
шкадаваць	ʂkadavatsʲ
шкарпэтка	ʂkarpɛtka
шкатулка	ʂkatuɫka
шкілет	ʂkʲilʲet
шкло	ʂkɫo
шклянка	ʂklʲanka
шкода	ʂkoda
шкоднасны	ʂkodnasnɨ
шкодны	ʂkodnɨ
школа	ʂkoɫa
шлюб	ʂlʲup
шлюбам	ʂlʲubam
шлюбамі	ʂlʲubamʲi
шлюбаў	ʂlʲubau̯
шлюбах	ʂlʲubax
шлюбе	ʂlʲubʲe
шлюбу	ʂlʲubu
шлюбы	ʂlʲubɨ
шлях	ʂlʲax
шляхетны	ʂlʲaxʲetnɨ
шляхта	ʂlʲaxta
шляхтай	ʂlʲaxtaj
шляхтаю	ʂlʲaxtaju
шляхце	ʂlʲaxtsʲe
шмат	ʂmat
шок	ʂok
шост	ʂost
шосты	ʂostɨ
шоўк	ʂou̯k
шпак	ʂpak
шпацыр	ʂpatsɨr
шпінат	ʂpʲinat
шруба	ʂruba
штаны	ʂtanɨ
штат	ʂtat
штатаў	ʂtatau̯
што	ʂto
штодзённы	ʂtodzʲonːɨ
штось	ʂtosʲ
штосьці	ʂtosʲtsʲi
штурхаць	ʂturxatsʲ
шукай	ʂukaj
шукала	ʂukaɫa
шукальнік	ʂukalʲnʲik
шукаў	ʂukau̯
шукаць	ʂukatsʲ
шукаю	ʂukaju
шум	ʂum
шуфляда	ʂuflʲada
шушкевіч	ʂuʂkʲevʲitʂ
шчака	ʂtʂaka
шчаслівы	ʂtʂasʲlʲivɨ
шчасце	ʂtʂasʲtsʲe
шчаўе	ʂtʂau̯je
шчодры	ʂtʂodrɨ
шчотка	ʂtʂotka
шчупак	ʂtʂupak
шчучын	ʂtʂutʂɨn
шчучына	ʂtʂutʂɨna
шчучынам	ʂtʂutʂɨnam
шчучыне	ʂtʂutʂɨnʲe
шчучыну	ʂtʂutʂɨnu
шчыкалатка	ʂtʂɨkaɫatka
шчыльны	ʂtʂɨlʲnɨ
шчыры	ʂtʂɨrɨ
шчыт	ʂtʂɨt
шчэрба	ʂtʂɛrba
шчэцін	ʂtʂɛtsʲin
шыбеніца	ʂɨbʲenʲitsa
шызы	ʂɨzɨ
шыльда	ʂɨlʲda
шынка	ʂɨnka
шыпшына	ʂɨpʂɨna
шыр	ʂɨr
шырата	ʂɨrata
шырокі	ʂɨrokʲi
шыць	ʂɨtsʲ
шыя	ʂɨja
шэдэўр	ʂɛdɛu̯r
шэдэўраў	ʂɛdɛu̯rau̯
шэршань	ʂɛrʂanʲ
шэры	ʂɛrɨ
шэсць	ʂɛsʲtsʲ
шэсцьдзесят	ʂɛzdzʲːesʲat
шэсцьсот	ʂɛsʲtsʲsot
ы	ɨ
э	ɛ
эвалюцыя	ɛvalʲutsɨja
эдуард	ɛduart
эдэшка	ɛdɛʂka
эканоміка	ɛkanomʲika
эквадор	ɛkvador
экзамен	ɛgzamʲen
экран	ɛkran
электрык	ɛlʲektrɨk
элемент	ɛlʲemʲent
эліпс	ɛlʲips
эльзас	ɛlʲzas
эльзаскі	ɛlʲzaskʲi
энцыклапедыя	ɛntsɨkɫapʲedɨja
эпістэмалогія	ɛpʲistɛmaɫoɣʲija
эра	ɛra
эрэкцыя	ɛrɛktsɨja
эстонец	ɛstonʲets
эстонія	ɛstonʲija
эстонка	ɛstonka
эстонскі	ɛstonskʲi
этнічны	ɛtnʲitʂnɨ
этымалогія	ɛtɨmaɫoɣʲija
этэр	ɛtɛr
эфект	ɛfʲekt
эфектам	ɛfʲektam
эфекту	ɛfʲektu
эфекты	ɛfʲektɨ
эфекце	ɛfʲektsʲe
эфір	ɛfʲir
эякуляцыя	ɛjakulʲatsɨja
ю	ju
юбілей	jubʲilʲej
югаславія	juɣasɫavʲija
юдзіцкі	judzʲitskʲi
юлія	julʲija
юны	junɨ
юрый	jurɨj
юрэвіч	jurɛvʲitʂ
юшкевіч	juʂkʲevʲitʂ
я	ja
ябаць	jabatsʲ
яблык	jabɫɨk
яблыка	jabɫɨka
яблыкам	jabɫɨkam
яблыкамі	jabɫɨkamʲi
яблыкаў	jabɫɨkau̯
яблыках	jabɫɨkax
яблыкі	jabɫɨkʲi
яблыку	jabɫɨku
ягада	jaɣada
ягнё	jaɣnʲo
ягнём	jaɣnʲom
ягня	jaɣnʲa
ягнят	jaɣnʲat
ягнятам	jaɣnʲatam
ягнятамі	jaɣnʲatamʲi
ягнятах	jaɣnʲatax
ягняты	jaɣnʲatɨ
ягняці	jaɣnʲatsʲi
яго	jaɣo
ягонага	jaɣonaɣa
ягонае	jaɣonaje
ягонай	jaɣonaj
ягонаму	jaɣonamu
ягонаю	jaɣonaju
ягоная	jaɣonaja
ягоную	jaɣonuju
ягоны	jaɣonɨ
ягоным	jaɣonɨm
ягонымі	jaɣonɨmʲi
ягоных	jaɣonɨx
ягоныя	jaɣonɨja
ягор	jaɣor
ягурт	jaɣurt
яда	jada
ядваб	jadvap
ядвіга	jadvʲiɣa
ядловец	jadɫovʲets
яднаць	jadnatsʲ
ядраны	jadranɨ
яе	jaje
яечка	jajetʂka
яечня	jajetʂnʲa
язык	jazɨk
яйка	jajka
яйцо	jajtso
як	jak
яка	jaka
якам	jakam
якамі	jakamʲi
якар	jakar
якасны	jakasnɨ
якасць	jakasʲtsʲ
якаў	jakau̯
яках	jakax
якая	jakaja
які	jakʲi
якім	jakʲim
якімі	jakʲimʲi
якімовіч	jakʲimovʲitʂ
якісьці	jakʲisʲtsʲi
якіх	jakʲix
якія	jakʲija
якога	jakoɣa
якое	jakoje
якой	jakoj
якому	jakomu
якою	jakoju
яку	jaku
якубовіч	jakubovʲitʂ
якую	jakuju
ялавічына	jaɫavʲitʂɨna
яліты	jalʲitɨ
ялта	jaɫta
яма	jama
яму	jamu
ян	jan
яна	jana
яно	jano
янтар	jantar
яны	janɨ
японія	japonʲija
японскі	japonskʲi
яраслаў	jarasɫau̯
яркі	jarkʲi
ярмо	jarmo
ясень	jasʲenʲ
ясі	jasʲi
яскевіч	jaskʲevʲitʂ
ясны	jasnɨ
ястраб	jastrap
яўген	jau̯ɣʲen
яўгеній	jau̯ɣʲenʲij
яўгенія	jau̯ɣʲenʲija
яўрэй	jau̯rɛj
яўрэйскі	jau̯rɛjskʲi
яфім	jafʲim
ячмень	jatʂmʲenʲ
яшчарка	jaʂtʂarka
яшчэ	jaʂtʂɛ
