ئا	a
ئائىت	ʔɑʔit
ئائىلە	ʔɑʔilɛ
ئابلىز	ʔɑbliz
ئابنۇس	ʔɑbnus
ئات	ɑt
ئاتا	ʔɑtɑ
ئاتمىش	ɑtmiʃ
ئاجايىپ	ʔɑdʒɑjip
ئاجىز	ʔɑdʒiz
ئاخشام	ʔɑχʃɑm
ئاخىرەت	ʔɑχirɛt
ئادالەت	ʔɑdɑlɛt
ئادرىس	ʔɑdris
ئادىل	ʔɑdil
ئادۋوكات	ʔɑdwokɑt
ئادەت	ʔɑdɛt
ئادەم	ɑdæm
ئارزۇ	ʔɑrzu
ئارسىن	ʔɑrsin
ئارغىماق	ʔɑrʁimɑq
ئارغۇن	ʔɑrʁun
ئارقا	ʔɑrqɑ
ئارماغان	ʔɑrmɑʁɑn
ئارىفمېتىكا	ʔɑrifmetikɑ
ئارگون	ʔɑrgon
ئاز	ʔɑz
ئازات	ʔɑzɑt
ئازاپ	ʔɑzɑp
ئازوت	ʔɑzot
ئاسان	ʔɑsɑn
ئاسايىش	ʔɑsɑjiʃ
ئاستاتىن	ʔɑstɑtin
ئاسفالت	ʔɑsfɑlt
ئاسلان	ʔɑslɑn
ئاسمان	ɑsmɑn
ئاسى	ʔɑsi
ئاسىيا	ʔɑsijɑ
ئاش	ʔɑʃ
ئاشيان	ʔɑʃjɑn
ئاشپەز	ʔɑʃpɛz
ئاغ	ʔɑʁ
ئاغرىق	ʔɑʁriq
ئافغان	ʔɑfʁɑn
ئاق	ɑq
ئاقرابا	ʔɑqrɑbɑ
ئاقراپ	ʔɑqrɑp
ئاققۇ	ʔɑqqu
ئاقىۋەت	ʔɑqiwɛt
ئاكا	ʔɑkɑ
ئاكتىنىي	ʔɑktinij
ئالا	ʔɑlɑ
ئالاقە	ʔɑlɑqɛ
ئالاڭ	ʔɑlɑŋ
ئالتىنچى	ɑltintʃi
ئالتە	altæ
ئالتە	altɛ
ئالتە	ɑltæ
ئالتە	ɑltɛ
ئالقىش	ʔɑlqiʃ
ئالما	ɑlmɑ
ئالماس	ʔɑlmɑs
ئالىم	ʔɑlim
ئاليۇمىن	ʔɑljumin
ئالپ	ʔɑlp
ئالگېبرا	ʔɑlgebrɑ
ئالەت	ʔɑlɛt
ئامال	ʔɑmɑl
ئامانەت	ʔɑmɑnɛt
ئامراق	ʔɑmrɑq
ئامېرىتسىي	ʔɑmeritsij
ئانا	ɑnɑ
ئاناتومىيە	ʔɑnɑtomijɛ
ئانار	ʔɑnɑr
ئانت	ʔɑnt
ئاي	ʔɑj
ئاياز	ʔɑjɑz
ئاياق	ʔɑjɑq
ئايران	ʔɑjrɑn
ئايغىر	ʔɑjʁir
ئايماق	ʔɑjmɑq
ئاپتوموبىل	ʔɑptomobil
ئاپتوۋۇز	ʔɑptowuz
ئاپرېل	ʔɑprel
ئاپىرىن	ʔɑpirin
ئاپىيەت	ʔɑpijɛt
ئاپەت	ʔɑpɛt
ئاچا	ʔɑtʃɑ
ئاھالە	ʔɑhɑlɛ
ئاھاڭ	ʔɑhɑŋ
ئاۋارە	ʔɑwɑrɛ
ئاۋاز	ʔɑwɑz
ئاۋام	ʔɑwɑm
ئاۋغۇست	ʔɑwʁust
ئاۋۇچ	ʔɑwutʃ
ئو	o
ئوت	ʔot
ئوتتۇز	ottuz
ئوتۇن	ʔotun
ئوخشىماق	ʔoχʃimɑq
ئورتاق	ʔortɑq
ئوغا	ʔoʁɑ
ئوغرى	ʔoʁri
ئوغۇز	ʔoʁuz
ئوغۇل	oʁul
ئوق	ʔoq
ئوقۇماق	ʔoqumɑq
ئون	on
ئون	ɔn
ئونىنچى	onintʃi
ئويۇن	ʔojun
ئى	i
ئىبادەت	ʔibɑdɛt
ئىبادەتخانا	ʔibɑdɛtχɑnɑ
ئىبارە	ʔibɑrɛ
ئىبراھىم	ʔibrɑhim
ئىبرەت	ʔibrɛt
ئىبلىس	ʔiblis
ئىت	it
ئىتائەت	ʔitɑʔɛt
ئىتترىي	ʔittrij
ئىتتېربىي	ʔitterbij
ئىجات	ʔidʒɑt
ئىجتىمائىي	ʔidʒtimɑʔij
ئىرادە	ʔirɑdɛ
ئىرق	ʔirq
ئىرىدىي	ʔiridij
ئىزاھ	ʔizɑh
ئىس	ʔis
ئىستىراھەت	ʔistirɑhɛt
ئىستىسنا	ʔistisnɑ
ئىستىقبال	ʔistiqbɑl
ئىستىقلال	ʔistiqlɑl
ئىستىلا	ʔistilɑ
ئىستەك	ʔistɛk
ئىسراپ	ʔisrɑp
ئىسلاند	ʔislɑnd
ئىسيان	ʔisjɑn
ئىسيانچى	ʔisjɑntʃi
ئىسپات	ʔispɑt
ئىش	iʃ
ئىشارەت	ʔiʃɑrɛt
ئىشغال	ʔiʃʁɑl
ئىشق	ʔiʃq
ئىشىتمەك	ʔiʃitmɛk
ئىشچى	iʃtʃi
ئىشەك	ʔiʃɛk
ئىقبال	ʔiqbɑl
ئىقتىدار	ʔiqtidɑr
ئىقتىسات	ʔiqtisɑt
ئىقلىم	ʔiqlim
ئىككى	ikːi
ئىككىنچى	ikːintʃi
ئىلاج	ʔilɑdʒ
ئىلاھ	ʔilɑh
ئىلتىپات	ʔiltipɑt
ئىلىم	ʔilim
ئىلھام	ʔilhɑm
ئىم	ʔim
ئىمكان	ʔimkɑn
ئىن	ʔin
ئىنتىزام	ʔintizɑm
ئىنتىقام	ʔintiqɑm
ئىنجىل	ʔindʒil
ئىندىي	ʔindij
ئىنسانىيەت	ʔinsɑnijɛt
ئىنساپ	ʔinsɑp
ئىنكار	ʔinkɑr
ئىنى	ʔini
ئىنەك	inæk
ئىيۇل	ʔijul
ئىيۇن	ʔijun
ئىپادە	ʔipɑdɛ
ئىپتار	ʔiptɑr
ئىپپەت	ʔippɛt
ئىڭەك	ʔiŋɛk
ئىگە	ʔigɛ
ئىگەر	ʔigɛr
ئۆ	ø
ئۆت	ʔøt
ئۆز	ʔøz
ئۆستەڭ	østɛŋ
ئۆشكە	ʔøʃkɛ
ئۆكتەبر	ʔøktɛbr
ئۆكۈز	ʔøkyz
ئۆلۈم	ʔølym
ئۆي	øj
ئۆيلەر	øjlær
ئۆيلەر	øjlæː
ئۆپكە	ʔøpkɛ
ئۆچ	ʔøtʃ
ئۆچكە	ʔøtʃkɛ
ئۆگەي	ʔøgɛj
ئۇ	u
ئۇتۇق	ʔutuq
ئۇجرەت	ʔudʒrɛt
ئۇد	ʔud
ئۇرپ	ʔurp
ئۇرۇش	ʔuruʃ
ئۇرۇق	ʔuruq
ئۇزۇن	ʔuzun
ئۇستا	ʔustɑ
ئۇستات	ʔustɑt
ئۇستۇرا	ʔusturɑ
ئۇسلۇپ	ʔuslup
ئۇلار	ulɑr
ئۇلۇغ	ʔuluʁ
ئۇمۇرتقا	ʔumurtqɑ
ئۇن	ʔun
ئۇنسۇر	ʔunsur
ئۇنناپ	ʔunnɑp
ئۇنى	uni
ئۇنىڭغا	uniŋʁɑ
ئۇنىۋېرسىتېت	ʔuniwersitet
ئۇنىۋېرسىتېتى	ʔuniwersiteti
ئۇنۋان	ʔunwɑn
ئۇي	ʔuj
ئۇيغۇر	ʔujʁur
ئۇيغۇرچە	ujʁurtʃɛ
ئۇيقۇ	ʔujqu
ئۇپۇق	ʔupuq
ئۇۋا	ʔuwɑ
ئۇۋاق	ʔuwɑq
ئۈ	y
ئۈزۈك	ʔyzyk
ئۈزۈم	ʔyzym
ئۈزەڭگە	ʔyzɛŋgɛ
ئۈلپەت	ʔylpɛt
ئۈچ	ʔytʃ
ئۈچىنچى	ytʃintʃi
ئې	e
ئېتىراز	ʔetirɑz
ئېتىراپ	ʔetirɑp
ئېتىقات	ʔetiqɑt
ئېتىقاد	ʔetiqɑd
ئېتىۋار	ʔetiwɑr
ئېرا	ʔerɑ
ئېربىي	ʔerbij
ئېرىق	ʔeriq
ئېرىمەك	ʔerimɛk
ئېغىر	ʔeʁir
ئېغىرلىق	ʔeʁirliq
ئېغىز	ʔeʁiz
ئېغىل	ʔeʁil
ئېكران	ʔekrɑn
ئېكىن	ʔekin
ئېكۋاتور	ʔekwɑtor
ئېلان	ʔelɑn
ئېلىپ	ʔelip
ئېلىپبە	ʔelipbɛ
ئېلېمېنت	ʔelement
ئېنقىلاب	ʔenqilɑb
ئېنېرگىيە	ʔenergijɛ
ئېينشتېينىي	ʔejnʃtejnij
ئېيىق	ejiq
ئېپىك	ʔepik
ئېھاتە	ʔehɑtɛ
ئېھتىرام	ʔehtirɑm
ئېھتىمال	ʔehtimɑl
ئېھتىيات	ʔehtijɑt
ئېھسان	ʔehsɑn
ئە	ɛ
ئەتىۋار	ʔɛtiwɑr
ئەزان	ʔɛzɑn
ئەسل	ʔɛsl
ئەل	æl
ئەللىك	ællik̚
ئەللىك	ɛllik̚
ئەپسۇس	æpsus
ئەپەندى	ʔɛpɛndi
ئەڭ	ʔɛŋ
ئەگەر	ɛgɛr
ئەھمەد	ʔɛhmɛd
ئەھەد	ʔɛhɛd
ب	b
ب	be
باتارى	bɑtɑri
باتراق	bɑtrɑq
باتۇر	bɑtur
باج	bɑdʒ
بادام	bɑdɑm
بار	bɑr
بارماق	bɑrmɑq
بارىي	bɑrij
بازار	bɑzɑː
باشاق	bɑʃɑq
باققال	bɑqqɑl
باقى	bɑqi
بالا	bɑlɑ
بالكون	bɑlkon
بالېت	bɑlet
بانا	bɑnɑ
بانان	bɑnɑn
بانداژ	bɑndɑʒ
بايراق	bɑjrɑq
بايرام	bɑjrɑm
بايقۇش	bɑjquʃ
باپ	bɑp
باھا	bɑhɑ
بروم	brom
بوخچا	boχtʃɑ
بور	bor
بورچ	bortʃ
بوستان	bostɑn
بوسەي	bosɛj
بولكا	bolkɑ
بولۇو	boluo
بولۇپ	bolup
بومبا	bombɑ
بويۇن	bojun
بىتون	biton
بىر	bir
بىرىليانت	biriljɑnt
بىرىنچى	birintʃi
بىسمۇت	bismut
بىلەن	bilɛn
بىڭگۇر	biŋgur
بۆرەك	børɛk
بۆشۈك	bøʃyk
بۆك	bøk
بۆھران	bøhrɑn
بۇ	bu
بۇت	but
بۇتپەرەس	butpɛrɛs
بۇدجېت	buddʒet
بۇرادەر	burɑdɛr
بۇرژۇئا	burʒuʔɑ
بۇرژۇئازىيە	burʒuʔɑzijɛ
بۇرۇت	burut
بۇرۇن	burun
بۇغ	buʁ
بۇقا	buqɑ
بۇلاق	bulɑq
بۇلبۇل	bulbul
بۇلجۇڭ	buldʒuŋ
بۇلغارىيە	bulʁɑrijɛ
بۇلۇت	bulut
بۇيرۇق	bujruq
بۈيۈك	byjyk
بېركلىي	berklij
بېرىللىي	berillij
بېغىر	beʁir
بېلوك	belok
بېلىق	beliq
بېلىقچى	beliqtʃi
بېلەت	belɛt
بېنزىن	benzin
بېگېموت	begemot
بەختىيار	bɛχtijɑr
بەخش	bɛχʃ
بەدەل	bɛdɛl
بەدەن	bɛdɛn
بەركە	bɛrkɛ
بەرمەك	bɛrmɛk
بەز	bɛz
بەسەي	bɛsɛj
بەش	bæʃ
بەش	bɛʃ
بەشىنچى	bɛʃintʃi
بەك	bɛk
بەل	bɛl
بەلغەم	bɛlʁɛm
بەنزە	bɛnzɛ
بەنسىيۇەن	bɛnsijuɛn
بەنسىچۇ	bɛnsitʃu
بەياز	bɛjɑz
بەگ	bɛg
ت	t
ت	te
تار	tɑr
تارازا	tɑrɑzɑ
تاراۋى	tɑrɑwi
تاغ	tɑʁ
تاماق	tɑmɑq
تاملار	tʰamlɑː
تاملار	tʰɑmlɑr
ترامپ	trɑmp
تورۇق	toruq
توسۇن	tosun
توقسان	toqsɑn
توققۇز	toqquz
توققۇز	tɔqquz
توققۇزىنچى	toqquzintʃi
توپ	top
توپۇق	topuq
تىرناق	tirnɑq
تىلەك	tilɛk
تىمساخ	timsɑχ
تىيىن	tijin
تۆت	tøt̚
تۆت	tœt̚
تۆتىنچى	tøtintʃi
تۆتىنچى	tœtintʃi
تۆش	tøʃ
تۆمۈر	tømyr
تۆپە	tøpɛ
تۆگە	tøgæ
تۆگە	tøgɛ
تۆگە	tœgæ
تۆگە	tœgɛ
تۇتماق	tutmɑq
تۇخۇم	tuχum
تۇز	tuz
تۇزاق	tuzɑq
تۇياق	tujɑq
تۈتۈن	tytyn
تۈز	tyz
تۈك	tyk
تۈلكە	tylkæ
تۈلكە	tylkɛ
تېز	tez
تېكە	tekɛ
تەبلىغ	tɛbliʁ
تەخسە	tækʰsæ
تەخسە	tæxsæ
تەخسە	tɛkʰsɛ
تەخسە	tɛxsɛ
تەخمىن	tɛχmin
تەدبىر	tɛdbir
تەر	tɛr
تەرجىمان	tɛrdʒimɑn
تەرجىمە	tærdʒimæ
تەرجىمە	tɛrdʒimɛ
تەس	tɛs
تەلۋە	tɛlwɛ
تەپەككۇر	tɛpɛkkur
تەڭرى	tɛŋri
تەھدىت	tɛhdit
ج	dʒ
ج	dʒe
جازا	dʒɑzɑ
جامائەت	dʒɑmɑʔɛt
جاڭيۇ	dʒɑŋju
جاۋاپ	dʒɑwɑp
جوزا	dʒozɑ
جىنازا	dʒinɑzɑ
جىنايەت	dʒinɑjɛt
جىگەر	dʒigɛr
جۇدا	dʒudɑ
جۇڭگو	dʒuŋgo
جۈمە	dʒymæ
جۈمە	dʒymɛ
جەسۇر	dʒɛsur
جەڭچى	dʒæŋtʃi
جەڭچى	dʒɛŋtʃi
خ	χ
خ	χe
خوتەن	χotɛn
خوراز	χorɑz
خورۋاتىيە	χorwɑtijɛ
خوش	xoʃ
خوش	xɔʃ
خىت	χit
خىزمەتچى	χizmɛttʃi
خېچىر	χetʃir
خەنزۇ	χɛnzu
د	d
د	de
دادا	dɑdɑ
داستان	dɑstɑn
داشۈئې	dɑʃyʔe
دانە	dɑnɛ
داۋا	dɑwɑ
داۋۇت	dɑwut
دوست	dost
دوستانە	dostɑnɛ
دومبىرا	dombirɑ
دىن	din
دۇئا	duʔɑ
دۇتار	dutɑr
دۇتتار	duttɑr
دۈدۈك	dydyk
دۈشەنبە	dyʃænbæ
دۈشەنبە	dyʃɛnbɛ
دېكابر	dekɑbr
دېڭىز	deŋiz
دەپتەر	dæp̚tær
دەپتەر	dɛp̚tɛr
ر	r
ر	re
روبرۇ	robru
رۇخسەت	ruχsɛt
رۇسىيە	rúsijɛ
رەھمەت	ræhmɛt
ز	z
ز	ze
زامىن	zɑmin
زاپاس	zɑpɑs
زوق	zoq
زىت	zit
زىرە	zirɛ
زىننەت	zinnɛt
زۇلۇم	zulum
زۇمرەت	zumrɛt
زەئىپ	zɛʔip
زەربە	zɛrbɛ
زەررە	zɛrrɛ
زەرەر	zɛrɛr
زەمبىرەك	zɛmbirɛk
زەنجىر	zɛndʒir
زەنجىۋىل	zɛndʒiwil
س	s
س	se
سائەت	saʔɛt
ساختا	sɑχtɑ
ساداق	sɑdɑq
ساراي	sɑrɑj
سارراپ	sɑrrɑp
ساقاق	sɑqɑq
ساقچى	sɑqtʃi
سال	sɑl
ساما	sɑmɑ
سامان	sɑmɑn
ساماۋار	sɑmɑwɑr
سايە	sɑjɛ
ساپان	sɑpɑn
سىركە	sirkɛ
سىرەك	sirɛk
سىياسەت	sijɑsɛt
سىيىر	sijir
سىڭىر	siŋir
سۆز	søz
سۆگەت	søgɛt
سۆھبەت	søhbɛt
سۇ	su
سۈت	syt
سۈلھ	sylh
سۈمۈرمەك	symyrmɛk
سۈيدۈك	syjdyk
سېغىزخان	seʁizχɑn
سېمىز	semiz
سېمىزئوت	semizʔot
سېنتەبر	sentɛbr
سەرخۇش	sɛrχuʃ
سەكسەن	sɛksɛn
سەكسەنپۇت	sɛksɛnput
سەككىز	sækkiz
سەككىز	sæk̚kiz
سەككىز	sɛkkiz
سەككىز	sɛk̚kiz
سەككىزىنچى	sɛkkizintʃi
سەمەرقەند	sɛmɛrqɛnd
سەنئەت	sɛnʔɛt
سەي	sɛj
سەيشەنبە	sæjʃænbæ
سەيشەنبە	sɛjʃɛnbɛ
سەپەر	sɛpɛr
ش	ʃ
ش	ʃe
شام	ʃɑm
شامان	ʃɑmɑn
شاپتۇل	ʃɑptul
شاھ	ʃɑh
شوپۇر	ʃopur
شىرىن	ʃirin
شىنجاڭ	ʃindʒɑŋ
شياڭگاڭ	ʃjɑŋgɑŋ
شۆھرەت	ʃøhrɛt
شۈبھە	ʃybhɛ
شۈكۈر	ʃykyr
شېكەر	ʃekɛr
شەنبە	ʃænbæ
شەنبە	ʃɛnbɛ
شەپكە	ʃɛpkɛ
غ	ʁ
غ	ʁe
غازى	ʁɑzi
غالىپ	ʁɑlip
غايىپ	ʁɑjip
غايە	ʁɑjɛ
غايەت	ʁɑjɛt
غاپىل	ʁɑpil
غىجەك	ʁidʒɛk
غۇربەت	ʁurbɛt
غۇرۇر	ʁurur
غۇلاچ	ʁulɑtʃ
غەددار	ʁɛddɑr
غەرپ	ʁɛrp
غەرەز	ʁɛrɛz
غەزەپ	ʁɛzɛp
غەلىبە	ʁɛlibɛ
غەلۋىر	ʁɛlwir
غەم	ʁɛm
غەمزە	ʁɛmzɛ
غەنى	ʁɛni
غەنىمەت	ʁɛnimɛt
غەيرەت	ʁɛjrɛt
غەيۋەت	ʁɛjwɛt
غەپلەت	ʁɛplɛt
غەۋغا	ʁɛwʁɑ
ف	f
ف	fe
فاشىست	fɑʃist
فرانسىيە	frɑnsijɛ
فېۋرال	fewrɑl
ق	q
ق	qe
قائىدە	qɑʔidɛ
قابىلىيەت	qɑbilijɛt
قات	qɑt
قادىر	qɑdir
قار	qɑr
قارار	qɑrɑr
قارارگاھ	qɑrɑrgɑh
قاراچاي	tʃɑj
قارشى	qɑrʃi
قارىن	qɑrin
قازاغىستان	qɑzɑʁistɑn
قازى	qɑzi
قاسساپ	qɑssɑp
قاسىم	qɑsim
قاغا	qɑʁɑ
قالقان	qɑlqɑn
قالپاق	qɑlpɑq
قالۇن	qɑlun
قامچا	qɑmtʃɑ
قانائەت	qɑnɑʔɛt
قانال	qɑnɑl
قانجۇق	qɑndʒuq
قانۇن	qɑnun
قايسى	qɑjsi
قايغۇ	qɑjʁu
قايماق	qɑjmɑq
قاپقاق	qɑpqɑq
قاچا	qɑtʃɑ
قاچاق	qɑtʃɑq
قاھىرە	qɑhirɛ
قوبۇل	qobul
قورقاق	qorqɑq
قورقۇنچ	qorquntʃ
قوزا	qozɑ
قوزىقۇلاق	qoziqulɑq
قوزۇق	qozuq
قوساق	qosɑq
قوشۇق	qoʃuq
قوغۇن	qoʁun
قومۇش	qomuʃ
قونچ	qontʃ
قويۇق	qojuq
قويۇن	qojun
قوڭغۇز	qoŋʁuz
قوۋم	qowm
قوۋۇرغا	qowurʁɑ
قىرغۇل	qirʁul
قىرو	qiro
قىرىق	qiriq
قىز	qɤz
قىزىلغاز	qizilʁɑz
قىساس	qisɑs
قىسقاچ	qisqɑtʃ
قىسمەت	qismɛt
قىسىر	qisir
قىشلاق	qiʃlɑq
قىلىق	qiliq
قىلىچ	qilitʃ
قىمار	qimɑr
قىن	qin
قىيامەت	qijɑmɛt
قىياپەت	qijɑpɛt
قىيما	qijmɑ
قىچىق	qitʃiq
قۇببە	qubbɛ
قۇتلۇق	qutluq
قۇدرەت	qudrɛt
قۇدۇق	quduq
قۇرئان	qurʔɑn
قۇرغاق	qurʁɑq
قۇزغۇن	quzʁun
قۇسۇر	qusur
قۇش	quʃ
قۇلۇن	qulun
قۇم	qum
قۇمچاق	qumtʃɑq
قۇيرۇق	qujruq
قۇچاق	qutʃɑq
قۇۋانچ	quwɑntʃ
قېلىپ	qelip
قېنى	qeni
قېيىق	qejiq
قېيىن	qejin
قەبرە	qɛbrɛ
قەتئى	qɛtʔi
قەترە	qɛtrɛ
قەدىم	qɛdim
قەدەھ	qɛdɛh
قەرەنفىل	qɛrɛnfil
قەستەن	qɛstɛn
قەسىدە	qɛsidɛ
قەسىر	qɛsir
قەغەز	qæʁæz
قەلئە	qɛlʔɛ
قەلەم	qælæm
قەلەي	qɛlɛj
قەمەر	qɛmɛr
قەندىل	qɛndil
قەيسەر	qɛjsɛr
قەپەز	qɛpɛz
قەھر	qɛhr
قەھرىۋا	qɛhriwɑ
قەۋرە	qɛwrɛ
ك	k
ك	ke
كائىنات	kɑʔinɑt
كابىل	kɑbil
كابىنېت	kɑbinet
كاتالوگ	kɑtɑlog
كاتالىزاتور	kɑtɑlizɑtor
كاتولىك	kɑtolik
كاتىپ	kɑtip
كاتېگورىيە	kɑtegorijɛ
كادمىي	kɑdmij
كارانتىن	kɑrɑntin
كارىدور	kɑridor
كارۋات	kɑrwɑt
كاسا	kɑsɑ
كاسات	kɑsɑt
كاستۇم	kɑstum
كاكاۋۇ	kɑkɑwu
كالتسىي	kɑltsij
كاللا	kɑllɑ
كالىفورنىي	kɑlifornij
كالىي	kɑlij
كامال	kɑmɑl
كاپىر	kɑpir
كاپۇستا	kɑpustɑ
كاھىن	kɑhin
كاۋاپ	kɑwɑp
كاۋچۇك	kɑwtʃuk
كرىمنىي	krimnij
كرىپتون	kripton
كسېنون	ksenon
كوبالت	kobɑlt
كور	kor
كورلۇق	korluq
كوسا	kosɑ
كوفېيىن	kofejin
كوكائىن	kokɑʔin
كولخوز	kolχoz
كومپاس	kompɑs
كونسۇل	konsul
كويزا	kojzɑ
كىبىر	kibir
كىت	kit
كىتاب	kitɑp
كىر	kir
كىرا	kirɑ
كىرىچ	kiritʃ
كىرپىك	kirpik
كىرپىچ	kirpitʃ
كىرپە	kirpɛ
كىشنەمەك	kiʃnɛmɛk
كىشى	kiʃi
كىلو	kilo
كىلومېتىر	kilometir
كىلوگىرام	kilogirɑm
كىنو	kino
كىيمەك	kijmɛk
كىيىك	kijik
كىپەك	kipɛk
كىچىك	kitʃik
كيۇرىي	kjurij
كۆت	køt
كۆرۈك	køryk
كۆز	køz
كۆزگۈ	køzgy
كۆكس	køks
كۆل	køl
كۆمۈر	kømyr
كۆمەك	kømɛk
كۆن	køn
كۆينەك	køjnɛk
كۆپۈك	køpyk
كۆچ	køtʃ
كۆچكۈن	køtʃkyn
كۆچمەك	køtʃmɛk
كۆڭۈل	køŋyl
كۇتۇپخانا	kutupχɑnɑ
كۈرەش	kyrɛʃ
كۈل	kyl
كۈلپەت	kylpɛt
كۈمۈش	kymyʃ
كۈن	kyn
كۈنجۈت	kyndʒyt
كۈپ	kyp
كېلىن	kelin
كېلەر	kelɛr
كېمىرمەك	kemirmɛk
كېمىچى	kemitʃi
كېپىل	kepil
كېپەن	kepɛn
كېچا	ketʃɑ
كەررە	kɛrrɛ
كەسكىن	kɛskin
كەسىر	kɛsir
كەسىپ	kɛsɪp
كەشنىز	kɛʃniz
كەشپ	kɛʃp
كەكلىك	kɛklik
كەلمەك	kʰæːmæk
كەنت	kɛnt
كەندىر	kɛndir
كەيپ	kɛjp
كەچ	kɛtʃ
كەچۈرۈڭ	ketʃiriŋ
كەچۈرۈڭ	kɛtʃyryŋ
كەھرىبا	kɛhribɑ
كەۋسەر	kɛwsɛr
ل	l
ل	le
لاتارىيە	lɑtɑrijɛ
لاتاپەت	lɑtɑpɛt
لازىم	lɑzim
لاك	lɑk
لال	lɑl
لانتان	lɑntɑn
لايىھە	lɑjihɛ
لاچىن	lɑtʃin
لاڭتۇ	lɑŋtu
لاۋا	lɑwɑ
لاۋرېنتسىي	lɑwrentsij
لوقما	loqmɑ
لوم	lom
لوگارىفما	logɑrifmɑ
لىباس	libɑs
لىبېرال	liberɑl
لىتىي	litij
لىفت	lift
لىمونات	limonɑt
لىڭجەن	liŋdʒɛn
ليۇتېتسىي	ljutetsij
لۇغەت	luʁæt
لۈتۈپ	lytyp
لېزىز	leziz
لېكىن	lekin
لېۋەن	lewɛn
لەتىپە	lɛtipɛ
لەززەت	lɛzzɛt
لەقەم	lɛqɛm
لەنەت	lɛnɛt
لەيتەكس	lɛjtɛks
لەپ	lɛp
لەڭمەن	læʁmɑn
لەڭگەر	lɛŋgɛr
لەگەن	lɛgɛn
لەھجە	lɛhdʒɛ
لەھزە	lɛhzɛ
لەھەت	lɛhɛt
م	m
م	me
مائارىپ	mɑʔɑrip
مائاش	mɑʔɑʃ
مائاۋىن	mɑʔɑwin
ماتكا	mɑtkɑ
ماتور	mɑtor
ماتېماتىكا	mɑtemɑtikɑ
ماتەم	mɑtɛm
ماجال	mɑdʒɑl
ماددا	mɑddɑ
مارافون	mɑrɑfon
ماراكەش	mɑrɑkɛʃ
مارال	mɑrɑl
مارت	mɑrt
مارجان	mɑrdʒɑn
مارگانېتىس	mɑrgɑnetis
مازار	mɑzɑr
ماشىنا	mɑʃinɑ
ماقالا	mɑqɑlɑ
ماقالە	mɑqɑlɛ
ماقۇل	mɑqul
مالىيە	mɑlijɛ
مالېكۇلا	mɑlekulɑ
مامونت	mɑmont
مانجىت	mɑndʒit
مانىفېست	mɑnifest
مانېۋىر	mɑnewir
مايمۇن	mɑjmun
ماگنىت	mɑgnit
ماگنىي	mɑgnij
ماھارەت	mɑhɑrɛt
ماھىيەت	mɑhijɛt
ماۋزۇ	mɑwzu
ماۋزۇر	mɑwzur
مودېل	model
مورفىن	morfin
مول	mol
مولىبدېن	molibden
موم	mom
مونچاق	montʃɑq
موڭغۇلىيە	moŋʁulijɛ
مىخ	miχ
مىراس	mirɑs
مىزان	mizɑn
مىس	mis
مىسال	misɑl
مىسرا	misrɑ
مىسكىن	miskin
مىسۋاك	miswɑk
مىقدار	miqdɑr
مىكروسكوپ	mikroskop
مىكروفون	mikrofon
مىكروپ	mikrop
مىللەت	millɛt
مىليارد	miljɑrt
مىليون	miljon
مىنا	minɑ
مىننەت	minnɛt
مىننەتدار	minnɛtdɑr
مىنىستىر	ministir
مىنگۇو	minguo
مىنۇت	minut
مىنۇس	minus
مىنېرال	minerɑl
مىڭ	miŋ
مۆجىزە	mødʒizɛ
مۆمىن	mømin
مۆڭ	møŋ
مۆھۈر	møhyr
مۇئاش	muʔɑʃ
مۇئاھىدە	muʔɑhidɛ
مۇئەززەم	muʔɛzzɛm
مۇئەسسەسە	muʔɛssɛsɛ
مۇئەللىم	muʔɛllim
مۇئەمما	muʔɛmmɑ
مۇئەييەن	muʔɛjjɛn
مۇبارەك	mubɑrɛk
مۇبالىغە	mubɑliʁɛ
مۇتلەق	mutlɛq
مۇتەئەسسىپ	mutɛʔɛssip
مۇتەخەسسىس	mutɛχɛssis
مۇخالىپ	muχɑlip
مۇخبىر	muχbir
مۇختار	muχtɑr
مۇداپىە	mudɑpiɛ
مۇددەت	muddɛt
مۇدھىش	mudhiʃ
مۇراسىم	murɑsim
مۇرەككەپ	murɛkkɛp
مۇزاكىرە	muzɑkirɛ
مۇزېي	muzej
مۇسابىقە	musɑbiqɛ
مۇساپىر	musɑpir
مۇسبەت	musbɛt
مۇستەسنا	mustɛsnɑ
مۇستەقىل	mustɛqil
مۇستەملىكە	mustɛmlikɛ
مۇستەھكەم	mustɛhkɛm
مۇسكۇل	muskul
مۇسىبەت	musibɛt
مۇشەققەت	muʃɛqqɛt
مۇقىم	muqim
مۇقەددەس	muqɛddɛs
مۇقەررەر	muqɛrrɛr
مۇكاپات	mukɑpɑt
مۇكەممەل	mukɛmmɛl
مۇلايىم	mulɑjim
مۇنازىرە	munɑzirɛ
مۇناسىپ	munɑsip
مۇناسىۋەت	munɑsiwɛt
مۇنتىزىم	muntizim
مۇنەججىم	munɛdʒdʒim
مۇيەسسەر	mujɛssɛr
مۇپتىلا	muptilɑ
مۇھاسىرە	muhɑsirɛ
مۇھتاج	muhtɑdʒ
مۇھتەرەم	muhtɛrɛm
مۇھىت	muhit
مۇھىم	muhim
مۇھەببەت	muhɛbbɛt
مۇۋازىنەت	muwɑzinɛt
مۇۋاپىق	muwɑpiq
مۇۋەققەت	muwɛqqɛt
مۇۋەپپەق	muwɛppɛq
مۇۋەپپەقىيەت	muwɛppɛqijɛt
مۈشكۈل	myʃkyl
مۈشۈك	myʃyk̚
مۈلۈك	mylyk
مۈمكىن	mymkin
مېتان	metɑn
مېترو	metro
مېتود	metod
مېتىر	metir
مېدال	medɑl
مېردىيان	merdijɑn
مېركۇرى	merkuri
مېندېلېيېۋىي	mendelejewij
مېنىنگىت	meningit
مېھراپ	mehrɑp
مېھمان	mehmɑn
مېھنەت	mehnɛt
مېۋە	mewɛ
مەبلەغ	mɛblɛʁ
مەتبە	mɛtbɛ
مەجبۇر	mɛdʒbur
مەجلىس	mɛdʒlis
مەجنۇن	mɛdʒnun
مەجھۇل	mɛdʒhul
مەخلۇق	mɛχluq
مەدەت	mɛdɛt
مەدەن	mɛdɛn
مەدەنىي	mɛdɛnij
مەرت	mɛrt
مەرتىۋە	mɛrtiwɛ
مەركەز	mɛrkɛz
مەرمەر	mɛrmɛr
مەرھۇم	mɛrhum
مەرھەمەت	mɛrhɛmɛt
مەزلۇم	mɛzlum
مەزھەپ	mɛzhɛp
مەسئۇل	mɛsʔul
مەسخىرە	mɛsχirɛ
مەسلىھەت	mɛslihɛt
مەسلەك	mɛslɛk
مەسۇم	mɛsum
مەشغۇل	mɛʃʁul
مەشھۇر	mɛʃhur
مەغرۇر	mɛʁrur
مەغلۇپ	mɛʁlup
مەقئەت	mɛqʔɛt
مەقبۇل	mɛqbul
مەقسەت	mɛqsɛt
مەكتۇپ	mɛktup
مەكتەپ	mɛktɛp
مەمنۇن	mɛmnun
مەمۇر	mɛmur
مەن	mæn
مەنتىق	mɛntiq
مەنزىرە	mɛnzirɛ
مەنزىل	mɛnzil
مەنسۇپ	mɛnsup
مەنپىي	mɛnpij
مەنپەئەت	mɛnpɛʔɛt
مەيدان	mɛjdɑn
مەيىل	mɛjil
مەيۈس	mɛjys
مەھبۇس	mɛhbus
مەھرۇم	mɛhrum
مەھسۇل	mɛhsul
مەھكىمە	mɛhkimɛ
مەھكۇم	mɛhkum
مەھەممەت	mæmæt̚
مەھەممەت	mɛmɛt̚
مەۋسۈم	mɛwsym
مەۋھۈم	mɛwhym
ن	n
ن	ne
نائىل	nɑʔil
نائىلاج	nɑʔilɑdʒ
نائىنساپ	nɑʔinsɑp
نائىپ	nɑʔip
نائۇستا	nɑʔustɑ
نائۈمىت	nɑʔymit
ناترىي	nɑtrij
ناتسىست	nɑtsist
ناتوغرا	nɑtoʁrɑ
نادامەت	nɑdɑmɛt
نادان	nɑdɑn
نادىر	nɑdir
ناز	nɑz
نازارەت	nɑzɑrɛt
نازاكەت	nɑzɑkɛt
نازىم	nɑzim
نالايىق	nɑlɑjiq
نام	nɑm
ناماز	nɑmɑz
ناماقۇل	nɑmɑqul
نامايىش	nɑmɑjiʃ
نامزات	nɑmzɑt
نامۇس	nɑmus
نامە	nɑmɛ
نامەرت	nɑmɛrt
نامەلۇم	nɑmɛlum
نان	nɑn
نانكور	nɑnkor
ناپاك	nɑpɑk
ناھىيە	nɑhijɛ
نوبېلىي	nobelij
نورمال	normɑl
نوغاي	noʁɑj
نومۇر	nomur
نومۇس	nomus
نويابر	nojɑbr
نوپۇز	nopuz
نوپۇس	nopus
نىجات	nidʒɑt
نىجىس	nidʒis
نىزام	nizɑm
نىسبەت	nisbɛt
نىسپىي	nispij
نىشان	niʃɑn
نىكا	nikɑ
نىكېل	nikel
نىلۇپەر	nilupɛr
نىوبىي	niobij
نىيەت	nijɛt
نىگار	nigɑr
نۆشۈدۈر	nøʃydyr
نۆل	nøl
نۆل	nœl
نۆلىنچى	nølintʃi
نۆلىنچى	nœlintʃi
نۆۋەت	nøwɛt
نۇتۇق	nutuq
نۇر	nur
نۇرانى	nurɑni
نۇسخە	nusχɛ
نۇسرەت	nusrɛt
نۇقسان	nuqsɑn
نېرۋا	nerwɑ
نېسىپ	nesip
نېفىت	nefit
نېمە	nemɛ
نېودىم	neodim
نېون	neon
نېيترون	nejtron
نېپتۇنىي	neptunij
نەبى	nɛbi
نەتىجە	nɛtidʒɛ
نەرە	nɛrɛ
نەزەر	nɛzɛr
نەسىر	nɛsir
نەسىل	nɛsil
نەسىھەت	nɛsihɛt
نەشتەر	nɛʃtɛr
نەشر	nɛʃr
نەغمە	nɛʁmɛ
نەقلىيات	nɛqlijɑt
نەقىش	nɛqiʃ
نەقىل	nɛqil
نەمۇنە	nɛmunɛ
نەي	nɛj
نەپرەت	nɛprɛt
نەپس	nɛps
نەپىس	nɛpis
نەپەس	nɛpɛs
نەپەقە	nɛpɛqɛ
نەۋ	nɛw
ى	i
ى	ɪ
ى	ɯ
ي	j
ي	je
يات	jɑt
ياخشى	jɑχʃi
ياخشىمۇسىز	jɑχʃimusiz
ياخشىمۇسىلەر	jakʰʃimusilær
ياخشىمۇسىلەر	jakʰʃimusilɛr
ياخشىمۇسىلەر	jɑxʃimusilær
ياخشىمۇسىلەر	jɑxʃimusilɛr
ياد	jɑd
يادىكار	jɑdikɑr
يار	jɑr
يارا	jɑrɑ
ياستۇق	jɑstuq
ياسىن	jɑsin
ياغ	jɑʁ
ياغاچ	jɑʁɑtʃ
ياق	jɑq
ياقا	jɑqɑ
ياقماق	jɑqmɑq
ياقۇت	jɑqut
ياكور	jɑkor
يالاڭ	jɑlɑŋ
يالاڭئاياق	jɑlɑŋʔɑjɑq
يالغان	jɑlʁɑn
يالپۇز	jɑlpuz
يالۋۇرماق	jɑlwurmɑq
يامغۇر	jɑmʁur
يانغىن	jɑnʁin
يانفون	jɑŋpon
يانماق	jɑnmɑq
يانۋار	jɑnwɑr
ياپونىيە	jɑponijɛ
ياڭاق	jɑŋɑq
ياڭيۇ	jɑŋju
ياگاو	jɑgɑo
ياۋروپا	jɑwropɑ
ياۋۇز	jɑwuz
يوتقان	jotqɑn
يود	jod
يورۇقلۇق	joruqluq
يوغان	joʁɑn
يوق	joq
يول	jol
يولداش	joldɑʃ
يولۋاس	jolwɑs
يوپىتېر	jopiter
يوپۇرماق	jopurmɑq
يىتىم	jitim
يىراقلىق	jirɑqliq
يىرتماق	jirtmɑq
يىرىڭ	jiriŋ
يىل	jil
يىلان	jilɑn
يىلىك	jilik
يىپ	jip
يىپەك	jipɛk
يىڭنە	jiŋnɛ
يىگىت	jigit
يىگىرمە	jigirmæ
يىگىرمە	jigirmɛ
يۇتقۇنچاق	jutquntʃɑq
يۇتماق	jutmɑq
يۇرت	jurt
يۇغۇرماق	juʁurmɑq
يۇققا	juqqɑ
يۇقۇرى	juquri
يۇلتۇز	jultuz
يۇلماق	julmɑq
يۇماق	jumɑq
يۇمماق	jummɑq
يۇمۇق	jumuq
يۇپقا	jupqɑ
يۇڭ	juŋ
يۇۋاش	juwɑʃ
يۈتمەك	jytmɛk
يۈرەكلىك	jyrɛklik
يۈز	jyz
يۈسۈپ	jysyp
يۈگەن	jygɛn
يېتەرسىز	jetɛrsiz
يېتەرلىك	jetɛrlik
يېشىل	jeʃil
يېقىلغۇ	jeqilʁu
يېنىك	jenik
يېپىشقاق	jepiʃqɑq
يېپىشماق	jepiʃmɑq
يېڭىلىق	jeŋiliq
يېۋروپىي	jewropij
يەتتىنچى	jɛttintʃi
يەتتە	jættæ
يەتتە	jæt̚tæ
يەتتە	jɛttɛ
يەتتە	jɛt̚tɛ
يەتمىش	jɛtmiʃ
يەريۈزى	jɛrjyzi
يەكشەنبە	jækʃæmbæ
يەكشەنبە	jæxʃæmbæ
يەكشەنبە	jɛkʃɛmbɛ
يەكشەنبە	jɛxʃɛmbɛ
يەكۈن	jɛkyn
يەل	jɛl
يەلكەن	jɛlkɛn
يەم	jɛm
يەنى	jɛni
يەڭ	jɛŋ
يەڭگىل	jɛŋgil
يەھۇدى	jɛhudi
پ	p
پ	pe
پاراخوت	pɑrɑχot
پارازىت	pɑrɑzit
پاراشوت	pɑrɑʃot
پاراشوك	pɑrɑʃok
پاراكەندە	pɑrɑkɛndɛ
پاراگىراپ	pɑrɑgirɑp
پاراۋوز	pɑrɑwoz
پاسپورت	pɑsport
پاقا	pɑqɑ
پاكىت	pɑkit
پال	pɑl
پايتەخت	pɑjtɛχt
پايدا	pɑjdɑ
پاھىشە	pɑhiʃɛ
پروفېسسور	propessor
پوق	poq
پولات	polɑt
پولشا	polʃɑ
پويىز	pojiz
پىت	pit
پىشلاق	piʃlɑq
پىيادە	pijɑdɛ
پۇت	put
پۇرسەت	pursɛt
پۇرچاق	purtʃɑq
پېقىر	peqir
پەردە	pɛrdɛ
پەرۋانە	pɛrwɑnɛ
پەلتو	pɛlto
پەلسەپە	pɛlsɛpɛ
پەن	pɛn
پەنجاب	pɛndʒɑb
پەيشەنبە	pæjʃænbæ
پەيشەنبە	pɛjʃɛnbɛ
پەيغەمبەر	pɛjʁɛmbɛr
چ	tʃ
چ	tʃe
چارشەنبە	tʃarʃænbæ
چارشەنبە	tʃarʃɛnbɛ
چارشەنبە	tʃɑrʃænbæ
چارشەنبە	tʃɑrʃɛnbɛ
چارەك	tʃɑrɛk
چاشكا	tʃɑʃkɑ
چاي	tʃɑj
چايان	tʃɑjɑn
چاچ	tʃɑtʃ
چوكا	tʃokɑ
چولاق	tʃolɑq
چىراق	tʃirɑq
چىش	tʃiʃ
چىكەتكە	tʃikɛtkɛ
چىمەن	tʃimɛn
چىۋىن	tʃiwin
چېركاۋ	tʃerkɑw
چېچەك	tʃetʃæk̚
چېچەك	tʃetʃɛk̚
ژ	ʒ
ژ	ʒe
ژارگون	ʒɑrgon
ژاندارما	ʒɑndɑrmɑ
ژانىر	ʒɑnir
ژۇرنال	ʒurnɑl
ژېڭۋېي	ʒeŋwej
ڭ	ŋ
ڭ	ŋe
گ	g
گ	ge
گاباردىن	gɑbɑrdin
گادولىنىي	gɑdolinij
گاز	gɑz
گافنىي	gɑfnij
گاللىي	gɑllij
گاڭبى	gɑŋbi
گاڭپەن	gɑŋpɛn
گاھ	gɑh
گرېتسىيە	gretsijɛ
گوللاندىيە	gollɑndijɛ
گولمىي	golmij
گويا	gojɑ
گىتار	gitɑr
گىرانات	girɑnɑt
گىرانىت	girɑnit
گىرداپ	girdɑp
گىرىپ	girip
گىياھ	gijɑh
گۆش	gøʃ
گۆھەر	gøhɛr
گۇنا	gunɑ
گۇناھ	gunɑh
گۈشە	gyʃɛ
گۈل	gyl
گۈلباغ	gylbɑʁ
گۈلباھار	gylbɑhɑr
گۈلخانا	gylχɑnɑ
گۈللەر	gyllær
گۈللەر	gyllæː
گۈللەر	gyllɛr
گۈلىستان	gylistɑn
گۈڭگۈرت	gyŋgyrt
گېرمانىي	germɑnij
گېزىت	gezit
گېكتار	gektɑr
گېلىي	gelij
گەدەن	gɛdɛn
ھ	h
ھ	he
ھارارەت	hɑrɑrɛt
ھازىر	ɦɑzɪr
ھازىرقى	ɦɑzɪrqɨ
ھالۋا	hɑlwɑ
ھايا	hɑjɑ
ھايات	hɑjɑt
ھاۋا	hɑwɑ
ھاۋز	hɑwz
ھىكايە	hikɑjɛ
ھۆرمەت	hørmɛt
ھۆكۈم	høkym
ھۇجۇم	hudʒum
ھېكايە	hikɑjæ
ھەئە	hɛʔɛ
ھەجىم	hɛdʒim
ھەدىيە	hɛdijɛ
ھەسەل	hɛsɛl
ھەممە	hɛmmɛ
ھەيكەل	hæjkæl
ھەپتە	hæptæ
ھەپتە	hæp̚tæ
ھەپتە	hɛptɛ
ھەپتە	hɛp̚tɛ
ھەپتە	ɦæptæ
ھەپتە	ɦæp̚tæ
ھەپتە	ɦɛptɛ
ھەپتە	ɦɛp̚tɛ
ۆ	ø
ۇ	u
ۈ	y
ۋ	v
ۋ	ve
ۋائىز	wɑʔiz
ۋابا	wɑbɑ
ۋادى	wɑdi
ۋاراق	wɑrɑq
ۋارىس	wɑris
ۋاز	wɑz
ۋاكسىنا	wɑksinɑ
ۋاپا	wɑpɑ
ۋاھە	wɑhɛ
ۋىرۇس	wirus
ۋۇجۇت	wudʒut
ۋېلسىپىت	welsipit
ۋېلىنېمەت	welinemɛt
ۋە	wɛ
ۋەتەن	wɛtɛn
ۋەدە	wɛdɛ
ۋەز	wɛz
ۋەزىپە	wɛzipɛ
ۋەسىقە	wɛsiqɛ
ۋەسىيەت	wɛsijɛt
ۋەسۋەسە	wɛswɛsɛ
ۋەلسىپىت	wɛlsipit
ۋەلىئەھد	wɛliʔɛhd
ۋەھشەت	wɛhʃɛt
